date,关键词,日期,PC+移动端,PC端,移动端,pre_hot,ma5_hot,ma10_hot
1,哈尔滨旅游,20220101,217,66,151,,,
2,哈尔滨旅游,20220102,239,74,165,217.0,,
3,哈尔滨旅游,20220103,247,63,184,239.0,,
4,哈尔滨旅游,20220104,258,93,165,247.0,,
5,哈尔滨旅游,20220105,252,104,148,258.0,242.6,
6,哈尔滨旅游,20220106,241,78,163,252.0,247.4,
7,哈尔滨旅游,20220107,243,78,165,241.0,248.2,
8,哈尔滨旅游,20220108,228,68,160,243.0,244.4,
9,哈尔滨旅游,20220109,225,74,151,228.0,237.8,
10,哈尔滨旅游,20220110,210,80,130,225.0,229.4,236.0
11,哈尔滨旅游,20220111,210,74,136,210.0,223.2,235.3
12,哈尔滨旅游,20220112,232,85,147,210.0,221.0,234.6
13,哈尔滨旅游,20220113,219,68,151,232.0,219.2,231.8
14,哈尔滨旅游,20220114,189,68,121,219.0,212.0,224.9
15,哈尔滨旅游,20220115,208,78,130,189.0,211.6,220.5
16,哈尔滨旅游,20220116,235,68,167,208.0,216.6,219.9
17,哈尔滨旅游,20220117,221,78,143,235.0,214.4,217.7
18,哈尔滨旅游,20220118,204,74,130,221.0,211.4,215.3
19,哈尔滨旅游,20220119,216,68,148,204.0,216.8,214.4
20,哈尔滨旅游,20220120,204,72,132,216.0,216.0,213.8
21,哈尔滨旅游,20220121,217,74,143,204.0,212.4,214.5
22,哈尔滨旅游,20220122,220,72,148,217.0,212.2,213.3
23,哈尔滨旅游,20220123,198,72,126,220.0,211.0,211.2
24,哈尔滨旅游,20220124,219,76,143,198.0,211.6,214.2
25,哈尔滨旅游,20220125,217,74,143,219.0,214.2,215.1
26,哈尔滨旅游,20220126,241,80,161,217.0,219.0,215.7
27,哈尔滨旅游,20220127,215,74,141,241.0,218.0,215.1
28,哈尔滨旅游,20220128,211,68,143,215.0,220.6,215.8
29,哈尔滨旅游,20220129,159,0,159,211.0,208.6,210.1
30,哈尔滨旅游,20220130,209,68,141,159.0,207.0,210.6
31,哈尔滨旅游,20220131,188,63,125,209.0,196.4,207.7
32,哈尔滨旅游,20220201,204,59,145,188.0,194.2,206.1
33,哈尔滨旅游,20220202,225,61,164,204.0,197.0,208.8
34,哈尔滨旅游,20220203,224,66,158,225.0,210.0,209.3
35,哈尔滨旅游,20220204,218,61,157,224.0,211.8,209.4
36,哈尔滨旅游,20220205,236,66,170,218.0,221.4,208.9
37,哈尔滨旅游,20220206,222,59,163,236.0,225.0,209.6
38,哈尔滨旅游,20220207,248,80,168,222.0,229.6,213.3
39,哈尔滨旅游,20220208,255,82,173,248.0,235.8,222.9
40,哈尔滨旅游,20220209,225,74,151,255.0,237.2,224.5
41,哈尔滨旅游,20220210,220,68,152,225.0,234.0,227.7
42,哈尔滨旅游,20220211,221,74,147,220.0,233.8,229.4
43,哈尔滨旅游,20220212,240,72,168,221.0,232.2,230.9
44,哈尔滨旅游,20220213,232,66,166,240.0,227.6,231.7
45,哈尔滨旅游,20220214,238,83,155,232.0,230.2,233.7
46,哈尔滨旅游,20220215,229,74,155,238.0,232.0,233.0
47,哈尔滨旅游,20220216,246,85,161,229.0,237.0,235.4
48,哈尔滨旅游,20220217,246,76,170,246.0,238.2,235.2
49,哈尔滨旅游,20220218,246,78,168,246.0,241.0,234.3
50,哈尔滨旅游,20220219,247,76,171,246.0,242.8,236.5
51,哈尔滨旅游,20220220,248,72,176,247.0,246.6,239.3
52,哈尔滨旅游,20220221,247,83,164,248.0,246.8,241.9
53,哈尔滨旅游,20220222,250,76,174,247.0,247.6,242.9
54,哈尔滨旅游,20220223,227,72,155,250.0,243.8,242.4
55,哈尔滨旅游,20220224,200,82,118,227.0,234.4,238.6
56,哈尔滨旅游,20220225,197,76,121,200.0,224.2,235.4
57,哈尔滨旅游,20220226,177,72,105,197.0,210.2,228.5
58,哈尔滨旅游,20220227,105,0,105,177.0,181.2,214.4
59,哈尔滨旅游,20220228,188,76,112,105.0,173.4,208.6
60,哈尔滨旅游,20220301,191,76,115,188.0,171.6,203.0
61,哈尔滨旅游,20220302,172,63,109,191.0,166.6,195.4
62,哈尔滨旅游,20220303,172,72,100,172.0,165.6,187.9
63,哈尔滨旅游,20220304,157,64,93,172.0,176.0,178.6
64,哈尔滨旅游,20220305,174,61,113,157.0,173.2,173.3
65,哈尔滨旅游,20220306,188,66,122,174.0,172.6,172.1
66,哈尔滨旅游,20220307,179,66,113,188.0,174.0,170.3
67,哈尔滨旅游,20220308,164,68,96,179.0,172.4,169.0
68,哈尔滨旅游,20220309,199,76,123,164.0,180.8,178.4
69,哈尔滨旅游,20220310,190,78,112,199.0,184.0,178.6
70,哈尔滨旅游,20220311,195,74,121,190.0,185.4,179.0
71,哈尔滨旅游,20220312,140,64,76,195.0,177.6,175.8
72,哈尔滨旅游,20220313,156,64,92,140.0,176.0,174.2
73,哈尔滨旅游,20220314,155,72,83,156.0,167.2,174.0
74,哈尔滨旅游,20220315,162,70,92,155.0,161.6,172.8
75,哈尔滨旅游,20220316,162,70,92,162.0,155.0,170.2
76,哈尔滨旅游,20220317,147,64,83,162.0,156.4,167.0
77,哈尔滨旅游,20220318,157,70,87,147.0,156.6,166.3
78,哈尔滨旅游,20220319,163,59,104,157.0,158.2,162.7
79,哈尔滨旅游,20220320,154,68,86,163.0,156.6,159.1
80,哈尔滨旅游,20220321,158,61,97,154.0,155.8,155.4
81,哈尔滨旅游,20220322,168,63,105,158.0,160.0,158.2
82,哈尔滨旅游,20220323,144,70,74,168.0,157.4,157.0
83,哈尔滨旅游,20220324,160,63,97,144.0,156.8,157.5
84,哈尔滨旅游,20220325,169,72,97,160.0,159.8,158.2
85,哈尔滨旅游,20220326,148,61,87,169.0,157.8,156.8
86,哈尔滨旅游,20220327,138,59,79,148.0,151.8,155.9
87,哈尔滨旅游,20220328,148,64,84,138.0,152.6,155.0
88,哈尔滨旅游,20220329,158,72,86,148.0,152.2,154.5
89,哈尔滨旅游,20220330,154,61,93,158.0,149.2,154.5
90,哈尔滨旅游,20220331,142,68,74,154.0,148.0,152.9
91,哈尔滨旅游,20220401,160,68,92,142.0,152.4,152.1
92,哈尔滨旅游,20220402,143,61,82,160.0,151.4,152.0
93,哈尔滨旅游,20220403,148,59,89,143.0,149.4,150.8
94,哈尔滨旅游,20220404,151,59,92,148.0,148.8,149.0
95,哈尔滨旅游,20220405,154,70,84,151.0,151.2,149.6
96,哈尔滨旅游,20220406,163,64,99,154.0,151.8,152.1
97,哈尔滨旅游,20220407,167,68,99,163.0,156.6,154.0
98,哈尔滨旅游,20220408,150,68,82,167.0,157.0,153.2
99,哈尔滨旅游,20220409,168,68,100,150.0,160.4,154.6
100,哈尔滨旅游,20220410,182,72,110,168.0,166.0,158.6
101,哈尔滨旅游,20220411,150,66,84,182.0,163.4,157.6
102,哈尔滨旅游,20220412,167,63,104,150.0,163.4,160.0
103,哈尔滨旅游,20220413,169,72,97,167.0,167.2,162.1
104,哈尔滨旅游,20220414,169,74,95,169.0,167.4,163.9
105,哈尔滨旅游,20220415,157,66,91,169.0,162.4,164.2
106,哈尔滨旅游,20220416,160,68,92,157.0,164.4,163.9
107,哈尔滨旅游,20220417,157,61,96,160.0,162.4,162.9
108,哈尔滨旅游,20220418,163,64,99,157.0,161.2,164.2
109,哈尔滨旅游,20220419,147,68,79,163.0,156.8,162.1
110,哈尔滨旅游,20220420,157,61,96,147.0,156.8,159.6
111,哈尔滨旅游,20220421,171,66,105,157.0,159.0,161.7
112,哈尔滨旅游,20220422,162,70,92,171.0,160.0,161.2
113,哈尔滨旅游,20220423,163,61,102,162.0,160.0,160.6
114,哈尔滨旅游,20220424,152,66,86,163.0,161.0,158.9
115,哈尔滨旅游,20220425,150,66,84,152.0,159.6,158.2
116,哈尔滨旅游,20220426,159,68,91,150.0,157.2,158.1
117,哈尔滨旅游,20220427,163,63,100,159.0,157.4,158.7
118,哈尔滨旅游,20220428,171,63,108,163.0,159.0,159.5
119,哈尔滨旅游,20220429,169,70,99,171.0,162.4,161.7
120,哈尔滨旅游,20220430,160,64,96,169.0,164.4,162.0
121,哈尔滨旅游,20220501,166,64,102,160.0,165.8,161.5
122,哈尔滨旅游,20220502,159,63,96,166.0,165.0,161.2
123,哈尔滨旅游,20220503,140,61,79,159.0,158.8,158.9
124,哈尔滨旅游,20220504,169,63,106,140.0,158.8,160.6
125,哈尔滨旅游,20220505,167,70,97,169.0,160.2,162.3
126,哈尔滨旅游,20220506,144,61,83,167.0,155.8,160.8
127,哈尔滨旅游,20220507,172,72,100,144.0,158.4,161.7
128,哈尔滨旅游,20220508,154,59,95,172.0,161.2,160.0
129,哈尔滨旅游,20220509,169,64,105,154.0,161.2,160.0
130,哈尔滨旅游,20220510,172,66,106,169.0,162.2,161.2
131,哈尔滨旅游,20220511,214,76,138,172.0,176.2,166.0
132,哈尔滨旅游,20220512,293,74,219,214.0,200.4,179.4
133,哈尔滨旅游,20220513,238,64,174,293.0,217.2,189.2
134,哈尔滨旅游,20220514,187,64,123,238.0,220.8,191.0
135,哈尔滨旅游,20220515,177,64,113,187.0,221.8,192.0
136,哈尔滨旅游,20220516,179,70,109,177.0,214.8,195.5
137,哈尔滨旅游,20220517,213,66,147,179.0,198.8,199.6
138,哈尔滨旅游,20220518,164,64,100,213.0,184.0,200.6
139,哈尔滨旅游,20220519,179,64,115,164.0,182.4,201.6
140,哈尔滨旅游,20220520,230,72,158,179.0,193.0,207.4
141,哈尔滨旅游,20220521,225,68,157,230.0,202.2,208.5
142,哈尔滨旅游,20220522,213,68,145,225.0,202.2,200.5
143,哈尔滨旅游,20220523,232,66,166,213.0,215.8,199.9
144,哈尔滨旅游,20220524,215,72,143,232.0,223.0,202.7
145,哈尔滨旅游,20220525,234,83,151,215.0,223.8,208.4
146,哈尔滨旅游,20220526,236,74,162,234.0,226.0,214.1
147,哈尔滨旅游,20220527,219,68,151,236.0,227.2,214.7
148,哈尔滨旅游,20220528,248,74,174,219.0,230.4,223.1
149,哈尔滨旅游,20220529,217,66,151,248.0,230.8,226.9
150,哈尔滨旅游,20220530,238,93,145,217.0,231.6,227.7
151,哈尔滨旅游,20220531,205,80,125,238.0,225.4,225.7
152,哈尔滨旅游,20220601,208,74,134,205.0,223.2,225.2
153,哈尔滨旅游,20220602,268,97,171,208.0,227.2,228.8
154,哈尔滨旅游,20220603,232,68,164,268.0,230.2,230.5
155,哈尔滨旅游,20220604,218,61,157,232.0,226.2,228.9
156,哈尔滨旅游,20220605,219,59,160,218.0,229.0,227.2
157,哈尔滨旅游,20220606,268,72,196,219.0,241.0,232.1
158,哈尔滨旅游,20220607,246,76,170,268.0,236.6,231.9
159,哈尔滨旅游,20220608,269,83,186,246.0,244.0,237.1
160,哈尔滨旅游,20220609,359,97,262,269.0,272.2,249.2
161,哈尔滨旅游,20220610,263,85,178,359.0,281.0,255.0
162,哈尔滨旅游,20220611,238,68,170,263.0,275.0,258.0
163,哈尔滨旅游,20220612,227,63,164,238.0,271.2,253.9
164,哈尔滨旅游,20220613,283,85,198,227.0,274.0,259.0
165,哈尔滨旅游,20220614,269,91,178,283.0,256.0,264.1
166,哈尔滨旅游,20220615,246,78,168,269.0,252.6,266.8
167,哈尔滨旅游,20220616,250,74,176,246.0,255.0,265.0
168,哈尔滨旅游,20220617,286,85,201,250.0,266.8,269.0
169,哈尔滨旅游,20220618,256,66,190,286.0,261.4,267.7
170,哈尔滨旅游,20220619,287,66,221,256.0,265.0,260.5
171,哈尔滨旅游,20220620,281,72,209,287.0,272.0,262.3
172,哈尔滨旅游,20220621,270,91,179,281.0,276.0,265.5
173,哈尔滨旅游,20220622,295,83,212,270.0,277.8,272.3
174,哈尔滨旅游,20220623,314,89,225,295.0,289.4,275.4
175,哈尔滨旅游,20220624,347,99,248,314.0,301.4,283.2
176,哈尔滨旅游,20220625,249,63,186,347.0,295.0,283.5
177,哈尔滨旅游,20220626,293,85,208,249.0,299.6,287.8
178,哈尔滨旅游,20220627,312,97,215,293.0,303.0,290.4
179,哈尔滨旅游,20220628,336,121,215,312.0,307.4,298.4
180,哈尔滨旅游,20220629,367,108,259,336.0,311.4,306.4
181,哈尔滨旅游,20220630,382,125,257,367.0,338.0,316.5
182,哈尔滨旅游,20220701,353,93,260,382.0,350.0,324.8
183,哈尔滨旅游,20220702,351,87,264,353.0,357.8,330.4
184,哈尔滨旅游,20220703,356,72,284,351.0,361.8,334.6
185,哈尔滨旅游,20220704,391,121,270,356.0,366.6,339.0
186,哈尔滨旅游,20220705,419,123,296,391.0,374.0,356.0
187,哈尔滨旅游,20220706,408,116,292,419.0,385.0,367.5
188,哈尔滨旅游,20220707,392,93,299,408.0,393.2,375.5
189,哈尔滨旅游,20220708,407,101,306,392.0,403.4,382.6
190,哈尔滨旅游,20220709,395,83,312,407.0,404.2,385.4
191,哈尔滨旅游,20220710,408,66,342,395.0,402.0,388.0
192,哈尔滨旅游,20220711,477,139,338,408.0,415.8,400.4
193,哈尔滨旅游,20220712,509,121,388,477.0,439.2,416.2
194,哈尔滨旅游,20220713,500,120,380,509.0,457.8,430.6
195,哈尔滨旅游,20220714,531,144,387,500.0,485.0,444.6
196,哈尔滨旅游,20220715,510,133,377,531.0,505.4,453.7
197,哈尔滨旅游,20220716,409,89,320,510.0,491.8,453.8
198,哈尔滨旅游,20220717,348,93,255,409.0,459.6,449.4
199,哈尔滨旅游,20220718,401,159,242,348.0,439.8,448.8
200,哈尔滨旅游,20220719,415,123,292,401.0,416.6,450.8
201,哈尔滨旅游,20220720,388,110,278,415.0,392.2,448.8
202,哈尔滨旅游,20220721,449,116,333,388.0,400.2,446.0
203,哈尔滨旅游,20220722,433,125,308,449.0,417.2,438.4
204,哈尔滨旅游,20220723,390,78,312,433.0,415.0,427.4
205,哈尔滨旅游,20220724,394,82,312,390.0,410.8,413.7
206,哈尔滨旅游,20220725,515,150,365,394.0,436.2,414.2
207,哈尔滨旅游,20220726,444,118,326,515.0,435.2,417.7
208,哈尔滨旅游,20220727,448,121,327,444.0,438.2,427.7
209,哈尔滨旅游,20220728,416,116,300,448.0,443.4,429.2
210,哈尔滨旅游,20220729,436,110,326,416.0,451.8,431.3
211,哈尔滨旅游,20220730,440,99,341,436.0,436.8,436.5
212,哈尔滨旅游,20220731,437,95,342,440.0,435.4,435.3
213,哈尔滨旅游,20220801,493,158,335,437.0,444.4,441.3
214,哈尔滨旅游,20220802,445,137,308,493.0,450.2,446.8
215,哈尔滨旅游,20220803,436,140,296,445.0,450.2,451.0
216,哈尔滨旅游,20220804,485,152,333,436.0,459.2,448.0
217,哈尔滨旅游,20220805,502,129,373,485.0,472.2,453.8
218,哈尔滨旅游,20220806,386,74,312,502.0,450.8,447.6
219,哈尔滨旅游,20220807,402,72,330,386.0,442.2,446.2
220,哈尔滨旅游,20220808,450,137,313,402.0,445.0,447.6
221,哈尔滨旅游,20220809,392,121,271,450.0,426.4,442.8
222,哈尔滨旅游,20220810,409,125,284,392.0,407.8,440.0
223,哈尔滨旅游,20220811,356,102,254,409.0,401.8,426.3
224,哈尔滨旅游,20220812,344,112,232,356.0,390.2,416.2
225,哈尔滨旅游,20220813,317,70,247,344.0,363.6,404.3
226,哈尔滨旅游,20220814,325,82,243,317.0,350.2,388.3
227,哈尔滨旅游,20220815,383,120,263,325.0,345.0,376.4
228,哈尔滨旅游,20220816,354,101,253,383.0,344.6,373.2
229,哈尔滨旅游,20220817,331,102,229,354.0,342.0,366.1
230,哈尔滨旅游,20220818,322,114,208,331.0,343.0,353.3
231,哈尔滨旅游,20220819,323,99,224,322.0,342.6,346.4
232,哈尔滨旅游,20220820,285,82,203,323.0,323.0,334.0
233,哈尔滨旅游,20220821,245,72,173,285.0,301.2,322.9
234,哈尔滨旅游,20220822,291,99,192,245.0,293.2,317.6
235,哈尔滨旅游,20220823,297,121,176,291.0,288.2,315.6
236,哈尔滨旅游,20220824,329,104,225,297.0,289.4,316.0
237,哈尔滨旅游,20220825,284,97,187,329.0,289.2,306.1
238,哈尔滨旅游,20220826,338,85,253,284.0,307.8,304.5
239,哈尔滨旅游,20220827,256,74,182,338.0,300.8,297.0
240,哈尔滨旅游,20220828,228,63,165,256.0,287.0,287.6
241,哈尔滨旅游,20220829,194,82,112,228.0,260.0,274.7
242,哈尔滨旅游,20220830,193,87,106,194.0,241.8,265.5
243,哈尔滨旅游,20220831,201,80,121,193.0,214.4,261.1
244,哈尔滨旅游,20220901,197,87,110,201.0,202.6,251.7
245,哈尔滨旅游,20220902,165,76,89,197.0,190.0,238.5
246,哈尔滨旅游,20220903,179,64,115,165.0,187.0,223.5
247,哈尔滨旅游,20220904,192,61,131,179.0,186.8,214.3
248,哈尔滨旅游,20220905,186,76,110,192.0,183.8,199.1
249,哈尔滨旅游,20220906,174,74,100,186.0,179.2,190.9
250,哈尔滨旅游,20220907,193,80,113,174.0,184.8,187.4
251,哈尔滨旅游,20220908,199,82,117,193.0,188.8,187.9
252,哈尔滨旅游,20220909,178,61,117,199.0,186.0,186.4
253,哈尔滨旅游,20220910,173,63,110,178.0,183.4,183.6
254,哈尔滨旅游,20220911,207,68,139,173.0,190.0,184.6
255,哈尔滨旅游,20220912,189,63,126,207.0,189.2,187.0
256,哈尔滨旅游,20220913,221,83,138,189.0,193.6,191.2
257,哈尔滨旅游,20220914,218,83,135,221.0,201.6,193.8
258,哈尔滨旅游,20220915,218,83,135,218.0,210.6,197.0
259,哈尔滨旅游,20220916,228,85,143,218.0,214.8,202.4
260,哈尔滨旅游,20220917,256,70,186,228.0,228.2,208.7
261,哈尔滨旅游,20220918,243,82,161,256.0,232.6,213.1
262,哈尔滨旅游,20220919,276,106,170,243.0,244.2,222.9
263,哈尔滨旅游,20220920,230,89,141,276.0,246.6,228.6
264,哈尔滨旅游,20220921,217,95,122,230.0,244.4,229.6
265,哈尔滨旅游,20220922,229,91,138,217.0,239.0,233.6
266,哈尔滨旅游,20220923,227,93,134,229.0,235.8,234.2
267,哈尔滨旅游,20220924,197,66,131,227.0,220.0,232.1
268,哈尔滨旅游,20220925,215,68,147,197.0,217.0,231.8
269,哈尔滨旅游,20220926,246,108,138,215.0,222.8,233.6
270,哈尔滨旅游,20220927,246,116,130,246.0,226.2,232.6
271,哈尔滨旅游,20220928,204,83,121,246.0,221.6,228.7
272,哈尔滨旅游,20220929,227,76,151,204.0,227.6,223.8
273,哈尔滨旅游,20220930,257,83,174,227.0,236.0,226.5
274,哈尔滨旅游,20221001,194,64,130,257.0,225.6,224.2
275,哈尔滨旅游,20221002,200,74,126,194.0,216.4,221.3
276,哈尔滨旅游,20221003,211,68,143,200.0,217.8,219.7
277,哈尔滨旅游,20221004,194,64,130,211.0,211.2,219.4
278,哈尔滨旅游,20221005,172,64,108,194.0,194.2,215.1
279,哈尔滨旅游,20221006,215,66,149,172.0,198.4,212.0
280,哈尔滨旅游,20221007,264,85,179,215.0,211.2,213.8
281,哈尔滨旅游,20221008,222,101,121,264.0,213.4,215.6
282,哈尔滨旅游,20221009,238,97,141,222.0,222.2,216.7
283,哈尔滨旅游,20221010,206,91,115,238.0,229.0,211.6
284,哈尔滨旅游,20221011,230,95,135,206.0,232.0,215.2
285,哈尔滨旅游,20221012,195,74,121,230.0,218.2,214.7
286,哈尔滨旅游,20221013,189,89,100,195.0,211.6,212.5
287,哈尔滨旅游,20221014,201,89,112,189.0,204.2,213.2
288,哈尔滨旅游,20221015,202,66,136,201.0,203.4,216.2
289,哈尔滨旅游,20221016,188,80,108,202.0,195.0,213.5
290,哈尔滨旅游,20221017,227,101,126,188.0,201.4,209.8
291,哈尔滨旅游,20221018,232,91,141,227.0,210.0,210.8
292,哈尔滨旅游,20221019,208,82,126,232.0,211.4,207.8
293,哈尔滨旅游,20221020,248,104,144,208.0,220.6,212.0
294,哈尔滨旅游,20221021,241,87,154,248.0,231.2,213.1
295,哈尔滨旅游,20221022,213,74,139,241.0,228.4,214.9
296,哈尔滨旅游,20221023,215,72,143,213.0,225.0,217.5
297,哈尔滨旅游,20221024,235,74,161,215.0,230.4,220.9
298,哈尔滨旅游,20221025,221,85,136,235.0,225.0,222.8
299,哈尔滨旅游,20221026,234,99,135,221.0,223.6,227.4
300,哈尔滨旅游,20221027,220,85,135,234.0,225.0,226.7
301,哈尔滨旅游,20221028,208,83,125,220.0,223.6,224.3
302,哈尔滨旅游,20221029,214,78,136,208.0,219.4,224.9
303,哈尔滨旅游,20221030,190,59,131,214.0,213.2,219.1
304,哈尔滨旅游,20221031,217,82,135,190.0,209.8,216.7
305,哈尔滨旅游,20221101,193,80,113,217.0,204.4,214.7
306,哈尔滨旅游,20221102,218,83,135,193.0,206.4,215.0
307,哈尔滨旅游,20221103,198,83,115,218.0,203.2,211.3
308,哈尔滨旅游,20221104,186,74,112,198.0,202.4,207.8
309,哈尔滨旅游,20221105,199,63,136,186.0,198.8,204.3
310,哈尔滨旅游,20221106,209,66,143,199.0,202.0,203.2
311,哈尔滨旅游,20221107,229,101,128,209.0,204.2,205.3
312,哈尔滨旅游,20221108,206,89,117,229.0,205.8,204.5
313,哈尔滨旅游,20221109,216,82,134,206.0,211.8,207.1
314,哈尔滨旅游,20221110,190,78,112,216.0,210.0,204.4
315,哈尔滨旅游,20221111,215,74,141,190.0,211.2,206.6
316,哈尔滨旅游,20221112,220,63,157,215.0,209.4,206.8
317,哈尔滨旅游,20221113,223,66,157,220.0,212.8,209.3
318,哈尔滨旅游,20221114,247,102,145,223.0,219.0,215.4
319,哈尔滨旅游,20221115,229,106,123,247.0,226.8,218.4
320,哈尔滨旅游,20221116,255,110,145,229.0,234.8,223.0
321,哈尔滨旅游,20221117,275,110,165,255.0,245.8,227.6
322,哈尔滨旅游,20221118,260,97,163,275.0,253.2,233.0
323,哈尔滨旅游,20221119,233,78,155,260.0,250.4,234.7
324,哈尔滨旅游,20221120,238,72,166,233.0,252.2,239.5
325,哈尔滨旅游,20221121,260,97,163,238.0,253.2,244.0
326,哈尔滨旅游,20221122,252,91,161,260.0,248.6,247.2
327,哈尔滨旅游,20221123,224,85,139,252.0,241.4,247.3
328,哈尔滨旅游,20221124,213,70,143,224.0,237.4,243.9
329,哈尔滨旅游,20221125,217,85,132,213.0,233.2,242.7
330,哈尔滨旅游,20221126,190,68,122,217.0,219.2,236.2
331,哈尔滨旅游,20221127,131,0,131,190.0,195.0,221.8
332,哈尔滨旅游,20221128,242,99,143,131.0,198.6,220.0
333,哈尔滨旅游,20221129,204,78,126,242.0,196.8,217.1
334,哈尔滨旅游,20221130,199,78,121,204.0,193.2,213.2
335,哈尔滨旅游,20221201,209,78,131,199.0,197.0,208.1
336,哈尔滨旅游,20221202,230,87,143,209.0,216.8,205.9
337,哈尔滨旅游,20221203,227,82,145,230.0,213.8,206.2
338,哈尔滨旅游,20221204,219,78,141,227.0,216.8,206.8
339,哈尔滨旅游,20221205,335,108,227,219.0,244.0,218.6
340,哈尔滨旅游,20221206,319,118,201,335.0,266.0,231.5
341,哈尔滨旅游,20221207,333,135,198,319.0,286.6,251.7
342,哈尔滨旅游,20221208,405,142,263,333.0,322.2,268.0
343,哈尔滨旅游,20221209,328,133,195,405.0,344.0,280.4
344,哈尔滨旅游,20221210,292,95,197,328.0,335.4,289.7
345,哈尔滨旅游,20221211,287,91,196,292.0,329.0,297.5
346,哈尔滨旅游,20221212,333,127,206,287.0,329.0,307.8
347,哈尔滨旅游,20221213,313,120,193,333.0,310.6,316.4
348,哈尔滨旅游,20221214,294,108,186,313.0,303.8,323.9
349,哈尔滨旅游,20221215,314,148,166,294.0,308.2,321.8
350,哈尔滨旅游,20221216,259,102,157,314.0,302.6,315.8
351,哈尔滨旅游,20221217,241,82,159,259.0,284.2,306.6
352,哈尔滨旅游,20221218,253,76,177,241.0,272.2,291.4
353,哈尔滨旅游,20221219,288,112,176,253.0,271.0,287.4
354,哈尔滨旅游,20221220,256,93,163,288.0,259.4,283.8
355,哈尔滨旅游,20221221,311,112,199,256.0,269.8,286.2
356,哈尔滨旅游,20221222,288,114,174,311.0,279.2,281.7
357,哈尔滨旅游,20221223,330,102,228,288.0,294.6,283.4
358,哈尔滨旅游,20221224,270,83,187,330.0,291.0,281.0
359,哈尔滨旅游,20221225,348,87,261,270.0,309.4,284.4
360,哈尔滨旅游,20221226,399,139,260,348.0,327.0,298.4
361,哈尔滨旅游,20221227,429,154,275,399.0,355.2,317.2
362,哈尔滨旅游,20221228,409,140,269,429.0,371.0,332.8
363,哈尔滨旅游,20221229,429,175,254,409.0,402.8,346.9
364,哈尔滨旅游,20221230,378,131,247,429.0,408.8,359.1
365,哈尔滨旅游,20221231,359,91,268,378.0,400.8,363.9
366,哈尔滨旅游,20230101,355,93,262,359.0,386.0,370.6
367,哈尔滨旅游,20230102,390,102,288,355.0,382.2,376.6
368,哈尔滨旅游,20230103,460,159,301,390.0,388.4,395.6
369,哈尔滨旅游,20230104,473,182,291,460.0,407.4,408.1
370,哈尔滨旅游,20230105,524,175,349,473.0,440.4,420.6
371,哈尔滨旅游,20230106,517,179,338,524.0,472.8,429.4
372,哈尔滨旅游,20230107,482,129,353,517.0,491.2,436.7
373,哈尔滨旅游,20230108,491,110,381,482.0,497.4,442.9
374,哈尔滨旅游,20230109,556,191,365,491.0,514.0,460.7
375,哈尔滨旅游,20230110,510,172,338,556.0,511.2,475.8
376,哈尔滨旅游,20230111,573,155,418,510.0,522.4,497.6
377,哈尔滨旅游,20230112,561,163,398,573.0,538.2,514.7
378,哈尔滨旅游,20230113,703,142,561,561.0,580.6,539.0
379,哈尔滨旅游,20230114,638,110,528,703.0,597.0,555.5
380,哈尔滨旅游,20230115,782,118,664,638.0,651.4,581.3
381,哈尔滨旅游,20230116,654,162,492,782.0,667.6,595.0
382,哈尔滨旅游,20230117,769,177,592,654.0,709.2,623.7
383,哈尔滨旅游,20230118,992,151,841,769.0,767.0,673.8
384,哈尔滨旅游,20230119,601,133,468,992.0,759.6,678.3
385,哈尔滨旅游,20230120,559,91,468,601.0,715.0,683.2
386,哈尔滨旅游,20230121,360,80,280,559.0,656.2,661.9
387,哈尔滨旅游,20230122,1071,87,984,360.0,716.6,712.9
388,哈尔滨旅游,20230123,735,78,657,1071.0,665.2,716.1
389,哈尔滨旅游,20230124,725,112,613,735.0,690.0,724.8
390,哈尔滨旅游,20230125,561,89,472,725.0,690.4,702.7
391,哈尔滨旅游,20230126,566,87,479,561.0,731.6,693.9
392,哈尔滨旅游,20230127,595,91,504,566.0,636.4,676.5
393,哈尔滨旅游,20230128,644,157,487,595.0,618.2,641.7
394,哈尔滨旅游,20230129,620,162,458,644.0,597.2,643.6
395,哈尔滨旅游,20230130,574,144,430,620.0,599.8,645.1
396,哈尔滨旅游,20230131,544,112,432,574.0,595.4,663.5
397,哈尔滨旅游,20230201,560,123,437,544.0,588.4,612.4
398,哈尔滨旅游,20230202,485,116,369,560.0,556.6,587.4
399,哈尔滨旅游,20230203,482,112,370,485.0,529.0,563.1
400,哈尔滨旅游,20230204,548,76,472,482.0,523.8,561.8
401,哈尔滨旅游,20230205,511,74,437,548.0,517.2,556.3
402,哈尔滨旅游,20230206,442,112,330,511.0,493.6,541.0
403,哈尔滨旅游,20230207,494,110,384,442.0,495.4,526.0
404,哈尔滨旅游,20230208,451,82,369,494.0,489.2,509.1
405,哈尔滨旅游,20230209,443,102,341,451.0,468.2,496.0
406,哈尔滨旅游,20230210,451,89,362,443.0,456.2,486.7
407,哈尔滨旅游,20230211,482,74,408,451.0,464.2,478.9
408,哈尔滨旅游,20230212,372,76,296,482.0,439.8,467.6
409,哈尔滨旅游,20230213,398,91,307,372.0,429.2,459.2
410,哈尔滨旅游,20230214,418,80,338,398.0,424.2,446.2
411,哈尔滨旅游,20230215,391,93,298,418.0,412.2,434.2
412,哈尔滨旅游,20230216,352,85,267,391.0,386.2,425.2
413,哈尔滨旅游,20230217,382,87,295,352.0,388.2,414.0
414,哈尔滨旅游,20230218,421,72,349,382.0,392.8,411.0
415,哈尔滨旅游,20230219,519,76,443,421.0,413.0,418.6
416,哈尔滨旅游,20230220,430,85,345,519.0,420.8,416.5
417,哈尔滨旅游,20230221,902,104,798,430.0,530.8,458.5
418,哈尔滨旅游,20230222,679,101,578,902.0,590.2,489.2
419,哈尔滨旅游,20230223,967,87,880,679.0,699.4,546.1
420,哈尔滨旅游,20230224,396,83,313,967.0,674.8,543.9
421,哈尔滨旅游,20230225,314,66,248,396.0,651.6,536.2
422,哈尔滨旅游,20230226,263,74,189,314.0,523.8,527.3
423,哈尔滨旅游,20230227,374,80,294,263.0,462.8,526.5
424,哈尔滨旅游,20230228,368,97,271,374.0,343.0,521.2
425,哈尔滨旅游,20230301,457,76,381,368.0,355.2,515.0
426,哈尔滨旅游,20230302,328,74,254,457.0,358.0,504.8
427,哈尔滨旅游,20230303,263,89,174,328.0,358.0,440.9
428,哈尔滨旅游,20230304,234,80,154,263.0,330.0,396.4
429,哈尔滨旅游,20230305,227,63,164,234.0,301.8,322.4
430,哈尔滨旅游,20230306,240,83,157,227.0,258.4,306.8
431,哈尔滨旅游,20230307,230,85,145,240.0,238.8,298.4
432,哈尔滨旅游,20230308,217,72,145,230.0,229.6,293.8
433,哈尔滨旅游,20230309,236,82,154,217.0,230.0,280.0
434,哈尔滨旅游,20230310,221,66,155,236.0,228.8,265.3
435,哈尔滨旅游,20230311,211,64,147,221.0,223.0,240.7
436,哈尔滨旅游,20230312,265,66,199,211.0,230.0,234.4
437,哈尔滨旅游,20230313,258,85,173,265.0,238.2,233.9
438,哈尔滨旅游,20230314,248,85,163,258.0,240.6,235.3
439,哈尔滨旅游,20230315,258,85,173,248.0,248.0,238.4
440,哈尔滨旅游,20230316,275,101,174,258.0,260.8,241.9
441,哈尔滨旅游,20230317,269,89,180,275.0,261.6,245.8
442,哈尔滨旅游,20230318,261,64,197,269.0,262.2,250.2
443,哈尔滨旅游,20230319,232,70,162,261.0,259.0,249.8
444,哈尔滨旅游,20230320,281,95,186,232.0,263.6,255.8
445,哈尔滨旅游,20230321,286,101,185,281.0,265.8,263.3
446,哈尔滨旅游,20230322,268,95,173,286.0,265.6,263.6
447,哈尔滨旅游,20230323,262,102,160,268.0,265.8,264.0
448,哈尔滨旅游,20230324,280,99,181,262.0,275.4,267.2
449,哈尔滨旅游,20230325,248,78,170,280.0,268.8,266.2
450,哈尔滨旅游,20230326,275,85,190,248.0,266.6,266.2
451,哈尔滨旅游,20230327,288,104,184,275.0,270.6,268.1
452,哈尔滨旅游,20230328,288,108,180,288.0,275.8,270.8
453,哈尔滨旅游,20230329,317,125,192,288.0,283.2,279.3
454,哈尔滨旅游,20230330,311,135,176,317.0,295.8,282.3
455,哈尔滨旅游,20230331,299,112,187,311.0,300.6,283.6
456,哈尔滨旅游,20230401,272,76,196,299.0,297.4,284.0
457,哈尔滨旅游,20230402,265,68,197,272.0,292.8,284.3
458,哈尔滨旅游,20230403,325,121,204,265.0,294.4,288.8
459,哈尔滨旅游,20230404,343,104,239,325.0,300.8,298.3
460,哈尔滨旅游,20230405,289,83,206,343.0,298.8,299.7
461,哈尔滨旅游,20230406,309,104,205,289.0,306.2,301.8
462,哈尔滨旅游,20230407,312,133,179,309.0,315.6,304.2
463,哈尔滨旅游,20230408,283,85,198,312.0,307.2,300.8
464,哈尔滨旅游,20230409,282,70,212,283.0,295.0,297.9
465,哈尔滨旅游,20230410,343,125,218,282.0,305.8,302.3
466,哈尔滨旅游,20230411,313,120,193,343.0,306.6,306.4
467,哈尔滨旅游,20230412,322,129,193,313.0,308.6,312.1
468,哈尔滨旅游,20230413,321,129,192,322.0,316.2,311.7
469,哈尔滨旅游,20230414,350,116,234,321.0,329.8,312.4
470,哈尔滨旅游,20230415,292,87,205,350.0,319.6,312.7
471,哈尔滨旅游,20230416,317,82,235,292.0,320.4,313.5
472,哈尔滨旅游,20230417,364,137,227,317.0,328.8,318.7
473,哈尔滨旅游,20230418,335,118,217,364.0,331.6,323.9
474,哈尔滨旅游,20230419,343,118,225,335.0,330.2,330.0
475,哈尔滨旅游,20230420,375,137,238,343.0,346.8,333.2
476,哈尔滨旅游,20230421,356,118,238,375.0,354.6,337.5
477,哈尔滨旅游,20230422,341,95,246,356.0,350.0,339.4
478,哈尔滨旅游,20230423,346,121,225,341.0,352.2,341.9
479,哈尔滨旅游,20230424,340,120,220,346.0,351.6,340.9
480,哈尔滨旅游,20230425,538,116,422,340.0,384.2,365.5
481,哈尔滨旅游,20230426,380,127,253,538.0,389.0,371.8
482,哈尔滨旅游,20230427,402,135,267,380.0,401.2,375.6
483,哈尔滨旅游,20230428,433,110,323,402.0,418.6,385.4
484,哈尔滨旅游,20230429,451,74,377,433.0,440.8,396.2
485,哈尔滨旅游,20230430,489,83,406,451.0,431.0,407.6
486,哈尔滨旅游,20230501,504,72,432,489.0,455.8,422.4
487,哈尔滨旅游,20230502,324,68,256,504.0,440.2,420.7
488,哈尔滨旅游,20230503,291,74,217,324.0,411.8,415.2
489,哈尔滨旅游,20230504,307,121,186,291.0,383.0,411.9
490,哈尔滨旅游,20230505,280,110,170,307.0,341.2,386.1
491,哈尔滨旅游,20230506,258,99,159,280.0,292.0,373.9
492,哈尔滨旅游,20230507,263,80,183,258.0,279.8,360.0
493,哈尔滨旅游,20230508,275,101,174,263.0,276.6,344.2
494,哈尔滨旅游,20230509,271,89,182,275.0,269.4,326.2
495,哈尔滨旅游,20230510,289,112,177,271.0,271.2,306.2
496,哈尔滨旅游,20230511,254,99,155,289.0,270.4,281.2
497,哈尔滨旅游,20230512,270,102,168,254.0,271.8,275.8
498,哈尔滨旅游,20230513,262,78,184,270.0,269.2,272.9
499,哈尔滨旅游,20230514,284,76,208,262.0,271.8,270.6
500,哈尔滨旅游,20230515,289,102,187,284.0,271.8,271.5
501,哈尔滨旅游,20230516,260,89,171,289.0,273.0,271.7
502,哈尔滨旅游,20230517,266,85,181,260.0,272.2,272.0
503,哈尔滨旅游,20230518,283,110,173,266.0,276.4,272.8
504,哈尔滨旅游,20230519,259,89,170,283.0,271.4,271.6
505,哈尔滨旅游,20230520,261,72,189,259.0,265.8,268.8
506,哈尔滨旅游,20230521,234,61,173,261.0,260.6,266.8
507,哈尔滨旅游,20230522,246,85,161,234.0,256.6,264.4
508,哈尔滨旅游,20230523,279,82,197,246.0,255.8,266.1
509,哈尔滨旅游,20230524,295,106,189,279.0,263.0,267.2
510,哈尔滨旅游,20230525,254,83,171,295.0,261.6,263.7
511,哈尔滨旅游,20230526,238,83,155,254.0,262.4,261.5
512,哈尔滨旅游,20230527,267,74,193,238.0,266.6,261.6
513,哈尔滨旅游,20230528,288,74,214,267.0,268.4,262.1
514,哈尔滨旅游,20230529,320,125,195,288.0,273.4,268.2
515,哈尔滨旅游,20230530,270,97,173,320.0,276.6,269.1
516,哈尔滨旅游,20230531,281,99,182,270.0,285.2,273.8
517,哈尔滨旅游,20230601,244,93,151,281.0,280.6,273.6
518,哈尔滨旅游,20230602,317,106,211,244.0,286.4,277.4
519,哈尔滨旅游,20230603,278,85,193,317.0,278.0,275.7
520,哈尔滨旅游,20230604,273,72,201,278.0,278.6,277.6
521,哈尔滨旅游,20230605,311,116,195,273.0,284.6,284.9
522,哈尔滨旅游,20230606,311,121,190,311.0,298.0,289.3
523,哈尔滨旅游,20230607,331,123,208,311.0,300.8,293.6
524,哈尔滨旅游,20230608,344,139,205,331.0,314.0,296.0
525,哈尔滨旅游,20230609,330,129,201,344.0,325.4,302.0
526,哈尔滨旅游,20230610,272,76,196,330.0,317.6,301.1
527,哈尔滨旅游,20230611,344,80,264,272.0,324.2,311.1
528,哈尔滨旅游,20230612,340,118,222,344.0,326.0,313.4
529,哈尔滨旅游,20230613,389,155,234,340.0,335.0,324.5
530,哈尔滨旅游,20230614,367,140,227,389.0,342.4,333.9
531,哈尔滨旅游,20230615,349,125,224,367.0,357.8,337.7
532,哈尔滨旅游,20230616,342,108,234,349.0,357.4,340.8
533,哈尔滨旅游,20230617,334,95,239,342.0,356.2,341.1
534,哈尔滨旅游,20230618,359,91,268,334.0,350.2,342.6
535,哈尔滨旅游,20230619,358,140,218,359.0,348.4,345.4
536,哈尔滨旅游,20230620,389,144,245,358.0,356.4,357.1
537,哈尔滨旅游,20230621,421,125,296,389.0,372.2,364.8
538,哈尔滨旅游,20230622,384,78,306,421.0,382.2,369.2
539,哈尔滨旅游,20230623,345,76,269,384.0,379.4,364.8
540,哈尔滨旅游,20230624,391,93,298,345.0,386.0,367.2
541,哈尔滨旅游,20230625,432,154,278,391.0,394.6,375.5
542,哈尔滨旅游,20230626,405,148,257,432.0,391.4,381.8
543,哈尔滨旅游,20230627,465,158,307,405.0,407.6,394.9
544,哈尔滨旅游,20230628,445,161,284,465.0,427.6,403.5
545,哈尔滨旅游,20230629,466,135,331,445.0,442.6,414.3
546,哈尔滨旅游,20230630,435,129,306,466.0,443.2,418.9
547,哈尔滨旅游,20230701,457,87,370,435.0,453.6,422.5
548,哈尔滨旅游,20230702,415,78,337,457.0,443.6,425.6
549,哈尔滨旅游,20230703,526,157,369,415.0,459.8,443.7
550,哈尔滨旅游,20230704,502,161,341,526.0,467.0,454.8
551,哈尔滨旅游,20230705,544,177,367,502.0,488.8,466.0
552,哈尔滨旅游,20230706,442,133,309,544.0,485.8,469.7
553,哈尔滨旅游,20230707,551,175,376,442.0,513.0,478.3
554,哈尔滨旅游,20230708,469,99,370,551.0,501.6,480.7
555,哈尔滨旅游,20230709,514,110,404,469.0,504.0,485.5
556,哈尔滨旅游,20230710,673,216,457,514.0,529.8,509.3
557,哈尔滨旅游,20230711,570,159,411,673.0,555.4,520.6
558,哈尔滨旅游,20230712,575,170,405,570.0,560.2,536.6
559,哈尔滨旅游,20230713,525,169,356,575.0,571.4,536.5
560,哈尔滨旅游,20230714,551,168,383,525.0,578.8,541.4
561,哈尔滨旅游,20230715,709,114,595,551.0,586.0,557.9
562,哈尔滨旅游,20230716,651,101,550,709.0,602.2,578.8
563,哈尔滨旅游,20230717,623,175,448,651.0,611.8,586.0
564,哈尔滨旅游,20230718,658,180,478,623.0,638.4,604.9
565,哈尔滨旅游,20230719,568,142,426,658.0,641.8,610.3
566,哈尔滨旅游,20230720,588,158,430,568.0,617.6,601.8
567,哈尔滨旅游,20230721,609,159,450,588.0,609.2,605.7
568,哈尔滨旅游,20230722,538,101,437,609.0,592.2,602.0
569,哈尔滨旅游,20230723,543,106,437,538.0,569.2,603.8
570,哈尔滨旅游,20230724,648,197,451,543.0,585.2,613.5
571,哈尔滨旅游,20230725,626,197,429,648.0,592.8,605.2
572,哈尔滨旅游,20230726,621,163,458,626.0,595.2,602.2
573,哈尔滨旅游,20230727,585,159,426,621.0,604.6,598.4
574,哈尔滨旅游,20230728,614,154,460,585.0,618.8,594.0
575,哈尔滨旅游,20230729,799,101,698,614.0,649.0,617.1
576,哈尔滨旅游,20230730,731,93,638,799.0,670.0,631.4
577,哈尔滨旅游,20230731,853,157,696,731.0,716.4,655.8
578,哈尔滨旅游,20230801,674,162,512,853.0,734.2,669.4
579,哈尔滨旅游,20230802,511,159,352,674.0,713.6,666.2
580,哈尔滨旅游,20230803,743,179,564,511.0,702.4,675.7
581,哈尔滨旅游,20230804,835,146,689,743.0,723.2,696.6
582,哈尔滨旅游,20230805,572,82,490,835.0,667.0,691.7
583,哈尔滨旅游,20230806,544,76,468,572.0,641.0,687.6
584,哈尔滨旅游,20230807,606,133,473,544.0,660.0,686.8
585,哈尔滨旅游,20230808,602,123,479,606.0,631.8,667.1
586,哈尔滨旅游,20230809,589,121,468,602.0,582.6,652.9
587,哈尔滨旅游,20230810,627,106,521,589.0,593.6,630.3
588,哈尔滨旅游,20230811,541,127,414,627.0,593.0,617.0
589,哈尔滨旅游,20230812,475,91,384,541.0,566.8,613.4
590,哈尔滨旅游,20230813,515,85,430,475.0,549.4,590.6
591,哈尔滨旅游,20230814,629,157,472,515.0,557.4,570.0
592,哈尔滨旅游,20230815,546,139,407,629.0,541.2,567.4
593,哈尔滨旅游,20230816,519,131,388,546.0,536.8,564.9
594,哈尔滨旅游,20230817,607,131,476,519.0,563.2,565.0
595,哈尔滨旅游,20230818,574,131,443,607.0,575.0,562.2
596,哈尔滨旅游,20230819,405,82,323,574.0,530.2,543.8
597,哈尔滨旅游,20230820,445,83,362,405.0,510.0,525.6
598,哈尔滨旅游,20230821,479,123,356,445.0,502.0,519.4
599,哈尔滨旅游,20230822,437,114,323,479.0,468.0,515.6
600,哈尔滨旅游,20230823,465,116,349,437.0,446.2,510.6
601,哈尔滨旅游,20230824,412,116,296,465.0,447.6,488.9
602,哈尔滨旅游,20230825,428,120,308,412.0,444.2,477.1
603,哈尔滨旅游,20230826,458,74,384,428.0,440.0,471.0
604,哈尔滨旅游,20230827,423,83,340,458.0,437.2,452.6
605,哈尔滨旅游,20230828,496,127,369,423.0,443.4,444.8
606,哈尔滨旅游,20230829,952,110,842,496.0,551.4,499.5
607,哈尔滨旅游,20230830,428,114,314,952.0,551.4,497.8
608,哈尔滨旅游,20230831,548,114,434,428.0,569.4,504.7
609,哈尔滨旅游,20230901,406,101,305,548.0,566.0,501.6
610,哈尔滨旅游,20230902,295,74,221,406.0,525.8,484.6
611,哈尔滨旅游,20230903,294,80,214,295.0,394.2,472.8
612,哈尔滨旅游,20230904,359,137,222,294.0,380.4,465.9
613,哈尔滨旅游,20230905,376,121,255,359.0,346.0,457.7
614,哈尔滨旅游,20230906,312,104,208,376.0,327.2,446.6
615,哈尔滨旅游,20230907,304,133,171,312.0,329.0,427.4
616,哈尔滨旅游,20230908,320,120,200,304.0,334.2,364.2
617,哈尔滨旅游,20230909,336,87,249,320.0,329.6,355.0
618,哈尔滨旅游,20230910,288,85,203,336.0,312.0,329.0
619,哈尔滨旅游,20230911,357,139,218,288.0,321.0,324.1
620,哈尔滨旅游,20230912,356,142,214,357.0,331.4,330.2
621,哈尔滨旅游,20230913,348,137,211,356.0,337.0,335.6
622,哈尔滨旅游,20230914,394,169,225,348.0,348.6,339.1
623,哈尔滨旅游,20230915,362,127,235,394.0,363.4,337.7
624,哈尔滨旅游,20230916,292,93,199,362.0,350.4,335.7
625,哈尔滨旅游,20230917,348,89,259,292.0,348.8,340.1
626,哈尔滨旅游,20230918,383,159,224,348.0,355.8,346.4
627,哈尔滨旅游,20230919,375,144,231,383.0,352.0,350.3
628,哈尔滨旅游,20230920,333,121,212,375.0,346.2,354.8
629,哈尔滨旅游,20230921,397,137,260,333.0,367.2,358.8
630,哈尔滨旅游,20230922,350,123,227,397.0,367.6,358.2
631,哈尔滨旅游,20230923,324,76,248,350.0,355.8,355.8
632,哈尔滨旅游,20230924,307,80,227,324.0,342.2,347.1
633,哈尔滨旅游,20230925,362,162,200,307.0,348.0,347.1
634,哈尔滨旅游,20230926,358,152,206,362.0,340.2,353.7
635,哈尔滨旅游,20230927,407,161,246,358.0,351.6,359.6
636,哈尔滨旅游,20230928,427,173,254,407.0,372.2,364.0
637,哈尔滨旅游,20230929,365,76,289,427.0,383.8,363.0
638,哈尔滨旅游,20230930,456,93,363,365.0,402.6,375.3
639,哈尔滨旅游,20231001,455,89,366,456.0,422.0,381.1
640,哈尔滨旅游,20231002,436,70,366,455.0,427.8,389.7
641,哈尔滨旅游,20231003,383,82,301,436.0,419.0,395.6
642,哈尔滨旅游,20231004,346,80,266,383.0,415.2,399.5
643,哈尔滨旅游,20231005,308,76,232,346.0,385.6,394.1
644,哈尔滨旅游,20231006,313,93,220,308.0,357.2,389.6
645,哈尔滨旅游,20231007,393,173,220,313.0,348.6,388.2
646,哈尔滨旅游,20231008,407,180,227,393.0,353.4,386.2
647,哈尔滨旅游,20231009,386,175,211,407.0,361.4,388.3
648,哈尔滨旅游,20231010,347,139,208,386.0,369.2,377.4
649,哈尔滨旅游,20231011,343,137,206,347.0,375.2,366.2
650,哈尔滨旅游,20231012,720,146,574,343.0,440.6,394.6
651,哈尔滨旅游,20231013,460,159,301,720.0,451.2,402.3
652,哈尔滨旅游,20231014,388,93,295,460.0,451.6,406.5
653,哈尔滨旅游,20231015,369,82,287,388.0,456.0,412.6
654,哈尔滨旅游,20231016,470,209,261,369.0,481.4,428.3
655,哈尔滨旅游,20231017,492,166,326,470.0,435.8,438.2
656,哈尔滨旅游,20231018,520,180,340,492.0,447.8,449.5
657,哈尔滨旅游,20231019,504,183,321,520.0,471.0,461.3
658,哈尔滨旅游,20231020,394,175,219,504.0,476.0,466.0
659,哈尔滨旅游,20231021,340,102,238,394.0,450.0,465.7
660,哈尔滨旅游,20231022,311,87,224,340.0,413.8,424.8
661,哈尔滨旅游,20231023,394,180,214,311.0,388.6,418.2
662,哈尔滨旅游,20231024,451,166,285,394.0,378.0,424.5
663,哈尔滨旅游,20231025,456,187,269,451.0,390.4,433.2
664,哈尔滨旅游,20231026,478,168,310,456.0,418.0,434.0
665,哈尔滨旅游,20231027,500,183,317,478.0,455.8,434.8
666,哈尔滨旅游,20231028,505,104,401,500.0,478.0,433.3
667,哈尔滨旅游,20231029,423,106,317,505.0,472.4,425.2
668,哈尔滨旅游,20231030,545,183,362,423.0,490.2,440.3
669,哈尔滨旅游,20231031,576,204,372,545.0,509.8,463.9
670,哈尔滨旅游,20231101,538,158,380,576.0,517.4,486.6
671,哈尔滨旅游,20231102,574,194,380,538.0,531.2,504.6
672,哈尔滨旅游,20231103,575,176,399,574.0,561.6,517.0
673,哈尔滨旅游,20231104,414,102,312,575.0,535.4,512.8
674,哈尔滨旅游,20231105,469,114,355,414.0,514.0,511.9
675,哈尔滨旅游,20231106,682,243,439,469.0,542.8,530.1
676,哈尔滨旅游,20231107,624,229,395,682.0,552.8,542.0
677,哈尔滨旅游,20231108,742,234,508,624.0,586.2,573.9
678,哈尔滨旅游,20231109,755,212,543,742.0,654.4,594.9
679,哈尔滨旅游,20231110,873,207,666,755.0,735.2,624.6
680,哈尔滨旅游,20231111,580,108,472,873.0,714.8,628.8
681,哈尔滨旅游,20231112,682,131,551,580.0,726.4,639.6
682,哈尔滨旅游,20231113,871,346,525,682.0,752.2,669.2
683,哈尔滨旅游,20231114,863,273,590,871.0,773.8,714.1
684,哈尔滨旅游,20231115,726,234,492,863.0,744.4,739.8
685,哈尔滨旅游,20231116,733,211,522,726.0,775.0,744.9
686,哈尔滨旅游,20231117,910,166,744,733.0,820.6,773.5
687,哈尔滨旅游,20231118,710,97,613,910.0,788.4,770.3
688,哈尔滨旅游,20231119,677,106,571,710.0,751.2,762.5
689,哈尔滨旅游,20231120,867,240,627,677.0,779.4,761.9
690,哈尔滨旅游,20231121,846,216,630,867.0,802.0,788.5
691,哈尔滨旅游,20231122,842,247,595,846.0,788.4,804.5
692,哈尔滨旅游,20231123,710,223,487,842.0,788.4,788.4
693,哈尔滨旅游,20231124,827,207,620,710.0,818.4,784.8
694,哈尔滨旅游,20231125,705,110,595,827.0,786.0,782.7
695,哈尔滨旅游,20231126,822,99,723,705.0,781.2,791.6
696,哈尔滨旅游,20231127,884,245,639,822.0,789.6,789.0
697,哈尔滨旅游,20231128,728,209,519,884.0,793.2,790.8
698,哈尔滨旅游,20231129,892,225,667,728.0,806.2,812.3
699,哈尔滨旅游,20231130,1083,234,849,892.0,881.8,833.9
700,哈尔滨旅游,20231201,852,172,680,1083.0,887.8,834.5
701,哈尔滨旅游,20231202,853,108,745,852.0,881.6,835.6
702,哈尔滨旅游,20231203,848,114,734,853.0,905.6,849.4
703,哈尔滨旅游,20231204,953,245,708,848.0,917.8,862.0
704,哈尔滨旅游,20231205,956,229,727,953.0,892.4,887.1
705,哈尔滨旅游,20231206,883,226,657,956.0,898.6,893.2
706,哈尔滨旅游,20231207,959,211,748,883.0,919.8,900.7
707,哈尔滨旅游,20231208,780,163,617,959.0,906.2,905.9
708,哈尔滨旅游,20231209,896,106,790,780.0,894.8,906.3
709,哈尔滨旅游,20231210,778,108,670,896.0,859.2,875.8
710,哈尔滨旅游,20231211,769,223,546,778.0,836.4,867.5
711,哈尔滨旅游,20231212,724,233,491,769.0,789.4,854.6
712,哈尔滨旅游,20231213,837,212,625,724.0,800.8,853.5
713,哈尔滨旅游,20231214,1060,239,821,837.0,833.6,864.2
714,哈尔滨旅游,20231215,7887,198,7689,1060.0,2255.4,1557.3
715,哈尔滨旅游,20231216,1069,102,967,7887.0,2315.4,1575.9
716,哈尔滨旅游,20231217,772,120,652,1069.0,2325.0,1557.2
717,哈尔滨旅游,20231218,814,216,598,772.0,2320.4,1560.6
718,哈尔滨旅游,20231219,735,213,522,814.0,2255.4,1544.5
719,哈尔滨旅游,20231220,744,215,529,735.0,826.8,1541.1
720,哈尔滨旅游,20231221,890,180,710,744.0,791.0,1553.2
721,哈尔滨旅游,20231222,731,161,570,890.0,782.8,1553.9
722,哈尔滨旅游,20231223,738,106,632,731.0,767.6,1544.0
723,哈尔滨旅游,20231224,695,121,574,738.0,759.6,1507.5
724,哈尔滨旅游,20231225,1070,251,819,695.0,824.8,825.8
725,哈尔滨旅游,20231226,946,257,689,1070.0,836.0,813.5
726,哈尔滨旅游,20231227,1086,228,858,946.0,907.0,844.9
727,哈尔滨旅游,20231228,1022,218,804,1086.0,963.8,865.7
728,哈尔滨旅游,20231229,943,180,763,1022.0,1013.4,886.5
729,哈尔滨旅游,20231230,911,184,727,943.0,981.6,903.2
730,哈尔滨旅游,20231231,998,148,850,911.0,992.0,914.0
731,哈尔滨旅游,20240101,1069,175,894,998.0,988.6,947.8
732,哈尔滨旅游,20240102,1696,806,890,1069.0,1123.4,1043.6
733,哈尔滨旅游,20240103,1788,846,942,1696.0,1292.4,1152.9
734,哈尔滨旅游,20240104,2282,860,1422,1788.0,1566.6,1274.1
735,哈尔滨旅游,20240105,1990,774,1216,2282.0,1765.0,1378.5
736,哈尔滨旅游,20240106,1521,377,1144,1990.0,1855.4,1422.0
737,哈尔滨旅游,20240107,2017,408,1609,1521.0,1919.6,1521.5
738,哈尔滨旅游,20240108,2301,735,1566,2017.0,2022.2,1657.3
739,哈尔滨旅游,20240109,5600,628,4972,2301.0,2685.8,2126.2
740,哈尔滨旅游,20240110,1796,537,1259,5600.0,2647.0,2206.0
741,哈尔滨旅游,20240111,1599,523,1076,1796.0,2662.6,2259.0
742,哈尔滨旅游,20240112,2033,425,1608,1599.0,2665.8,2292.7
743,哈尔滨旅游,20240113,1589,250,1339,2033.0,2523.4,2272.8
744,哈尔滨旅游,20240114,2015,260,1755,1589.0,1806.4,2246.1
745,哈尔滨旅游,20240115,1739,439,1300,2015.0,1795.0,2221.0
746,哈尔滨旅游,20240116,4328,430,3898,1739.0,2340.8,2501.7
747,哈尔滨旅游,20240117,3744,402,3342,4328.0,2683.0,2674.4
748,哈尔滨旅游,20240118,3235,287,2948,3744.0,3012.2,2767.8
749,哈尔滨旅游,20240119,2879,330,2549,3235.0,3185.0,2495.7
750,哈尔滨旅游,20240120,1628,188,1440,2879.0,3162.8,2478.9
751,哈尔滨旅游,20240121,2117,228,1889,1628.0,2720.6,2530.7
752,哈尔滨旅游,20240122,1999,318,1681,2117.0,2371.6,2527.3
753,哈尔滨旅游,20240123,3233,330,2903,1999.0,2371.2,2691.7
754,哈尔滨旅游,20240124,3939,279,3660,3233.0,2583.2,2884.1
755,哈尔滨旅游,20240125,6261,213,6048,3939.0,3509.8,3336.3
756,哈尔滨旅游,20240126,6288,208,6080,6261.0,4344.0,3532.3
757,哈尔滨旅游,20240127,4100,169,3931,6288.0,4764.2,3567.9
758,哈尔滨旅游,20240128,3448,168,3280,4100.0,4807.2,3589.2
759,哈尔滨旅游,20240129,5510,288,5222,3448.0,5121.4,3852.3
760,哈尔滨旅游,20240130,10508,237,10271,5510.0,5970.8,4740.3
761,哈尔滨旅游,20240131,10790,281,10509,10508.0,6871.2,5607.6
762,哈尔滨旅游,20240201,10885,212,10673,10790.0,8228.2,6496.2
763,哈尔滨旅游,20240202,15226,301,14925,10885.0,10583.8,7695.5
764,哈尔滨旅游,20240203,16510,168,16342,15226.0,12783.8,8952.6
765,哈尔滨旅游,20240204,18819,364,18455,16510.0,14446.0,10208.4
766,哈尔滨旅游,20240205,18387,225,18162,18819.0,15965.4,11418.3
767,哈尔滨旅游,20240206,15836,169,15667,18387.0,16955.6,12591.9
768,哈尔滨旅游,20240207,15827,144,15683,15836.0,17075.8,13829.8
769,哈尔滨旅游,20240208,13612,148,13464,15827.0,16496.2,14640.0
770,哈尔滨旅游,20240209,12813,110,12703,13612.0,15295.0,14870.5
771,哈尔滨旅游,20240210,11200,85,11115,12813.0,13857.6,14911.5
772,哈尔滨旅游,20240211,12552,102,12450,11200.0,13200.8,15078.2
773,哈尔滨旅游,20240212,13834,123,13711,12552.0,12802.2,14939.0
774,哈尔滨旅游,20240213,14821,133,14688,13834.0,13044.0,14770.1
775,哈尔滨旅游,20240214,15336,93,15243,14821.0,13548.6,14421.8
776,哈尔滨旅游,20240215,12299,112,12187,15336.0,13768.4,13813.0
777,哈尔滨旅游,20240216,15472,140,15332,12299.0,14352.4,13776.6
778,哈尔滨旅游,20240217,12518,157,12361,15472.0,14089.2,13445.7
779,哈尔滨旅游,20240218,13038,231,12807,12518.0,13732.6,13388.3
780,哈尔滨旅游,20240219,10905,256,10649,13038.0,12846.4,13197.5
781,哈尔滨旅游,20240220,12758,231,12527,10905.0,12938.2,13353.3
782,哈尔滨旅游,20240221,10762,175,10587,12758.0,11996.2,13174.3
783,哈尔滨旅游,20240222,11286,195,11091,10762.0,11749.8,12919.5
784,哈尔滨旅游,20240223,10271,182,10089,11286.0,11196.4,12464.5
785,哈尔滨旅游,20240224,7887,120,7767,10271.0,10592.8,11719.6
786,哈尔滨旅游,20240225,3808,159,3649,7887.0,8802.8,10870.5
787,哈尔滨旅游,20240226,3340,190,3150,3808.0,7318.4,9657.3
788,哈尔滨旅游,20240227,2739,184,2555,3340.0,5609.0,8679.4
789,哈尔滨旅游,20240228,2579,190,2389,2739.0,4070.6,7633.5
790,哈尔滨旅游,20240229,2380,165,2215,2579.0,2969.2,6781.0
791,哈尔滨旅游,20240301,2703,151,2552,2380.0,2748.2,5775.5
792,哈尔滨旅游,20240302,3523,110,3413,2703.0,2784.8,5051.6
793,哈尔滨旅游,20240303,3661,118,3543,3523.0,2969.2,4289.1
794,哈尔滨旅游,20240304,2300,150,2150,3661.0,2913.4,3492.0
795,哈尔滨旅游,20240305,2010,131,1879,2300.0,2839.4,2904.3
796,哈尔滨旅游,20240306,2848,176,2672,2010.0,2868.4,2808.3
797,哈尔滨旅游,20240307,2964,144,2820,2848.0,2756.6,2770.7
798,哈尔滨旅游,20240308,8394,125,8269,2964.0,3703.2,3336.2
799,哈尔滨旅游,20240309,5411,99,5312,8394.0,4325.4,3619.4
800,哈尔滨旅游,20240310,5451,97,5354,5411.0,5013.6,3926.5
801,哈尔滨旅游,20240311,5771,163,5608,5451.0,5598.2,4233.3
802,哈尔滨旅游,20240312,5470,120,5350,5771.0,6099.4,4428.0
803,哈尔滨旅游,20240313,5460,139,5321,5470.0,5512.6,4607.9
804,哈尔滨旅游,20240314,4121,139,3982,5460.0,5254.6,4790.0
805,哈尔滨旅游,20240315,6609,135,6474,4121.0,5486.2,5249.9
806,哈尔滨旅游,20240316,2622,87,2535,6609.0,4856.4,5227.3
807,哈尔滨旅游,20240317,1971,106,1865,2622.0,4156.6,5128.0
808,哈尔滨旅游,20240318,2113,129,1984,1971.0,3487.2,4499.9
809,哈尔滨旅游,20240319,1422,152,1270,2113.0,2947.4,4101.0
810,哈尔滨旅游,20240320,1254,139,1115,1422.0,1876.4,3681.3
811,哈尔滨旅游,20240321,1248,133,1115,1254.0,1601.6,3229.0
812,哈尔滨旅游,20240322,5322,155,5167,1248.0,2271.8,3214.2
813,哈尔滨旅游,20240323,4457,85,4372,5322.0,2740.6,3113.9
814,哈尔滨旅游,20240324,4703,106,4597,4457.0,3396.8,3172.1
815,哈尔滨旅游,20240325,4133,137,3996,4703.0,3972.6,2924.5
816,哈尔滨旅游,20240326,4361,146,4215,4133.0,4595.2,3098.4
817,哈尔滨旅游,20240327,4309,139,4170,4361.0,4392.6,3332.2
818,哈尔滨旅游,20240328,4044,142,3902,4309.0,4310.0,3525.3
819,哈尔滨旅游,20240329,2826,104,2722,4044.0,3934.6,3665.7
820,哈尔滨旅游,20240330,5000,76,4924,2826.0,4108.0,4040.3
821,哈尔滨旅游,20240331,3510,106,3404,5000.0,3937.8,4266.5
822,哈尔滨旅游,20240401,2050,161,1889,3510.0,3486.0,3939.3
823,哈尔滨旅游,20240402,1224,131,1093,2050.0,2922.0,3616.0
824,哈尔滨旅游,20240403,2778,146,2632,1224.0,2912.4,3423.5
825,哈尔滨旅游,20240404,3308,78,3230,2778.0,2574.0,3341.0
826,哈尔滨旅游,20240405,1730,91,1639,3308.0,2218.0,3077.9
827,哈尔滨旅游,20240406,1086,97,989,1730.0,2025.2,2755.6
828,哈尔滨旅游,20240407,1538,162,1376,1086.0,2088.0,2505.0
829,哈尔滨旅游,20240408,1067,150,917,1538.0,1745.8,2329.1
830,哈尔滨旅游,20240409,1098,137,961,1067.0,1303.8,1938.9
831,哈尔滨旅游,20240410,1106,131,975,1098.0,1179.0,1698.5
832,哈尔滨旅游,20240411,1059,144,915,1106.0,1173.6,1599.4
833,哈尔滨旅游,20240412,2653,123,2530,1059.0,1396.6,1742.3
834,哈尔滨旅游,20240413,1085,97,988,2653.0,1400.2,1573.0
835,哈尔滨旅游,20240414,934,85,849,1085.0,1367.4,1335.6
836,哈尔滨旅游,20240415,1048,169,879,934.0,1355.8,1267.4
837,哈尔滨旅游,20240416,1016,154,862,1048.0,1347.2,1260.4
838,哈尔滨旅游,20240417,958,140,818,1016.0,1008.2,1202.4
839,哈尔滨旅游,20240418,986,135,851,958.0,988.4,1194.3
840,哈尔滨旅游,20240419,983,116,867,986.0,998.2,1182.8
841,哈尔滨旅游,20240420,934,76,858,983.0,975.4,1165.6
842,哈尔滨旅游,20240421,1045,97,948,934.0,981.2,1164.2
843,哈尔滨旅游,20240422,890,127,763,1045.0,967.6,987.9
844,哈尔滨旅游,20240423,974,123,851,890.0,965.2,976.8
845,哈尔滨旅游,20240424,1048,146,902,974.0,978.2,988.2
846,哈尔滨旅游,20240425,1068,142,926,1048.0,1005.0,990.2
847,哈尔滨旅游,20240426,920,140,780,1068.0,980.0,980.6
848,哈尔滨旅游,20240427,1093,89,1004,920.0,1020.6,994.1
849,哈尔滨旅游,20240428,1453,172,1281,1093.0,1116.4,1040.8
850,哈尔滨旅游,20240429,1049,186,863,1453.0,1116.6,1047.4
851,哈尔滨旅游,20240430,1067,182,885,1049.0,1116.4,1060.7
1,龙塔,20220101,154,0,154,1067.0,963.2,971.6
2,龙塔,20220102,226,72,154,154.0,789.8,905.2
3,龙塔,20220103,246,66,180,226.0,548.4,832.4
4,龙塔,20220104,224,80,144,246.0,383.4,750.0
5,龙塔,20220105,219,74,145,224.0,213.8,665.1
6,龙塔,20220106,218,70,148,219.0,226.6,594.9
7,龙塔,20220107,208,76,132,218.0,223.0,506.4
8,龙塔,20220108,210,59,151,208.0,215.8,382.1
9,龙塔,20220109,213,64,149,210.0,213.6,298.5
10,龙塔,20220110,208,74,134,213.0,211.4,212.6
11,龙塔,20220111,198,66,132,208.0,207.4,217.0
12,龙塔,20220112,204,66,138,198.0,206.6,214.8
13,龙塔,20220113,222,68,154,204.0,209.0,212.4
14,龙塔,20220114,202,76,126,222.0,206.8,210.2
15,龙塔,20220115,186,68,118,202.0,202.4,206.9
16,龙塔,20220116,211,59,152,186.0,205.0,206.2
17,龙塔,20220117,216,59,157,211.0,207.4,207.0
18,龙塔,20220118,215,70,145,216.0,206.0,207.5
19,龙塔,20220119,237,80,157,215.0,213.0,209.9
20,龙塔,20220120,217,70,147,237.0,219.2,210.8
21,龙塔,20220121,214,70,144,217.0,219.8,212.4
22,龙塔,20220122,224,66,158,214.0,221.4,214.4
23,龙塔,20220123,210,76,134,224.0,220.4,213.2
24,龙塔,20220124,204,66,138,210.0,213.8,213.4
25,龙塔,20220125,246,85,161,204.0,219.6,219.4
26,龙塔,20220126,257,87,170,246.0,228.2,224.0
27,龙塔,20220127,297,131,166,257.0,242.8,232.1
28,龙塔,20220128,283,118,165,297.0,257.4,238.9
29,龙塔,20220129,265,104,161,283.0,269.6,241.7
30,龙塔,20220130,284,127,157,265.0,277.2,248.4
31,龙塔,20220131,260,116,144,284.0,277.8,253.0
32,龙塔,20220201,289,108,181,260.0,276.2,259.5
33,龙塔,20220202,279,116,163,289.0,275.4,266.4
34,龙塔,20220203,251,93,158,279.0,272.6,271.1
35,龙塔,20220204,327,118,209,251.0,281.2,279.2
36,龙塔,20220205,307,131,176,327.0,290.6,284.2
37,龙塔,20220206,301,131,170,307.0,293.0,284.6
38,龙塔,20220207,280,121,159,301.0,293.2,284.3
39,龙塔,20220208,304,139,165,280.0,303.8,288.2
40,龙塔,20220209,303,133,170,304.0,299.0,290.1
41,龙塔,20220210,287,139,148,303.0,295.0,292.8
42,龙塔,20220211,326,150,176,287.0,300.0,296.5
43,龙塔,20220212,318,139,179,326.0,307.6,300.4
44,龙塔,20220213,344,148,196,318.0,315.6,309.7
45,龙塔,20220214,338,155,183,344.0,322.6,310.8
46,龙塔,20220215,321,144,177,338.0,329.4,312.2
47,龙塔,20220216,306,152,154,321.0,325.4,312.7
48,龙塔,20220217,317,154,163,306.0,325.2,316.4
49,龙塔,20220218,364,180,184,317.0,329.2,322.4
50,龙塔,20220219,337,157,180,364.0,329.0,325.8
51,龙塔,20220220,340,154,186,337.0,332.8,331.1
52,龙塔,20220221,336,163,173,340.0,338.8,332.1
53,龙塔,20220222,381,184,197,336.0,351.6,338.4
54,龙塔,20220223,280,101,179,381.0,334.8,332.0
55,龙塔,20220224,309,116,193,280.0,329.2,329.1
56,龙塔,20220225,304,104,200,309.0,322.0,327.4
57,龙塔,20220226,292,89,203,304.0,313.2,326.0
58,龙塔,20220227,303,97,206,292.0,297.6,324.6
59,龙塔,20220228,309,106,203,303.0,303.4,319.1
60,龙塔,20220301,358,99,259,309.0,313.2,321.2
61,龙塔,20220302,318,110,208,358.0,316.0,319.0
62,龙塔,20220303,292,91,201,318.0,316.0,314.6
63,龙塔,20220304,280,102,178,292.0,311.4,304.5
64,龙塔,20220305,294,93,201,280.0,308.4,305.9
65,龙塔,20220306,286,99,187,294.0,294.0,303.6
66,龙塔,20220307,298,137,161,286.0,290.0,303.0
67,龙塔,20220308,307,104,203,298.0,293.0,304.5
68,龙塔,20220309,289,127,162,307.0,294.8,303.1
69,龙塔,20220310,299,125,174,289.0,295.8,302.1
70,龙塔,20220311,278,116,162,299.0,294.2,294.1
71,龙塔,20220312,282,120,162,278.0,291.0,290.5
72,龙塔,20220313,296,123,173,282.0,288.8,290.9
73,龙塔,20220314,329,152,177,296.0,296.8,295.8
74,龙塔,20220315,275,110,165,329.0,292.0,293.9
75,龙塔,20220316,261,106,155,275.0,288.6,291.4
76,龙塔,20220317,271,101,170,261.0,286.4,288.7
77,龙塔,20220318,286,129,157,271.0,284.4,286.6
78,龙塔,20220319,258,99,159,286.0,270.2,283.5
79,龙塔,20220320,283,102,181,258.0,271.8,281.9
80,龙塔,20220321,290,106,184,283.0,277.6,283.1
81,龙塔,20220322,327,146,181,290.0,288.8,287.6
82,龙塔,20220323,292,110,182,327.0,290.0,287.2
83,龙塔,20220324,303,114,189,292.0,299.0,284.6
84,龙塔,20220325,301,131,170,303.0,302.6,287.2
85,龙塔,20220326,308,123,185,301.0,306.2,291.9
86,龙塔,20220327,307,125,182,308.0,302.2,295.5
87,龙塔,20220328,321,148,173,307.0,308.0,299.0
88,龙塔,20220329,318,142,176,321.0,311.0,305.0
89,龙塔,20220330,306,139,167,318.0,312.0,307.3
90,龙塔,20220331,278,123,155,306.0,306.0,306.1
91,龙塔,20220401,325,152,173,278.0,309.6,305.9
92,龙塔,20220402,272,121,151,325.0,299.8,303.9
93,龙塔,20220403,310,121,189,272.0,298.2,304.6
94,龙塔,20220404,313,127,186,310.0,299.6,305.8
95,龙塔,20220405,296,120,176,313.0,303.2,304.6
96,龙塔,20220406,305,131,174,296.0,299.2,304.4
97,龙塔,20220407,304,139,165,305.0,305.6,302.7
98,龙塔,20220408,313,148,165,304.0,306.2,302.2
99,龙塔,20220409,263,80,183,313.0,296.2,297.9
100,龙塔,20220410,249,85,164,263.0,286.8,295.0
101,龙塔,20220411,261,97,164,249.0,278.0,288.6
102,龙塔,20220412,277,120,157,261.0,272.6,289.1
103,龙塔,20220413,297,137,160,277.0,269.4,287.8
104,龙塔,20220414,290,125,165,297.0,274.8,285.5
105,龙塔,20220415,307,140,167,290.0,286.4,286.6
106,龙塔,20220416,309,127,182,307.0,296.0,287.0
107,龙塔,20220417,270,110,160,309.0,294.6,283.6
108,龙塔,20220418,310,139,171,270.0,297.2,283.3
109,龙塔,20220419,265,127,138,310.0,292.2,283.5
110,龙塔,20220420,239,104,135,265.0,278.6,282.5
111,龙塔,20220421,262,101,161,239.0,269.2,282.6
112,龙塔,20220422,292,125,167,262.0,273.6,284.1
113,龙塔,20220423,259,97,162,292.0,263.4,280.3
114,龙塔,20220424,262,131,131,259.0,262.8,277.5
115,龙塔,20220425,311,140,171,262.0,277.2,277.9
116,龙塔,20220426,306,139,167,311.0,286.0,277.6
117,龙塔,20220427,258,110,148,306.0,279.2,276.4
118,龙塔,20220428,291,118,173,258.0,285.6,274.5
119,龙塔,20220429,310,150,160,291.0,295.2,279.0
120,龙塔,20220430,262,104,158,310.0,285.4,281.3
121,龙塔,20220501,285,112,173,262.0,281.2,283.6
122,龙塔,20220502,291,127,164,285.0,287.8,283.5
123,龙塔,20220503,294,116,178,291.0,288.4,287.0
124,龙塔,20220504,304,125,179,294.0,287.2,291.2
125,龙塔,20220505,281,118,163,304.0,291.0,288.2
126,龙塔,20220506,276,116,160,281.0,289.2,285.2
127,龙塔,20220507,316,120,196,276.0,294.2,291.0
128,龙塔,20220508,298,106,192,316.0,295.0,291.7
129,龙塔,20220509,299,121,178,298.0,294.0,290.6
130,龙塔,20220510,265,120,145,299.0,290.8,290.9
131,龙塔,20220511,314,131,183,265.0,298.4,293.8
132,龙塔,20220512,295,110,185,314.0,294.2,294.2
133,龙塔,20220513,272,121,151,295.0,289.0,292.0
134,龙塔,20220514,303,110,193,272.0,289.8,291.9
135,龙塔,20220515,286,120,166,303.0,294.0,292.4
136,龙塔,20220516,270,106,164,286.0,285.2,291.8
137,龙塔,20220517,327,142,185,270.0,291.6,292.9
138,龙塔,20220518,315,118,197,327.0,300.2,294.6
139,龙塔,20220519,293,112,181,315.0,298.2,294.0
140,龙塔,20220520,313,116,197,293.0,303.6,298.8
141,龙塔,20220521,311,99,212,313.0,311.8,298.5
142,龙塔,20220522,390,112,278,311.0,324.4,308.0
143,龙塔,20220523,297,114,183,390.0,320.8,310.5
144,龙塔,20220524,277,97,180,297.0,317.6,307.9
145,龙塔,20220525,278,104,174,277.0,310.6,307.1
146,龙塔,20220526,292,112,180,278.0,306.8,309.3
147,龙塔,20220527,335,127,208,292.0,295.8,310.1
148,龙塔,20220528,315,112,203,335.0,299.4,310.1
149,龙塔,20220529,309,78,231,315.0,305.8,311.7
150,龙塔,20220530,275,108,167,309.0,305.2,307.9
151,龙塔,20220531,326,123,203,275.0,312.0,309.4
152,龙塔,20220601,284,97,187,326.0,301.8,298.8
153,龙塔,20220602,327,118,209,284.0,304.2,301.8
154,龙塔,20220603,348,110,238,327.0,312.0,308.9
155,龙塔,20220604,320,99,221,348.0,321.0,313.1
156,龙塔,20220605,309,110,199,320.0,317.6,314.8
157,龙塔,20220606,294,101,193,309.0,319.6,310.7
158,龙塔,20220607,282,101,181,294.0,310.6,307.4
159,龙塔,20220608,336,135,201,282.0,308.2,310.1
160,龙塔,20220609,313,133,180,336.0,306.8,313.9
161,龙塔,20220610,291,121,170,313.0,303.2,310.4
162,龙塔,20220611,311,116,195,291.0,306.6,313.1
163,龙塔,20220612,328,106,222,311.0,315.8,313.2
164,龙塔,20220613,303,114,189,328.0,309.2,308.7
165,龙塔,20220614,322,114,208,303.0,311.0,308.9
166,龙塔,20220615,264,85,179,322.0,305.6,304.4
167,龙塔,20220616,303,104,199,264.0,304.0,305.3
168,龙塔,20220617,301,114,187,303.0,298.6,307.2
169,龙塔,20220618,265,66,199,301.0,291.0,300.1
170,龙塔,20220619,254,59,195,265.0,277.4,294.2
171,龙塔,20220620,242,72,170,254.0,273.0,289.3
172,龙塔,20220621,294,82,212,242.0,271.2,287.6
173,龙塔,20220622,256,72,184,294.0,262.2,280.4
174,龙塔,20220623,261,72,189,256.0,261.4,276.2
175,龙塔,20220624,253,68,185,261.0,261.2,269.3
176,龙塔,20220625,308,72,236,253.0,274.4,273.7
177,龙塔,20220626,275,64,211,308.0,270.6,270.9
178,龙塔,20220627,252,68,184,275.0,269.8,266.0
179,龙塔,20220628,278,78,200,252.0,273.2,267.3
180,龙塔,20220629,296,74,222,278.0,281.8,271.5
181,龙塔,20220630,292,70,222,296.0,278.6,276.5
182,龙塔,20220701,290,72,218,292.0,281.6,276.1
183,龙塔,20220702,253,66,187,290.0,281.8,275.8
184,龙塔,20220703,261,72,189,253.0,278.4,275.8
185,龙塔,20220704,276,72,204,261.0,274.4,278.1
186,龙塔,20220705,256,70,186,276.0,267.2,272.9
187,龙塔,20220706,255,72,183,256.0,260.2,270.9
188,龙塔,20220707,289,74,215,255.0,267.4,274.6
189,龙塔,20220708,272,72,200,289.0,269.6,274.0
190,龙塔,20220709,313,61,252,272.0,277.0,275.7
191,龙塔,20220710,301,66,235,313.0,286.0,276.6
192,龙塔,20220711,273,61,212,301.0,289.6,274.9
193,龙塔,20220712,322,74,248,273.0,296.2,281.8
194,龙塔,20220713,304,72,232,322.0,302.6,286.1
195,龙塔,20220714,347,72,275,304.0,309.4,293.2
196,龙塔,20220715,301,70,231,347.0,309.4,297.7
197,龙塔,20220716,348,63,285,301.0,324.4,307.0
198,龙塔,20220717,365,64,301,348.0,333.0,314.6
199,龙塔,20220718,295,70,225,365.0,331.2,316.9
200,龙塔,20220719,313,70,243,295.0,324.4,316.9
201,龙塔,20220720,312,66,246,313.0,326.6,318.0
202,龙塔,20220721,340,76,264,312.0,325.0,324.7
203,龙塔,20220722,363,78,285,340.0,324.6,328.8
204,龙塔,20220723,350,66,284,363.0,335.6,333.4
205,龙塔,20220724,397,74,323,350.0,352.4,338.4
206,龙塔,20220725,363,72,291,397.0,362.6,344.6
207,龙塔,20220726,311,72,239,363.0,356.8,340.9
208,龙塔,20220727,366,72,294,311.0,357.4,341.0
209,龙塔,20220728,374,82,292,366.0,362.2,348.9
210,龙塔,20220729,339,72,267,374.0,350.6,351.5
211,龙塔,20220730,419,82,337,339.0,361.8,362.2
212,龙塔,20220731,383,66,317,419.0,376.2,366.5
213,龙塔,20220801,379,70,309,383.0,378.8,368.1
214,龙塔,20220802,393,78,315,379.0,382.6,372.4
215,龙塔,20220803,367,83,284,393.0,388.2,369.4
216,龙塔,20220804,376,61,315,367.0,379.6,370.7
217,龙塔,20220805,402,74,328,376.0,383.4,379.8
218,龙塔,20220806,429,64,365,402.0,393.4,386.1
219,龙塔,20220807,387,72,315,429.0,392.2,387.4
220,龙塔,20220808,393,80,313,387.0,397.4,392.8
221,龙塔,20220809,376,87,289,393.0,397.4,388.5
222,龙塔,20220810,339,76,263,376.0,384.8,384.1
223,龙塔,20220811,341,70,271,339.0,367.2,380.3
224,龙塔,20220812,316,82,234,341.0,353.0,372.6
225,龙塔,20220813,385,68,317,316.0,351.4,374.4
226,龙塔,20220814,364,70,294,385.0,349.0,373.2
227,龙塔,20220815,340,76,264,364.0,349.2,367.0
228,龙塔,20220816,343,72,271,340.0,349.6,358.4
229,龙塔,20220817,346,72,274,343.0,355.6,354.3
230,龙塔,20220818,322,68,254,346.0,343.0,347.2
231,龙塔,20220819,340,83,257,322.0,338.2,343.6
232,龙塔,20220820,347,70,277,340.0,339.6,344.4
233,龙塔,20220821,318,61,257,347.0,334.6,342.1
234,龙塔,20220822,323,70,253,318.0,330.0,342.8
235,龙塔,20220823,328,83,245,323.0,331.2,337.1
236,龙塔,20220824,334,70,264,328.0,330.0,334.1
237,龙塔,20220825,295,64,231,334.0,319.6,329.6
238,龙塔,20220826,318,70,248,295.0,319.6,327.1
239,龙塔,20220827,308,61,247,318.0,316.6,323.3
240,龙塔,20220828,274,66,208,308.0,305.8,318.5
241,龙塔,20220829,261,72,189,274.0,291.2,310.6
242,龙塔,20220830,228,76,152,261.0,277.8,298.7
243,龙塔,20220831,216,61,155,228.0,257.4,288.5
244,龙塔,20220901,267,74,193,216.0,249.2,282.9
245,龙塔,20220902,248,64,184,267.0,244.0,274.9
246,龙塔,20220903,225,61,164,248.0,236.8,264.0
247,龙塔,20220904,250,72,178,225.0,241.2,259.5
248,龙塔,20220905,240,59,181,250.0,246.0,251.7
249,龙塔,20220906,264,74,190,240.0,245.4,247.3
250,龙塔,20220907,252,63,189,264.0,246.2,245.1
251,龙塔,20220908,280,91,189,252.0,257.2,247.0
252,龙塔,20220909,309,95,214,280.0,269.0,255.1
253,龙塔,20220910,307,85,222,309.0,282.4,264.2
254,龙塔,20220911,290,76,214,307.0,287.6,266.5
255,龙塔,20220912,277,82,195,290.0,292.6,269.4
256,龙塔,20220913,249,97,152,277.0,286.4,271.8
257,龙塔,20220914,235,76,159,249.0,271.6,270.3
258,龙塔,20220915,263,82,181,235.0,262.8,272.6
259,龙塔,20220916,235,78,157,263.0,251.8,269.7
260,龙塔,20220917,261,68,193,235.0,248.6,270.6
261,龙塔,20220918,276,74,202,261.0,254.0,270.2
262,龙塔,20220919,224,76,148,276.0,251.8,261.7
263,龙塔,20220920,277,87,190,224.0,254.6,258.7
264,龙塔,20220921,242,82,160,277.0,256.0,253.9
265,龙塔,20220922,234,68,166,242.0,250.6,249.6
266,龙塔,20220923,246,76,170,234.0,244.6,249.3
267,龙塔,20220924,246,72,174,246.0,249.0,250.4
268,龙塔,20220925,261,83,178,246.0,245.8,250.2
269,龙塔,20220926,212,68,144,261.0,239.8,247.9
270,龙塔,20220927,244,78,166,212.0,241.8,246.2
271,龙塔,20220928,219,64,155,244.0,236.4,240.5
272,龙塔,20220929,235,68,167,219.0,234.2,241.6
273,龙塔,20220930,244,78,166,235.0,230.8,238.3
274,龙塔,20221001,201,0,201,244.0,228.6,234.2
275,龙塔,20221002,240,59,181,201.0,227.8,234.8
276,龙塔,20221003,248,64,184,240.0,233.6,235.0
277,龙塔,20221004,246,64,182,248.0,235.8,235.0
278,龙塔,20221005,229,59,170,246.0,232.8,231.8
279,龙塔,20221006,255,68,187,229.0,243.6,236.1
280,龙塔,20221007,245,74,171,255.0,244.6,236.2
281,龙塔,20221008,240,72,168,245.0,243.0,238.3
282,龙塔,20221009,251,78,173,240.0,244.0,239.9
283,龙塔,20221010,295,99,196,251.0,257.2,245.0
284,龙塔,20221011,415,85,330,295.0,289.2,266.4
285,龙塔,20221012,350,93,257,415.0,310.2,277.4
286,龙塔,20221013,242,76,166,350.0,310.6,276.8
287,龙塔,20221014,257,83,174,242.0,311.8,277.9
288,龙塔,20221015,237,74,163,257.0,300.2,278.7
289,龙塔,20221016,235,78,157,237.0,264.2,276.7
290,龙塔,20221017,250,85,165,235.0,244.2,277.2
291,龙塔,20221018,247,93,154,250.0,245.2,277.9
292,龙塔,20221019,239,85,154,247.0,241.6,276.7
293,龙塔,20221020,240,89,151,239.0,242.2,271.2
294,龙塔,20221021,227,68,159,240.0,240.6,252.4
295,龙塔,20221022,283,66,217,227.0,247.2,245.7
296,龙塔,20221023,231,0,231,283.0,244.0,244.6
297,龙塔,20221024,235,74,161,231.0,243.2,242.4
298,龙塔,20221025,264,74,190,235.0,248.0,245.1
299,龙塔,20221026,270,80,190,264.0,256.6,248.6
300,龙塔,20221027,224,64,160,270.0,244.8,246.0
301,龙塔,20221028,246,78,168,224.0,247.8,245.9
302,龙塔,20221029,212,0,212,246.0,243.2,243.2
303,龙塔,20221030,167,0,167,212.0,223.8,235.9
304,龙塔,20221031,230,64,166,167.0,215.8,236.2
305,龙塔,20221101,220,72,148,230.0,215.0,229.9
306,龙塔,20221102,288,76,212,220.0,223.4,235.6
307,龙塔,20221103,223,61,162,288.0,225.6,234.4
308,龙塔,20221104,235,80,155,223.0,239.2,231.5
309,龙塔,20221105,248,61,187,235.0,242.8,229.3
310,龙塔,20221106,212,61,151,248.0,241.2,228.1
311,龙塔,20221107,231,76,155,212.0,229.8,226.6
312,龙塔,20221108,202,64,138,231.0,225.6,225.6
313,龙塔,20221109,231,70,161,202.0,224.8,232.0
314,龙塔,20221110,237,72,165,231.0,222.6,232.7
315,龙塔,20221111,237,72,165,237.0,227.6,234.4
316,龙塔,20221112,220,59,161,237.0,225.4,227.6
317,龙塔,20221113,230,68,162,220.0,231.0,228.3
318,龙塔,20221114,220,72,148,230.0,228.8,226.8
319,龙塔,20221115,209,68,141,220.0,223.2,222.9
320,龙塔,20221116,189,61,128,209.0,213.6,220.6
321,龙塔,20221117,244,70,174,189.0,218.4,221.9
322,龙塔,20221118,223,72,151,244.0,217.0,224.0
323,龙塔,20221119,212,61,151,223.0,215.4,222.1
324,龙塔,20221120,214,63,151,212.0,216.4,219.8
325,龙塔,20221121,235,74,161,214.0,225.6,219.6
326,龙塔,20221122,223,68,155,235.0,221.4,219.9
327,龙塔,20221123,203,68,135,223.0,217.4,217.2
328,龙塔,20221124,241,68,173,203.0,223.2,219.3
329,龙塔,20221125,192,66,126,241.0,218.8,217.6
330,龙塔,20221126,199,61,138,192.0,211.6,218.6
331,龙塔,20221127,198,64,134,199.0,206.6,214.0
332,龙塔,20221128,214,63,151,198.0,208.8,213.1
333,龙塔,20221129,193,70,123,214.0,199.2,211.2
334,龙塔,20221130,211,68,143,193.0,203.0,210.9
335,龙塔,20221201,216,64,152,211.0,206.4,209.0
336,龙塔,20221202,226,74,152,216.0,212.0,209.3
337,龙塔,20221203,200,66,134,226.0,209.2,209.0
338,龙塔,20221204,214,63,151,200.0,213.4,206.3
339,龙塔,20221205,199,64,135,214.0,211.0,207.0
340,龙塔,20221206,204,61,143,199.0,208.6,207.5
341,龙塔,20221207,204,66,138,204.0,204.2,208.1
342,龙塔,20221208,221,74,147,204.0,208.4,208.8
343,龙塔,20221209,196,66,130,221.0,204.8,209.1
344,龙塔,20221210,186,61,125,196.0,202.2,206.6
345,龙塔,20221211,187,59,128,186.0,198.8,203.7
346,龙塔,20221212,200,61,139,187.0,198.0,201.1
347,龙塔,20221213,178,63,115,200.0,189.4,198.9
348,龙塔,20221214,189,64,125,178.0,188.0,196.4
349,龙塔,20221215,198,63,135,189.0,190.4,196.3
350,龙塔,20221216,195,72,123,198.0,192.0,195.4
351,龙塔,20221217,202,64,138,195.0,192.4,195.2
352,龙塔,20221218,169,63,106,202.0,190.6,190.0
353,龙塔,20221219,188,63,125,169.0,190.4,189.2
354,龙塔,20221220,177,64,113,188.0,186.2,188.3
355,龙塔,20221221,169,59,110,177.0,181.0,186.5
356,龙塔,20221222,106,0,106,169.0,161.8,177.1
357,龙塔,20221223,134,0,134,106.0,154.8,172.7
358,龙塔,20221224,170,66,104,134.0,151.2,170.8
359,龙塔,20221225,182,63,119,170.0,152.2,169.2
360,龙塔,20221226,191,66,125,182.0,156.6,168.8
361,龙塔,20221227,196,61,135,191.0,174.6,168.2
362,龙塔,20221228,185,63,122,196.0,184.8,169.8
363,龙塔,20221229,167,59,108,185.0,184.2,167.7
364,龙塔,20221230,206,61,145,167.0,189.0,170.6
365,龙塔,20221231,213,59,154,206.0,193.4,175.0
366,龙塔,20230101,205,64,141,213.0,195.2,184.9
367,龙塔,20230102,208,59,149,205.0,199.8,192.3
368,龙塔,20230103,201,63,138,208.0,206.6,195.4
369,龙塔,20230104,211,66,145,201.0,207.6,198.3
370,龙塔,20230105,215,64,151,211.0,208.0,200.7
371,龙塔,20230106,222,74,148,215.0,211.4,203.3
372,龙塔,20230107,221,66,155,222.0,214.0,206.9
373,龙塔,20230108,242,63,179,221.0,222.2,214.4
374,龙塔,20230109,205,74,131,242.0,221.0,214.3
375,龙塔,20230110,227,80,147,205.0,223.4,215.7
376,龙塔,20230111,213,74,139,227.0,221.6,216.5
377,龙塔,20230112,236,63,173,213.0,224.6,219.3
378,龙塔,20230113,237,74,163,236.0,223.6,222.9
379,龙塔,20230114,226,61,165,237.0,227.8,224.4
380,龙塔,20230115,212,64,148,226.0,224.8,224.1
381,龙塔,20230116,212,68,144,212.0,224.6,223.1
382,龙塔,20230117,227,66,161,212.0,222.8,223.7
383,龙塔,20230118,246,80,166,227.0,224.6,224.1
384,龙塔,20230119,224,63,161,246.0,224.2,226.0
385,龙塔,20230120,198,66,132,224.0,221.4,223.1
386,龙塔,20230121,174,59,115,198.0,213.8,219.2
387,龙塔,20230122,207,59,148,174.0,209.8,216.3
388,龙塔,20230123,250,64,186,207.0,210.6,217.6
389,龙塔,20230124,180,0,180,250.0,201.8,213.0
390,龙塔,20230125,278,61,217,180.0,217.8,219.6
391,龙塔,20230126,309,61,248,278.0,244.8,229.3
392,龙塔,20230127,272,80,192,309.0,257.8,233.8
393,龙塔,20230128,264,64,200,272.0,260.6,235.6
394,龙塔,20230129,290,97,193,264.0,282.6,242.2
395,龙塔,20230130,278,74,204,290.0,282.6,250.2
396,龙塔,20230131,290,97,193,278.0,278.8,261.8
397,龙塔,20230201,271,68,203,290.0,278.6,268.2
398,龙塔,20230202,267,83,184,271.0,279.2,269.9
399,龙塔,20230203,285,89,196,267.0,278.2,280.4
400,龙塔,20230204,251,59,192,285.0,272.8,277.7
401,龙塔,20230205,244,66,178,251.0,263.6,271.2
402,龙塔,20230206,237,74,163,244.0,256.8,267.7
403,龙塔,20230207,246,76,170,237.0,252.6,265.9
404,龙塔,20230208,276,80,196,246.0,250.8,264.5
405,龙塔,20230209,289,61,228,276.0,258.4,265.6
406,龙塔,20230210,245,74,171,289.0,258.6,261.1
407,龙塔,20230211,254,64,190,245.0,262.0,259.4
408,龙塔,20230212,297,66,231,254.0,272.2,262.4
409,龙塔,20230213,273,68,205,297.0,271.6,261.2
410,龙塔,20230214,248,70,178,273.0,263.4,260.9
411,龙塔,20230215,228,68,160,248.0,260.0,259.3
412,龙塔,20230216,237,66,171,228.0,256.6,259.3
413,龙塔,20230217,244,76,168,237.0,246.0,259.1
414,龙塔,20230218,263,59,204,244.0,244.0,257.8
415,龙塔,20230219,265,61,204,263.0,247.4,255.4
416,龙塔,20230220,237,64,173,265.0,249.2,254.6
417,龙塔,20230221,240,66,174,237.0,249.8,253.2
418,龙塔,20230222,232,66,166,240.0,247.4,246.7
419,龙塔,20230223,221,70,151,232.0,239.0,241.5
420,龙塔,20230224,238,68,170,221.0,233.6,240.5
421,龙塔,20230225,277,66,211,238.0,241.6,245.4
422,龙塔,20230226,271,74,197,277.0,247.8,248.8
423,龙塔,20230227,252,76,176,271.0,251.8,249.6
424,龙塔,20230228,219,70,149,252.0,251.4,245.2
425,龙塔,20230301,229,74,155,219.0,249.6,241.6
426,龙塔,20230302,231,74,157,229.0,240.4,241.0
427,龙塔,20230303,241,76,165,231.0,234.4,241.1
428,龙塔,20230304,284,59,225,241.0,240.8,246.3
429,龙塔,20230305,257,68,189,284.0,248.4,249.9
430,龙塔,20230306,237,82,155,257.0,250.0,249.8
431,龙塔,20230307,236,72,164,237.0,251.0,245.7
432,龙塔,20230308,247,70,177,236.0,252.2,243.3
433,龙塔,20230309,227,72,155,247.0,240.8,240.8
434,龙塔,20230310,244,63,181,227.0,238.2,243.3
435,龙塔,20230311,264,61,203,244.0,243.6,246.8
436,龙塔,20230312,284,66,218,264.0,253.2,252.1
437,龙塔,20230313,244,74,170,284.0,252.6,252.4
438,龙塔,20230314,227,64,163,244.0,252.6,246.7
439,龙塔,20230315,239,76,163,227.0,251.6,244.9
440,龙塔,20230316,242,68,174,239.0,247.2,245.4
441,龙塔,20230317,249,64,185,242.0,240.2,246.7
442,龙塔,20230318,283,64,219,249.0,248.0,250.3
443,龙塔,20230319,281,70,211,283.0,258.8,255.7
444,龙塔,20230320,227,64,163,281.0,256.4,254.0
445,龙塔,20230321,243,70,173,227.0,256.6,251.9
446,龙塔,20230322,230,70,160,243.0,252.8,246.5
447,龙塔,20230323,242,74,168,230.0,244.6,246.3
448,龙塔,20230324,242,68,174,242.0,236.8,247.8
449,龙塔,20230325,264,61,203,242.0,244.2,250.3
450,龙塔,20230326,259,59,200,264.0,247.4,252.0
451,龙塔,20230327,242,74,168,259.0,249.8,251.3
452,龙塔,20230328,252,70,182,242.0,251.8,248.2
453,龙塔,20230329,248,74,174,252.0,253.0,244.9
454,龙塔,20230330,281,76,205,248.0,256.4,250.3
455,龙塔,20230331,257,59,198,281.0,256.0,251.7
456,龙塔,20230401,288,59,229,257.0,265.2,257.5
457,龙塔,20230402,283,64,219,288.0,271.4,261.6
458,龙塔,20230403,261,78,183,283.0,274.0,263.5
459,龙塔,20230404,286,82,204,261.0,275.0,265.7
460,龙塔,20230405,304,72,232,286.0,284.4,270.2
461,龙塔,20230406,235,64,171,304.0,273.8,269.5
462,龙塔,20230407,269,70,199,235.0,271.0,271.2
463,龙塔,20230408,285,63,222,269.0,275.8,274.9
464,龙塔,20230409,292,68,224,285.0,277.0,276.0
465,龙塔,20230410,233,72,161,292.0,262.8,273.6
466,龙塔,20230411,252,76,176,233.0,266.2,270.0
467,龙塔,20230412,272,82,190,252.0,266.8,268.9
468,龙塔,20230413,279,89,190,272.0,265.6,270.7
469,龙塔,20230414,273,78,195,279.0,261.8,269.4
470,龙塔,20230415,324,63,261,273.0,280.0,271.4
471,龙塔,20230416,300,61,239,324.0,289.6,277.9
472,龙塔,20230417,264,72,192,300.0,288.0,277.4
473,龙塔,20230418,237,61,176,264.0,279.6,272.6
474,龙塔,20230419,284,72,212,237.0,281.8,271.8
475,龙塔,20230420,292,72,220,284.0,275.4,277.7
476,龙塔,20230421,294,72,222,292.0,274.2,281.9
477,龙塔,20230422,299,64,235,294.0,281.2,284.6
478,龙塔,20230423,295,68,227,299.0,292.8,286.2
479,龙塔,20230424,285,76,209,295.0,293.0,287.4
480,龙塔,20230425,280,72,208,285.0,290.6,283.0
481,龙塔,20230426,305,85,220,280.0,292.8,283.5
482,龙塔,20230427,310,68,242,305.0,295.0,288.1
483,龙塔,20230428,391,74,317,310.0,314.2,303.5
484,龙塔,20230429,583,72,511,391.0,373.8,333.4
485,龙塔,20230430,640,72,568,583.0,445.8,368.2
486,龙塔,20230501,647,68,579,640.0,514.2,403.5
487,龙塔,20230502,537,64,473,647.0,559.6,427.3
488,龙塔,20230503,471,74,397,537.0,575.6,444.9
489,龙塔,20230504,322,72,250,471.0,523.4,448.6
490,龙塔,20230505,297,66,231,322.0,454.8,450.3
491,龙塔,20230506,286,68,218,297.0,382.6,448.4
492,龙塔,20230507,317,61,256,286.0,338.6,449.1
493,龙塔,20230508,279,78,201,317.0,300.2,437.9
494,龙塔,20230509,272,74,198,279.0,290.2,406.8
495,龙塔,20230510,292,78,214,272.0,289.2,372.0
496,龙塔,20230511,284,80,204,292.0,288.8,335.7
497,龙塔,20230512,259,66,193,284.0,277.2,307.9
498,龙塔,20230513,273,61,212,259.0,276.0,288.1
499,龙塔,20230514,287,59,228,273.0,279.0,284.6
500,龙塔,20230515,271,74,197,287.0,274.8,282.0
501,龙塔,20230516,244,61,183,271.0,266.8,277.8
502,龙塔,20230517,270,66,204,244.0,269.0,273.1
503,龙塔,20230518,283,82,201,270.0,271.0,273.5
504,龙塔,20230519,269,66,203,283.0,267.4,273.2
505,龙塔,20230520,275,61,214,269.0,268.2,271.5
506,龙塔,20230521,320,66,254,275.0,283.4,275.1
507,龙塔,20230522,258,61,197,320.0,281.0,275.0
508,龙塔,20230523,235,61,174,258.0,271.4,271.2
509,龙塔,20230524,248,66,182,235.0,267.2,267.3
510,龙塔,20230525,248,66,182,248.0,261.8,265.0
511,龙塔,20230526,238,61,177,248.0,245.4,264.4
512,龙塔,20230527,278,66,212,238.0,249.4,265.2
513,龙塔,20230528,271,63,208,278.0,256.6,264.0
514,龙塔,20230529,254,64,190,271.0,257.8,262.5
515,龙塔,20230530,261,64,197,254.0,260.4,261.1
516,龙塔,20230531,279,74,205,261.0,268.6,257.0
517,龙塔,20230601,265,80,185,279.0,266.0,257.7
518,龙塔,20230602,261,76,185,265.0,264.0,260.3
519,龙塔,20230603,290,59,231,261.0,271.2,264.5
520,龙塔,20230604,288,64,224,290.0,276.6,268.5
521,龙塔,20230605,244,66,178,288.0,269.6,269.1
522,龙塔,20230606,257,72,185,244.0,268.0,267.0
523,龙塔,20230607,313,82,231,257.0,278.4,271.2
524,龙塔,20230608,304,72,232,313.0,281.2,276.2
525,龙塔,20230609,294,80,214,304.0,282.4,279.5
526,龙塔,20230610,286,61,225,294.0,290.8,280.2
527,龙塔,20230611,342,68,274,286.0,307.8,287.9
528,龙塔,20230612,289,85,204,342.0,303.0,290.7
529,龙塔,20230613,267,72,195,289.0,295.6,288.4
530,龙塔,20230614,271,78,193,267.0,291.0,286.7
531,龙塔,20230615,269,80,189,271.0,287.6,289.2
532,龙塔,20230616,254,68,186,269.0,270.0,288.9
533,龙塔,20230617,285,61,224,254.0,269.2,286.1
534,龙塔,20230618,267,0,267,285.0,269.2,282.4
535,龙塔,20230619,265,76,189,267.0,268.0,279.5
536,龙塔,20230620,259,66,193,265.0,266.0,276.8
537,龙塔,20230621,243,59,184,259.0,263.8,266.9
538,龙塔,20230622,312,64,248,243.0,269.2,269.2
539,龙塔,20230623,309,59,250,312.0,277.6,273.4
540,龙塔,20230624,208,0,208,309.0,266.2,267.1
541,龙塔,20230625,287,76,211,208.0,271.8,268.9
542,龙塔,20230626,270,64,206,287.0,277.2,270.5
543,龙塔,20230627,276,76,200,270.0,270.0,269.6
544,龙塔,20230628,294,85,209,276.0,267.0,272.3
545,龙塔,20230629,267,64,203,294.0,278.8,272.5
546,龙塔,20230630,252,70,182,267.0,271.8,271.8
547,龙塔,20230701,255,63,192,252.0,268.8,273.0
548,龙塔,20230702,298,63,235,255.0,273.2,271.6
549,龙塔,20230703,278,72,206,298.0,270.0,268.5
550,龙塔,20230704,256,66,190,278.0,267.8,273.3
551,龙塔,20230705,284,76,208,256.0,274.2,273.0
552,龙塔,20230706,270,78,192,284.0,277.2,273.0
553,龙塔,20230707,295,68,227,270.0,276.6,274.9
554,龙塔,20230708,344,66,278,295.0,289.8,279.9
555,龙塔,20230709,334,72,262,344.0,305.4,286.6
556,龙塔,20230710,293,78,215,334.0,307.2,290.7
557,龙塔,20230711,314,68,246,293.0,316.0,296.6
558,龙塔,20230712,333,70,263,314.0,323.6,300.1
559,龙塔,20230713,298,76,222,333.0,314.4,302.1
560,龙塔,20230714,289,70,219,298.0,305.4,305.4
561,龙塔,20230715,328,61,267,289.0,312.4,309.8
562,龙塔,20230716,316,63,253,328.0,312.8,314.4
563,龙塔,20230717,331,76,255,316.0,312.4,318.0
564,龙塔,20230718,322,76,246,331.0,317.2,315.8
565,龙塔,20230719,319,74,245,322.0,323.2,314.3
566,龙塔,20230720,319,78,241,319.0,321.4,316.9
567,龙塔,20230721,346,78,268,319.0,327.4,320.1
568,龙塔,20230722,338,68,270,346.0,328.8,320.6
569,龙塔,20230723,341,68,273,338.0,332.6,324.9
570,龙塔,20230724,367,87,280,341.0,342.2,332.7
571,龙塔,20230725,313,78,235,367.0,341.0,331.2
572,龙塔,20230726,358,70,288,313.0,343.4,335.4
573,龙塔,20230727,332,64,268,358.0,342.2,335.5
574,龙塔,20230728,376,78,298,332.0,349.2,340.9
575,龙塔,20230729,361,72,289,376.0,348.0,345.1
576,龙塔,20230730,389,66,323,361.0,363.2,352.1
577,龙塔,20230731,355,70,285,389.0,362.6,353.0
578,龙塔,20230801,354,83,271,355.0,367.0,354.6
579,龙塔,20230802,325,78,247,354.0,356.8,353.0
580,龙塔,20230803,331,74,257,325.0,350.8,349.4
581,龙塔,20230804,311,70,241,331.0,335.2,349.2
582,龙塔,20230805,347,63,284,311.0,333.6,348.1
583,龙塔,20230806,341,63,278,347.0,331.0,349.0
584,龙塔,20230807,404,101,303,341.0,346.8,351.8
585,龙塔,20230808,282,64,218,404.0,337.0,343.9
586,龙塔,20230809,323,76,247,282.0,339.4,337.3
587,龙塔,20230810,344,70,274,323.0,338.8,336.2
588,龙塔,20230811,311,72,239,344.0,332.8,331.9
589,龙塔,20230812,313,66,247,311.0,314.6,330.7
590,龙塔,20230813,295,70,225,313.0,317.2,327.1
591,龙塔,20230814,305,74,231,295.0,313.6,326.5
592,龙塔,20230815,309,68,241,305.0,306.6,322.7
593,龙塔,20230816,335,68,267,309.0,311.4,322.1
594,龙塔,20230817,307,68,239,335.0,310.2,312.4
595,龙塔,20230818,306,70,236,307.0,312.4,314.8
596,龙塔,20230819,354,72,282,306.0,322.2,317.9
597,龙塔,20230820,317,61,256,354.0,323.8,315.2
598,龙塔,20230821,312,74,238,317.0,319.2,315.3
599,龙塔,20230822,316,82,234,312.0,321.0,315.6
600,龙塔,20230823,282,70,212,316.0,316.2,314.3
601,龙塔,20230824,307,68,239,282.0,306.8,314.5
602,龙塔,20230825,325,80,245,307.0,308.4,316.1
603,龙塔,20230826,319,72,247,325.0,309.8,314.5
604,龙塔,20230827,290,63,227,319.0,304.6,312.8
605,龙塔,20230828,317,70,247,290.0,311.6,313.9
606,龙塔,20230829,282,76,206,317.0,306.6,306.7
607,龙塔,20230830,293,78,215,282.0,300.2,304.3
608,龙塔,20230831,258,63,195,293.0,288.0,298.9
609,龙塔,20230901,249,59,190,258.0,279.8,292.2
610,龙塔,20230902,256,63,193,249.0,267.6,289.6
611,龙塔,20230903,215,0,215,256.0,254.2,280.4
612,龙塔,20230904,229,68,161,215.0,241.4,270.8
613,龙塔,20230905,223,63,160,229.0,234.4,261.2
614,龙塔,20230906,244,64,180,223.0,233.4,256.6
615,龙塔,20230907,240,70,170,244.0,230.2,248.9
616,龙塔,20230908,261,66,195,240.0,239.4,246.8
617,龙塔,20230909,293,59,234,261.0,252.2,246.8
618,龙塔,20230910,337,64,273,293.0,275.0,254.7
619,龙塔,20230911,251,80,171,337.0,276.4,254.9
620,龙塔,20230912,271,78,193,251.0,282.6,256.4
621,龙塔,20230913,258,72,186,271.0,282.0,260.7
622,龙塔,20230914,250,63,187,258.0,273.4,262.8
623,龙塔,20230915,258,63,195,250.0,257.6,266.3
624,龙塔,20230916,280,66,214,258.0,263.4,269.9
625,龙塔,20230917,267,59,208,280.0,262.6,272.6
626,龙塔,20230918,243,70,173,267.0,259.6,270.8
627,龙塔,20230919,236,74,162,243.0,256.8,265.1
628,龙塔,20230920,248,72,176,236.0,254.8,256.2
629,龙塔,20230921,220,66,154,248.0,242.8,253.1
630,龙塔,20230922,242,72,170,220.0,237.8,250.2
631,龙塔,20230923,201,0,201,242.0,229.4,244.5
632,龙塔,20230924,250,63,187,201.0,232.2,244.5
633,龙塔,20230925,200,70,130,250.0,222.6,238.7
634,龙塔,20230926,226,66,160,200.0,223.8,233.3
635,龙塔,20230927,249,66,183,226.0,225.2,231.5
636,龙塔,20230928,241,61,180,249.0,233.2,231.3
637,龙塔,20230929,264,59,205,241.0,236.0,234.1
638,龙塔,20230930,322,63,259,264.0,260.4,241.5
639,龙塔,20231001,310,0,310,322.0,277.2,250.5
640,龙塔,20231002,390,0,390,310.0,305.4,265.3
641,龙塔,20231003,423,61,362,390.0,341.8,287.5
642,龙塔,20231004,417,68,349,423.0,372.4,304.2
643,龙塔,20231005,333,72,261,417.0,374.6,317.5
644,龙塔,20231006,306,64,242,333.0,373.8,325.5
645,龙塔,20231007,196,0,196,306.0,335.0,320.2
646,龙塔,20231008,233,63,170,196.0,297.0,319.4
647,龙塔,20231009,257,70,187,233.0,265.0,318.7
648,龙塔,20231010,261,72,189,257.0,250.6,312.6
649,龙塔,20231011,293,72,221,261.0,248.0,310.9
650,龙塔,20231012,304,83,221,293.0,269.6,302.3
651,龙塔,20231013,256,70,186,304.0,274.2,285.6
652,龙塔,20231014,282,74,208,256.0,279.2,272.1
653,龙塔,20231015,256,66,190,282.0,278.2,264.4
654,龙塔,20231016,282,85,197,256.0,276.0,262.0
655,龙塔,20231017,246,72,174,282.0,264.4,267.0
656,龙塔,20231018,236,72,164,246.0,260.4,267.3
657,龙塔,20231019,239,78,161,236.0,251.8,265.5
658,龙塔,20231020,230,68,162,239.0,246.6,262.4
659,龙塔,20231021,259,70,189,230.0,242.0,259.0
660,龙塔,20231022,245,68,177,259.0,241.8,253.1
661,龙塔,20231023,227,70,157,245.0,240.0,250.2
662,龙塔,20231024,203,72,131,227.0,232.8,242.3
663,龙塔,20231025,196,64,132,203.0,226.0,236.3
664,龙塔,20231026,219,80,139,196.0,218.0,230.0
665,龙塔,20231027,224,72,152,219.0,213.8,227.8
666,龙塔,20231028,248,59,189,224.0,218.0,229.0
667,龙塔,20231029,263,70,193,248.0,230.0,231.4
668,龙塔,20231030,234,80,154,263.0,237.6,231.8
669,龙塔,20231031,220,66,154,234.0,237.8,227.9
670,龙塔,20231101,235,83,152,220.0,240.0,226.9
671,龙塔,20231102,238,78,160,235.0,238.0,228.0
672,龙塔,20231103,223,74,149,238.0,230.0,230.0
673,龙塔,20231104,247,68,179,223.0,232.6,235.1
674,龙塔,20231105,223,68,155,247.0,233.2,235.5
675,龙塔,20231106,222,78,144,223.0,230.6,235.3
676,龙塔,20231107,246,87,159,222.0,232.2,235.1
677,龙塔,20231108,221,74,147,246.0,231.8,230.9
678,龙塔,20231109,221,66,155,221.0,226.6,229.6
679,龙塔,20231110,196,70,126,221.0,221.2,227.2
680,龙塔,20231111,219,64,155,196.0,220.6,225.6
681,龙塔,20231112,223,68,155,219.0,216.0,224.1
682,龙塔,20231113,213,74,139,223.0,214.4,223.1
683,龙塔,20231114,227,76,151,213.0,215.6,221.1
684,龙塔,20231115,244,89,155,227.0,225.2,223.2
685,龙塔,20231116,218,83,135,244.0,225.0,222.8
686,龙塔,20231117,232,70,162,218.0,226.8,221.4
687,龙塔,20231118,170,0,170,232.0,218.2,216.3
688,龙塔,20231119,174,0,174,170.0,207.6,211.6
689,龙塔,20231120,215,70,145,174.0,201.8,213.5
690,龙塔,20231121,248,99,149,215.0,207.8,216.4
691,龙塔,20231122,201,80,121,248.0,201.6,214.2
692,龙塔,20231123,223,80,143,201.0,212.2,215.2
693,龙塔,20231124,249,76,173,223.0,227.2,217.4
694,龙塔,20231125,259,85,174,249.0,236.0,218.9
695,龙塔,20231126,254,80,174,259.0,237.2,222.5
696,龙塔,20231127,224,76,148,254.0,241.8,221.7
697,龙塔,20231128,252,82,170,224.0,247.6,229.9
698,龙塔,20231129,250,95,155,252.0,247.8,237.5
699,龙塔,20231130,242,95,147,250.0,244.4,240.2
700,龙塔,20231201,220,66,154,242.0,237.6,237.4
701,龙塔,20231202,236,66,170,220.0,240.0,240.9
702,龙塔,20231203,259,64,195,236.0,241.4,244.5
703,龙塔,20231204,243,82,161,259.0,240.0,243.9
704,龙塔,20231205,239,87,152,243.0,239.4,241.9
705,龙塔,20231206,223,68,155,239.0,240.0,238.8
706,龙塔,20231207,231,70,161,223.0,239.0,239.5
707,龙塔,20231208,249,82,167,231.0,237.0,239.2
708,龙塔,20231209,230,70,160,249.0,234.4,237.2
709,龙塔,20231210,238,72,166,230.0,234.2,236.8
710,龙塔,20231211,194,72,122,238.0,228.4,234.2
711,龙塔,20231212,209,78,131,194.0,224.0,231.5
712,龙塔,20231213,213,70,143,209.0,216.8,226.9
713,龙塔,20231214,239,68,171,213.0,218.6,226.5
714,龙塔,20231215,225,70,155,239.0,216.0,225.1
715,龙塔,20231216,224,63,161,225.0,222.0,225.2
716,龙塔,20231217,233,63,170,224.0,226.8,225.4
717,龙塔,20231218,227,64,163,233.0,229.6,223.2
718,龙塔,20231219,255,85,170,227.0,232.8,225.7
719,龙塔,20231220,221,64,157,255.0,232.0,224.0
720,龙塔,20231221,219,72,147,221.0,231.0,226.5
721,龙塔,20231222,240,66,174,219.0,232.4,229.6
722,龙塔,20231223,254,61,193,240.0,237.8,233.7
723,龙塔,20231224,270,70,200,254.0,240.8,236.8
724,龙塔,20231225,232,78,154,270.0,243.0,237.5
725,龙塔,20231226,247,76,171,232.0,248.6,239.8
726,龙塔,20231227,251,74,177,247.0,250.8,241.6
727,龙塔,20231228,251,66,185,251.0,250.2,244.0
728,龙塔,20231229,275,80,195,251.0,251.2,246.0
729,龙塔,20231230,281,70,211,275.0,261.0,252.0
730,龙塔,20231231,270,59,211,281.0,265.6,257.1
731,龙塔,20240101,270,61,209,270.0,269.4,260.1
732,龙塔,20240102,215,70,145,270.0,262.2,256.2
733,龙塔,20240103,301,93,208,215.0,267.4,259.3
734,龙塔,20240104,257,76,181,301.0,262.6,261.8
735,龙塔,20240105,314,102,212,257.0,271.4,268.5
736,龙塔,20240106,280,72,208,314.0,273.4,271.4
737,龙塔,20240107,263,59,204,280.0,283.0,272.6
738,龙塔,20240108,286,87,199,263.0,280.0,273.7
739,龙塔,20240109,306,89,217,286.0,289.8,276.2
740,龙塔,20240110,289,87,202,306.0,284.8,278.1
741,龙塔,20240111,250,72,178,289.0,278.8,276.1
742,龙塔,20240112,246,70,176,250.0,275.4,279.2
743,龙塔,20240113,268,76,192,246.0,271.8,275.9
744,龙塔,20240114,252,68,184,268.0,261.0,275.4
745,龙塔,20240115,270,85,185,252.0,257.2,271.0
746,龙塔,20240116,256,83,173,270.0,258.4,268.6
747,龙塔,20240117,282,87,195,256.0,265.6,270.5
748,龙塔,20240118,266,82,184,282.0,265.2,268.5
749,龙塔,20240119,272,80,192,266.0,269.2,265.1
750,龙塔,20240120,266,63,203,272.0,268.4,262.8
751,龙塔,20240121,264,66,198,266.0,270.0,264.2
752,龙塔,20240122,249,68,181,264.0,263.4,264.5
753,龙塔,20240123,226,63,163,249.0,255.4,260.3
754,龙塔,20240124,238,76,162,226.0,248.6,258.9
755,龙塔,20240125,246,78,168,238.0,244.6,256.5
756,龙塔,20240126,261,82,179,246.0,244.0,257.0
757,龙塔,20240127,262,85,177,261.0,246.6,255.0
758,龙塔,20240128,300,68,232,262.0,261.4,258.4
759,龙塔,20240129,282,70,212,300.0,270.2,259.4
760,龙塔,20240130,303,76,227,282.0,281.6,263.1
761,龙塔,20240131,269,74,195,303.0,283.2,263.6
762,龙塔,20240201,255,70,185,269.0,281.8,264.2
763,龙塔,20240202,250,72,178,255.0,271.8,266.6
764,龙塔,20240203,258,63,195,250.0,267.0,268.6
765,龙塔,20240204,255,66,189,258.0,257.4,269.5
766,龙塔,20240205,298,63,235,255.0,263.2,273.2
767,龙塔,20240206,278,72,206,298.0,267.8,274.8
768,龙塔,20240207,244,68,176,278.0,266.6,269.2
769,龙塔,20240208,235,61,174,244.0,262.0,264.5
770,龙塔,20240209,305,63,242,235.0,272.0,264.7
771,龙塔,20240210,288,64,224,305.0,270.0,266.6
772,龙塔,20240211,371,63,308,288.0,288.6,278.2
773,龙塔,20240212,355,61,294,371.0,310.8,288.7
774,龙塔,20240213,460,70,390,355.0,355.8,308.9
775,龙塔,20240214,429,64,365,460.0,380.6,326.3
776,龙塔,20240215,415,61,354,429.0,406.0,338.0
777,龙塔,20240216,343,59,284,415.0,400.4,344.5
778,龙塔,20240217,389,63,326,343.0,407.2,359.0
779,龙塔,20240218,336,70,266,389.0,382.4,369.1
780,龙塔,20240219,306,78,228,336.0,357.8,369.2
781,龙塔,20240220,307,72,235,306.0,336.2,371.1
782,龙塔,20240221,298,74,224,307.0,327.2,363.8
783,龙塔,20240222,333,85,248,298.0,316.0,361.6
784,龙塔,20240223,289,74,215,333.0,306.6,344.5
785,龙塔,20240224,295,64,231,289.0,304.4,331.1
786,龙塔,20240225,279,59,220,295.0,298.8,317.5
787,龙塔,20240226,288,64,224,279.0,296.8,312.0
788,龙塔,20240227,284,83,201,288.0,287.0,301.5
789,龙塔,20240228,237,61,176,284.0,276.6,291.6
790,龙塔,20240229,235,64,171,237.0,264.6,284.5
791,龙塔,20240301,239,76,163,235.0,256.6,277.7
792,龙塔,20240302,224,64,160,239.0,243.8,270.3
793,龙塔,20240303,244,64,180,224.0,235.8,261.4
794,龙塔,20240304,244,74,170,244.0,237.2,256.9
795,龙塔,20240305,235,72,163,244.0,237.2,250.9
796,龙塔,20240306,228,68,160,235.0,235.0,245.8
797,龙塔,20240307,244,70,174,228.0,239.0,241.4
798,龙塔,20240308,261,66,195,244.0,242.4,239.1
799,龙塔,20240309,301,70,231,261.0,253.8,245.5
800,龙塔,20240310,267,59,208,301.0,260.2,248.7
801,龙塔,20240311,278,89,189,267.0,270.2,252.6
802,龙塔,20240312,242,87,155,278.0,269.8,254.4
803,龙塔,20240313,221,64,157,242.0,261.8,252.1
804,龙塔,20240314,219,72,147,221.0,245.4,249.6
805,龙塔,20240315,231,76,155,219.0,238.2,249.2
806,龙塔,20240316,222,68,154,231.0,227.0,248.6
807,龙塔,20240317,232,64,168,222.0,225.0,247.4
808,龙塔,20240318,209,64,145,232.0,222.6,242.2
809,龙塔,20240319,238,74,164,209.0,226.4,235.9
810,龙塔,20240320,207,72,135,238.0,221.6,229.9
811,龙塔,20240321,226,72,154,207.0,222.4,224.7
812,龙塔,20240322,202,68,134,226.0,216.4,220.7
813,龙塔,20240323,229,63,166,202.0,220.4,221.5
814,龙塔,20240324,242,68,174,229.0,221.2,223.8
815,龙塔,20240325,216,72,144,242.0,223.0,222.3
816,龙塔,20240326,224,63,161,216.0,222.6,222.5
817,龙塔,20240327,225,68,157,224.0,227.2,221.8
818,龙塔,20240328,237,78,159,225.0,228.8,224.6
819,龙塔,20240329,223,68,155,237.0,225.0,223.1
820,龙塔,20240330,250,61,189,223.0,231.8,227.4
821,龙塔,20240331,231,70,161,250.0,233.2,227.9
822,龙塔,20240401,221,72,149,231.0,232.4,229.8
823,龙塔,20240402,240,76,164,221.0,233.0,230.9
824,龙塔,20240403,231,83,148,240.0,234.6,229.8
825,龙塔,20240404,319,63,256,231.0,248.4,240.1
826,龙塔,20240405,340,63,277,319.0,270.2,251.7
827,龙塔,20240406,268,68,200,340.0,279.6,256.0
828,龙塔,20240407,218,74,144,268.0,275.2,254.1
829,龙塔,20240408,203,68,135,218.0,269.6,252.1
830,龙塔,20240409,220,63,157,203.0,249.8,249.1
831,龙塔,20240410,203,68,135,220.0,222.4,246.3
832,龙塔,20240411,199,74,125,203.0,208.6,244.1
833,龙塔,20240412,198,70,128,199.0,204.6,239.9
834,龙塔,20240413,247,63,184,198.0,213.4,241.5
835,龙塔,20240414,236,74,162,247.0,216.6,233.2
836,龙塔,20240415,199,61,138,236.0,215.8,219.1
837,龙塔,20240416,233,74,159,199.0,222.6,215.6
838,龙塔,20240417,218,63,155,233.0,226.6,215.6
839,龙塔,20240418,215,66,149,218.0,220.2,216.8
840,龙塔,20240419,225,76,149,215.0,218.0,217.3
841,龙塔,20240420,230,59,171,225.0,224.2,220.0
842,龙塔,20240421,241,61,180,230.0,225.8,224.2
843,龙塔,20240422,206,68,138,241.0,223.4,225.0
844,龙塔,20240423,245,82,163,206.0,229.4,224.8
845,龙塔,20240424,246,76,170,245.0,233.6,225.8
846,龙塔,20240425,242,66,176,246.0,236.0,230.1
847,龙塔,20240426,231,72,159,242.0,234.0,229.9
848,龙塔,20240427,259,66,193,231.0,244.6,234.0
849,龙塔,20240428,238,80,158,259.0,243.2,236.3
850,龙塔,20240429,187,61,126,238.0,231.4,232.5
851,龙塔,20240430,260,68,192,187.0,235.0,235.5
1,哈尔滨文化公园,20220101,63,0,63,260.0,201.4,217.7
2,哈尔滨文化公园,20220102,78,0,78,63.0,165.2,204.9
3,哈尔滨文化公园,20220103,84,0,84,78.0,134.4,188.8
4,哈尔滨文化公园,20220104,61,0,61,84.0,109.2,170.3
5,哈尔滨文化公园,20220105,63,0,63,61.0,69.8,152.4
6,哈尔滨文化公园,20220106,76,0,76,63.0,72.4,136.9
7,哈尔滨文化公园,20220107,59,59,0,76.0,68.6,116.9
8,哈尔滨文化公园,20220108,67,0,67,59.0,65.2,99.8
9,哈尔滨文化公园,20220109,129,59,70,67.0,78.8,94.0
10,哈尔滨文化公园,20220110,61,0,61,129.0,78.4,74.1
11,哈尔滨文化公园,20220111,66,0,66,61.0,76.4,74.4
12,哈尔滨文化公园,20220112,74,0,74,66.0,79.4,74.0
13,哈尔滨文化公园,20220113,125,59,66,74.0,91.0,78.1
14,哈尔滨文化公园,20220114,70,0,70,125.0,79.2,79.0
15,哈尔滨文化公园,20220115,70,0,70,70.0,81.0,79.7
16,哈尔滨文化公园,20220116,69,0,69,70.0,81.6,79.0
17,哈尔滨文化公园,20220117,61,0,61,69.0,79.0,79.2
18,哈尔滨文化公园,20220118,134,63,71,61.0,80.8,85.9
19,哈尔滨文化公园,20220119,124,59,65,134.0,91.6,85.4
20,哈尔滨文化公园,20220120,0,0,0,124.0,77.6,79.3
21,哈尔滨文化公园,20220121,63,0,63,0.0,76.4,79.0
22,哈尔滨文化公园,20220122,65,0,65,63.0,77.2,78.1
23,哈尔滨文化公园,20220123,69,0,69,65.0,64.2,72.5
24,哈尔滨文化公园,20220124,69,0,69,69.0,53.2,72.4
25,哈尔滨文化公园,20220125,0,0,0,69.0,53.2,65.4
26,哈尔滨文化公园,20220126,59,59,0,0.0,52.4,64.4
27,哈尔滨文化公园,20220127,130,61,69,59.0,65.4,71.3
28,哈尔滨文化公园,20220128,126,61,65,130.0,76.8,70.5
29,哈尔滨文化公园,20220129,63,0,63,126.0,75.6,64.4
30,哈尔滨文化公园,20220130,0,0,0,63.0,75.6,64.4
31,哈尔滨文化公园,20220131,0,0,0,0.0,63.8,58.1
32,哈尔滨文化公园,20220201,71,0,71,0.0,52.0,58.7
33,哈尔滨文化公园,20220202,69,0,69,71.0,40.6,58.7
34,哈尔滨文化公园,20220203,70,0,70,69.0,42.0,58.8
35,哈尔滨文化公园,20220204,66,0,66,70.0,55.2,65.4
36,哈尔滨文化公园,20220205,67,0,67,66.0,68.6,66.2
37,哈尔滨文化公园,20220206,70,0,70,67.0,68.4,60.2
38,哈尔滨文化公园,20220207,0,0,0,70.0,54.6,47.6
39,哈尔滨文化公园,20220208,126,61,65,0.0,65.8,53.9
40,哈尔滨文化公园,20220209,126,59,67,126.0,77.8,66.5
41,哈尔滨文化公园,20220210,71,0,71,126.0,78.6,73.6
42,哈尔滨文化公园,20220211,67,0,67,71.0,78.0,73.2
43,哈尔滨文化公园,20220212,67,0,67,67.0,91.4,73.0
44,哈尔滨文化公园,20220213,66,0,66,67.0,79.4,72.6
45,哈尔滨文化公园,20220214,0,0,0,66.0,54.2,66.0
46,哈尔滨文化公园,20220215,66,0,66,0.0,53.2,65.9
47,哈尔滨文化公园,20220216,63,0,63,66.0,52.4,65.2
48,哈尔滨文化公园,20220217,67,0,67,63.0,52.4,71.9
49,哈尔滨文化公园,20220218,135,59,76,67.0,66.2,72.8
50,哈尔滨文化公园,20220219,71,0,71,135.0,80.4,67.3
51,哈尔滨文化公园,20220220,71,0,71,71.0,81.4,67.3
52,哈尔滨文化公园,20220221,126,59,67,71.0,94.0,73.2
53,哈尔滨文化公园,20220222,127,61,66,126.0,106.0,79.2
54,哈尔滨文化公园,20220223,67,0,67,127.0,92.4,79.3
55,哈尔滨文化公园,20220224,135,61,74,67.0,105.2,92.8
56,哈尔滨文化公园,20220225,71,0,71,135.0,105.2,93.3
57,哈尔滨文化公园,20220226,66,0,66,71.0,93.2,93.6
58,哈尔滨文化公园,20220227,71,0,71,66.0,82.0,94.0
59,哈尔滨文化公园,20220228,126,59,67,71.0,93.8,93.1
60,哈尔滨文化公园,20220301,78,0,78,126.0,82.4,93.8
61,哈尔滨文化公园,20220302,61,0,61,78.0,80.4,92.8
62,哈尔滨文化公园,20220303,144,68,76,61.0,96.0,94.6
63,哈尔滨文化公园,20220304,129,63,66,144.0,107.6,94.8
64,哈尔滨文化公园,20220305,63,0,63,129.0,95.0,94.4
65,哈尔滨文化公园,20220306,79,0,79,63.0,95.2,88.8
66,哈尔滨文化公园,20220307,71,0,71,79.0,97.2,88.8
67,哈尔滨文化公园,20220308,79,0,79,71.0,84.2,90.1
68,哈尔滨文化公园,20220309,74,0,74,79.0,73.2,90.4
69,哈尔滨文化公园,20220310,78,0,78,74.0,76.2,85.6
70,哈尔滨文化公园,20220311,70,0,70,78.0,74.4,84.8
71,哈尔滨文化公园,20220312,71,0,71,70.0,74.4,85.8
72,哈尔滨文化公园,20220313,139,61,78,71.0,86.4,85.3
73,哈尔滨文化公园,20220314,128,59,69,139.0,97.2,85.2
74,哈尔滨文化公园,20220315,133,63,70,128.0,108.2,92.2
75,哈尔滨文化公园,20220316,142,64,78,133.0,122.6,98.5
76,哈尔滨文化公园,20220317,65,0,65,142.0,121.4,97.9
77,哈尔滨文化公园,20220318,69,0,69,65.0,107.4,96.9
78,哈尔滨文化公园,20220319,71,0,71,69.0,96.0,96.6
79,哈尔滨文化公园,20220320,69,0,69,71.0,83.2,95.7
80,哈尔滨文化公园,20220321,130,61,69,69.0,80.8,101.7
81,哈尔滨文化公园,20220322,130,59,71,130.0,93.8,107.6
82,哈尔滨文化公园,20220323,65,0,65,130.0,93.0,100.2
83,哈尔滨文化公园,20220324,61,61,0,65.0,91.0,93.5
84,哈尔滨文化公园,20220325,126,59,67,61.0,102.4,92.8
85,哈尔滨文化公园,20220326,74,0,74,126.0,91.2,86.0
86,哈尔滨文化公园,20220327,79,0,79,74.0,81.0,87.4
87,哈尔滨文化公园,20220328,78,0,78,79.0,83.6,88.3
88,哈尔滨文化公园,20220329,120,59,61,78.0,95.4,93.2
89,哈尔滨文化公园,20220330,143,61,82,120.0,98.8,100.6
90,哈尔滨文化公园,20220331,74,0,74,143.0,98.8,95.0
91,哈尔滨文化公园,20220401,130,59,71,74.0,109.0,95.0
92,哈尔滨文化公园,20220402,78,0,78,130.0,109.0,96.3
93,哈尔滨文化公园,20220403,139,59,80,78.0,112.8,104.1
94,哈尔滨文化公园,20220404,71,0,71,139.0,98.4,98.6
95,哈尔滨文化公园,20220405,132,61,71,71.0,110.0,104.4
96,哈尔滨文化公园,20220406,67,0,67,132.0,97.4,103.2
97,哈尔滨文化公园,20220407,74,0,74,67.0,96.6,102.8
98,哈尔滨文化公园,20220408,76,0,76,74.0,84.0,98.4
99,哈尔滨文化公园,20220409,71,0,71,76.0,84.0,91.2
100,哈尔滨文化公园,20220410,76,0,76,71.0,72.8,91.4
101,哈尔滨文化公园,20220411,145,59,86,76.0,88.4,92.9
102,哈尔滨文化公园,20220412,136,66,70,145.0,100.8,98.7
103,哈尔滨文化公园,20220413,71,0,71,136.0,99.8,91.9
104,哈尔滨文化公园,20220414,73,0,73,71.0,100.2,92.1
105,哈尔滨文化公园,20220415,66,0,66,73.0,98.2,85.5
106,哈尔滨文化公园,20220416,73,0,73,66.0,83.8,86.1
107,哈尔滨文化公园,20220417,132,59,73,73.0,83.0,91.9
108,哈尔滨文化公园,20220418,67,0,67,132.0,82.2,91.0
109,哈尔滨文化公园,20220419,65,0,65,67.0,80.6,90.4
110,哈尔滨文化公园,20220420,78,0,78,65.0,83.0,90.6
111,哈尔滨文化公园,20220421,120,59,61,78.0,92.4,88.1
112,哈尔滨文化公园,20220422,74,0,74,120.0,80.8,81.9
113,哈尔滨文化公园,20220423,63,0,63,74.0,80.0,81.1
114,哈尔滨文化公园,20220424,122,59,63,63.0,91.4,86.0
115,哈尔滨文化公园,20220425,79,0,79,122.0,91.6,87.3
116,哈尔滨文化公园,20220426,80,0,80,79.0,83.6,88.0
117,哈尔滨文化公园,20220427,124,59,65,80.0,93.6,87.2
118,哈尔滨文化公园,20220428,80,0,80,124.0,97.0,88.5
119,哈尔滨文化公园,20220429,78,0,78,80.0,88.2,89.8
120,哈尔滨文化公园,20220430,143,59,84,78.0,101.0,96.3
121,哈尔滨文化公园,20220501,140,64,76,143.0,113.0,98.3
122,哈尔滨文化公园,20220502,80,0,80,140.0,104.2,98.9
123,哈尔滨文化公园,20220503,132,59,73,80.0,114.6,105.8
124,哈尔滨文化公园,20220504,78,0,78,132.0,114.6,101.4
125,哈尔滨文化公园,20220505,93,0,93,78.0,104.6,102.8
126,哈尔滨文化公园,20220506,137,61,76,93.0,104.0,108.5
127,哈尔滨文化公园,20220507,78,0,78,137.0,103.6,103.9
128,哈尔滨文化公园,20220508,99,0,99,78.0,97.0,105.8
129,哈尔滨文化公园,20220509,95,0,95,99.0,100.4,107.5
130,哈尔滨文化公园,20220510,146,59,87,95.0,111.0,107.8
131,哈尔滨文化公园,20220511,165,63,102,146.0,116.6,110.3
132,哈尔滨文化公园,20220512,79,0,79,165.0,116.8,110.2
133,哈尔滨文化公园,20220513,142,63,79,79.0,125.4,111.2
134,哈尔滨文化公园,20220514,158,59,99,142.0,138.0,119.2
135,哈尔滨文化公园,20220515,109,0,109,158.0,130.6,120.8
136,哈尔滨文化公园,20220516,141,59,82,109.0,125.8,121.2
137,哈尔滨文化公园,20220517,79,0,79,141.0,125.8,121.3
138,哈尔滨文化公园,20220518,86,0,86,79.0,114.6,120.0
139,哈尔滨文化公园,20220519,95,0,95,86.0,102.0,120.0
140,哈尔滨文化公园,20220520,92,0,92,95.0,98.6,114.6
141,哈尔滨文化公园,20220521,168,63,105,92.0,104.0,114.9
142,哈尔滨文化公园,20220522,118,0,118,168.0,111.8,118.8
143,哈尔滨文化公园,20220523,153,64,89,118.0,125.2,119.9
144,哈尔滨文化公园,20220524,154,61,93,153.0,137.0,119.5
145,哈尔滨文化公园,20220525,139,59,80,154.0,146.4,122.5
146,哈尔滨文化公园,20220526,145,61,84,139.0,141.8,122.9
147,哈尔滨文化公园,20220527,93,0,93,145.0,136.8,124.3
148,哈尔滨文化公园,20220528,182,59,123,93.0,142.6,133.9
149,哈尔滨文化公园,20220529,151,59,92,182.0,142.0,139.5
150,哈尔滨文化公园,20220530,150,66,84,151.0,144.2,145.3
151,哈尔滨文化公园,20220531,118,0,118,150.0,138.8,140.3
152,哈尔滨文化公园,20220601,239,63,176,118.0,168.0,152.4
153,哈尔滨文化公园,20220602,128,0,128,239.0,157.2,149.9
154,哈尔滨文化公园,20220603,195,0,195,128.0,166.0,154.0
155,哈尔滨文化公园,20220604,135,0,135,195.0,163.0,153.6
156,哈尔滨文化公园,20220605,109,0,109,135.0,161.2,150.0
157,哈尔滨文化公园,20220606,156,61,95,109.0,144.6,156.3
158,哈尔滨文化公园,20220607,169,63,106,156.0,152.8,155.0
159,哈尔滨文化公园,20220608,113,0,113,169.0,136.4,151.2
160,哈尔滨文化公园,20220609,193,68,125,113.0,148.0,155.5
161,哈尔滨文化公园,20220610,156,64,92,193.0,157.4,159.3
162,哈尔滨文化公园,20220611,173,61,112,156.0,160.8,152.7
163,哈尔滨文化公园,20220612,176,61,115,173.0,162.2,157.5
164,哈尔滨文化公园,20220613,163,61,102,176.0,172.2,154.3
165,哈尔滨文化公园,20220614,154,61,93,163.0,164.4,156.2
166,哈尔滨文化公园,20220615,138,59,79,154.0,160.8,159.1
167,哈尔滨文化公园,20220616,71,0,71,138.0,140.4,150.6
168,哈尔滨文化公园,20220617,172,66,106,71.0,139.6,150.9
169,哈尔滨文化公园,20220618,123,0,123,172.0,131.6,151.9
170,哈尔滨文化公园,20220619,102,0,102,123.0,121.2,142.8
171,哈尔滨文化公园,20220620,156,63,93,102.0,124.8,142.8
172,哈尔滨文化公园,20220621,106,0,106,156.0,131.8,136.1
173,哈尔滨文化公园,20220622,147,64,83,106.0,126.8,133.2
174,哈尔滨文化公园,20220623,86,0,86,147.0,119.4,125.5
175,哈尔滨文化公园,20220624,86,0,86,86.0,116.2,118.7
176,哈尔滨文化公园,20220625,163,61,102,86.0,117.6,121.2
177,哈尔滨文化公园,20220626,168,59,109,163.0,130.0,130.9
178,哈尔滨文化公园,20220627,155,59,96,168.0,131.6,129.2
179,哈尔滨文化公园,20220628,99,0,99,155.0,134.2,126.8
180,哈尔滨文化公园,20220629,176,61,115,99.0,152.2,134.2
181,哈尔滨文化公园,20220630,183,66,117,176.0,156.2,136.9
182,哈尔滨文化公园,20220701,169,63,106,183.0,156.4,143.2
183,哈尔滨文化公园,20220702,121,0,121,169.0,149.6,140.6
184,哈尔滨文化公园,20220703,192,61,131,121.0,168.2,151.2
185,哈尔滨文化公园,20220704,157,61,96,192.0,164.4,158.3
186,哈尔滨文化公园,20220705,177,59,118,157.0,163.2,159.7
187,哈尔滨文化公园,20220706,185,59,126,177.0,166.4,161.4
188,哈尔滨文化公园,20220707,186,63,123,185.0,179.4,164.5
189,哈尔滨文化公园,20220708,138,0,138,186.0,168.6,168.4
190,哈尔滨文化公园,20220709,203,59,144,138.0,177.8,171.1
191,哈尔滨文化公园,20220710,195,61,134,203.0,181.4,172.3
192,哈尔滨文化公园,20220711,211,59,152,195.0,186.6,176.5
193,哈尔滨文化公园,20220712,209,61,148,211.0,191.2,185.3
194,哈尔滨文化公园,20220713,198,63,135,209.0,203.2,185.9
195,哈尔滨文化公园,20220714,195,63,132,198.0,201.6,189.7
196,哈尔滨文化公园,20220715,138,0,138,195.0,190.2,185.8
197,哈尔滨文化公园,20220716,215,61,154,138.0,191.0,188.8
198,哈尔滨文化公园,20220717,171,0,171,215.0,183.4,187.3
199,哈尔滨文化公园,20220718,195,59,136,171.0,182.8,193.0
200,哈尔滨文化公园,20220719,217,59,158,195.0,187.2,194.4
201,哈尔滨文化公园,20220720,202,63,139,217.0,200.0,195.1
202,哈尔滨文化公园,20220721,203,64,139,202.0,197.6,194.3
203,哈尔滨文化公园,20220722,210,63,147,203.0,205.4,194.4
204,哈尔滨文化公园,20220723,230,63,167,210.0,212.4,197.6
205,哈尔滨文化公园,20220724,196,61,135,230.0,208.2,197.7
206,哈尔滨文化公园,20220725,189,63,126,196.0,205.6,202.8
207,哈尔滨文化公园,20220726,215,66,149,189.0,208.0,202.8
208,哈尔滨文化公园,20220727,155,0,155,215.0,197.0,201.2
209,哈尔滨文化公园,20220728,218,66,152,155.0,194.6,203.5
210,哈尔滨文化公园,20220729,187,64,123,218.0,192.8,200.5
211,哈尔滨文化公园,20220730,160,0,160,187.0,187.0,196.3
212,哈尔滨文化公园,20220731,174,0,174,160.0,178.8,193.4
213,哈尔滨文化公园,20220801,215,64,151,174.0,190.8,193.9
214,哈尔滨文化公园,20220802,216,61,155,215.0,190.4,192.5
215,哈尔滨文化公园,20220803,157,0,157,216.0,184.4,188.6
216,哈尔滨文化公园,20220804,209,61,148,157.0,194.2,190.6
217,哈尔滨文化公园,20220805,224,59,165,209.0,204.2,191.5
218,哈尔滨文化公园,20220806,245,64,181,224.0,210.2,200.5
219,哈尔滨文化公园,20220807,207,59,148,245.0,208.4,199.4
220,哈尔滨文化公园,20220808,211,59,152,207.0,219.2,201.8
221,哈尔滨文化公园,20220809,128,0,128,211.0,203.0,198.6
222,哈尔滨文化公园,20220810,157,61,96,128.0,189.6,196.9
223,哈尔滨文化公园,20220811,184,61,123,157.0,177.4,193.8
224,哈尔滨文化公园,20220812,131,0,131,184.0,162.2,185.3
225,哈尔滨文化公园,20220813,182,61,121,131.0,156.4,187.8
226,哈尔滨文化公园,20220814,145,0,145,182.0,159.8,181.4
227,哈尔滨文化公园,20220815,126,0,126,145.0,153.6,171.6
228,哈尔滨文化公园,20220816,119,0,119,126.0,140.6,159.0
229,哈尔滨文化公园,20220817,198,64,134,119.0,154.0,158.1
230,哈尔滨文化公园,20220818,180,59,121,198.0,153.6,155.0
231,哈尔滨文化公园,20220819,105,0,105,180.0,145.6,152.7
232,哈尔滨文化公园,20220820,135,0,135,105.0,147.4,150.5
233,哈尔滨文化公园,20220821,125,0,125,135.0,148.6,144.6
234,哈尔滨文化公园,20220822,150,59,91,125.0,139.0,146.5
235,哈尔滨文化公园,20220823,97,0,97,150.0,122.4,138.0
236,哈尔滨文化公园,20220824,102,0,102,97.0,121.8,133.7
237,哈尔滨文化公园,20220825,148,59,89,102.0,124.4,135.9
238,哈尔滨文化公园,20220826,92,0,92,148.0,117.8,133.2
239,哈尔滨文化公园,20220827,173,63,110,92.0,122.4,130.7
240,哈尔滨文化公园,20220828,87,0,87,173.0,120.4,121.4
241,哈尔滨文化公园,20220829,71,0,71,87.0,114.2,118.0
242,哈尔滨文化公园,20220830,73,0,73,71.0,99.2,111.8
243,哈尔滨文化公园,20220831,82,0,82,73.0,97.2,107.5
244,哈尔滨文化公园,20220901,124,59,65,82.0,87.4,104.9
245,哈尔滨文化公园,20220902,71,0,71,124.0,84.2,102.3
246,哈尔滨文化公园,20220903,133,59,74,71.0,96.6,105.4
247,哈尔滨文化公园,20220904,78,0,78,133.0,97.6,98.4
248,哈尔滨文化公园,20220905,67,0,67,78.0,94.6,95.9
249,哈尔滨文化公园,20220906,67,0,67,67.0,83.2,85.3
250,哈尔滨文化公园,20220907,132,61,71,67.0,95.4,89.8
251,哈尔滨文化公园,20220908,133,59,74,132.0,95.4,96.0
252,哈尔滨文化公园,20220909,143,59,84,133.0,108.4,103.0
253,哈尔滨文化公园,20220910,100,0,100,143.0,115.0,104.8
254,哈尔滨文化公园,20220911,100,0,100,100.0,121.6,102.4
255,哈尔滨文化公园,20220912,115,0,115,100.0,118.2,106.8
256,哈尔滨文化公园,20220913,137,61,76,115.0,119.0,107.2
257,哈尔滨文化公园,20220914,92,0,92,137.0,108.8,108.6
258,哈尔滨文化公园,20220915,80,0,80,92.0,104.8,109.9
259,哈尔滨文化公园,20220916,146,59,87,80.0,114.0,117.8
260,哈尔滨文化公园,20220917,80,0,80,146.0,107.0,112.6
261,哈尔滨文化公园,20220918,84,0,84,80.0,96.4,107.7
262,哈尔滨文化公园,20220919,69,0,69,84.0,91.8,100.3
263,哈尔滨文化公园,20220920,70,0,70,69.0,89.8,97.3
264,哈尔滨文化公园,20220921,126,59,67,70.0,85.8,99.9
265,哈尔滨文化公园,20220922,124,61,63,126.0,94.6,100.8
266,哈尔滨文化公园,20220923,61,0,61,124.0,90.0,93.2
267,哈尔滨文化公园,20220924,70,0,70,61.0,90.2,91.0
268,哈尔滨文化公园,20220925,95,0,95,70.0,95.2,92.5
269,哈尔滨文化公园,20220926,128,63,65,95.0,95.6,90.7
270,哈尔滨文化公园,20220927,131,61,70,128.0,97.0,95.8
271,哈尔滨文化公园,20220928,124,59,65,131.0,109.6,99.8
272,哈尔滨文化公园,20220929,71,0,71,124.0,109.8,100.0
273,哈尔滨文化公园,20220930,86,0,86,71.0,108.0,101.6
274,哈尔滨文化公园,20221001,109,0,109,86.0,104.2,99.9
275,哈尔滨文化公园,20221002,109,0,109,109.0,99.8,98.4
276,哈尔滨文化公园,20221003,76,0,76,109.0,90.2,99.9
277,哈尔滨文化公园,20221004,89,0,89,76.0,93.8,101.8
278,哈尔滨文化公园,20221005,76,0,76,89.0,91.8,99.9
279,哈尔滨文化公园,20221006,78,0,78,76.0,85.6,94.9
280,哈尔滨文化公园,20221007,78,0,78,78.0,79.4,89.6
281,哈尔滨文化公园,20221008,73,0,73,78.0,78.8,84.5
282,哈尔滨文化公园,20221009,63,0,63,73.0,73.6,83.7
283,哈尔滨文化公园,20221010,63,0,63,63.0,71.0,81.4
284,哈尔滨文化公园,20221011,69,0,69,63.0,69.2,77.4
285,哈尔滨文化公园,20221012,86,0,86,69.0,70.8,75.1
286,哈尔滨文化公园,20221013,67,0,67,86.0,69.6,74.2
287,哈尔滨文化公园,20221014,134,63,71,67.0,83.8,78.7
288,哈尔滨文化公园,20221015,73,0,73,134.0,85.8,78.4
289,哈尔滨文化公园,20221016,76,0,76,73.0,87.2,78.2
290,哈尔滨文化公园,20221017,73,0,73,76.0,84.6,77.7
291,哈尔滨文化公园,20221018,76,0,76,73.0,86.4,78.0
292,哈尔滨文化公园,20221019,78,0,78,76.0,75.2,79.5
293,哈尔滨文化公园,20221020,142,59,83,78.0,89.0,87.4
294,哈尔滨文化公园,20221021,82,0,82,142.0,90.2,88.7
295,哈尔滨文化公园,20221022,105,0,105,82.0,96.6,90.6
296,哈尔滨文化公园,20221023,100,0,100,105.0,101.4,93.9
297,哈尔滨文化公园,20221024,79,0,79,100.0,101.6,88.4
298,哈尔滨文化公园,20221025,70,0,70,79.0,87.2,88.1
299,哈尔滨文化公园,20221026,67,0,67,70.0,84.2,87.2
300,哈尔滨文化公园,20221027,87,0,87,67.0,80.6,88.6
301,哈尔滨文化公园,20221028,70,0,70,87.0,74.6,88.0
302,哈尔滨文化公园,20221029,74,0,74,70.0,73.6,87.6
303,哈尔滨文化公园,20221030,80,0,80,74.0,75.6,81.4
304,哈尔滨文化公园,20221031,133,59,74,80.0,88.8,86.5
305,哈尔滨文化公园,20221101,70,0,70,133.0,85.4,83.0
306,哈尔滨文化公园,20221102,66,0,66,70.0,84.6,79.6
307,哈尔滨文化公园,20221103,61,0,61,66.0,82.0,77.8
308,哈尔滨文化公园,20221104,61,0,61,61.0,78.2,76.9
309,哈尔滨文化公园,20221105,61,0,61,61.0,63.8,76.3
310,哈尔滨文化公园,20221106,73,0,73,61.0,64.4,74.9
311,哈尔滨文化公园,20221107,66,0,66,73.0,64.4,74.5
312,哈尔滨文化公园,20221108,71,0,71,66.0,66.4,74.2
313,哈尔滨文化公园,20221109,79,0,79,71.0,70.0,74.1
314,哈尔滨文化公园,20221110,73,0,73,79.0,72.4,68.1
315,哈尔滨文化公园,20221111,70,0,70,73.0,71.8,68.1
316,哈尔滨文化公园,20221112,124,59,65,70.0,83.4,73.9
317,哈尔滨文化公园,20221113,70,0,70,124.0,83.2,74.8
318,哈尔滨文化公园,20221114,61,0,61,70.0,79.6,74.8
319,哈尔滨文化公园,20221115,139,68,71,61.0,92.8,82.6
320,哈尔滨文化公园,20221116,66,0,66,139.0,92.0,81.9
321,哈尔滨文化公园,20221117,70,0,70,66.0,81.2,82.3
322,哈尔滨文化公园,20221118,0,0,0,70.0,67.2,75.2
323,哈尔滨文化公园,20221119,69,0,69,0.0,68.8,74.2
324,哈尔滨文化公园,20221120,122,59,63,69.0,65.4,79.1
325,哈尔滨文化公园,20221121,122,59,63,122.0,76.6,84.3
326,哈尔滨文化公园,20221122,65,0,65,122.0,75.6,78.4
327,哈尔滨文化公园,20221123,129,66,63,65.0,101.4,84.3
328,哈尔滨文化公园,20221124,65,0,65,129.0,100.6,84.7
329,哈尔滨文化公园,20221125,130,64,66,65.0,102.2,83.8
330,哈尔滨文化公园,20221126,0,0,0,130.0,77.8,77.2
331,哈尔滨文化公园,20221127,130,59,71,0.0,90.8,83.2
332,哈尔滨文化公园,20221128,0,0,0,130.0,65.0,83.2
333,哈尔滨文化公园,20221129,67,0,67,0.0,65.4,83.0
334,哈尔滨文化公园,20221130,64,64,0,67.0,52.2,77.2
335,哈尔滨文化公园,20221201,59,59,0,64.0,64.0,70.9
336,哈尔滨文化公园,20221202,65,0,65,59.0,51.0,70.9
337,哈尔滨文化公园,20221203,70,0,70,65.0,65.0,65.0
338,哈尔滨文化公园,20221204,70,0,70,70.0,65.6,65.5
339,哈尔滨文化公园,20221205,0,0,0,70.0,52.8,52.5
340,哈尔滨文化公园,20221206,0,0,0,0.0,41.0,52.5
341,哈尔滨文化公园,20221207,66,0,66,0.0,41.2,46.1
342,哈尔滨文化公园,20221208,65,0,65,66.0,40.2,52.6
343,哈尔滨文化公园,20221209,65,0,65,65.0,39.2,52.4
344,哈尔滨文化公园,20221210,67,0,67,65.0,52.6,52.7
345,哈尔滨文化公园,20221211,63,0,63,67.0,65.2,53.1
346,哈尔滨文化公园,20221212,66,0,66,63.0,65.2,53.2
347,哈尔滨文化公园,20221213,0,0,0,66.0,52.2,46.2
348,哈尔滨文化公园,20221214,126,59,67,0.0,64.4,51.8
349,哈尔滨文化公园,20221215,66,0,66,126.0,64.2,58.4
350,哈尔滨文化公园,20221216,70,0,70,66.0,65.6,65.4
351,哈尔滨文化公园,20221217,73,0,73,70.0,67.0,66.1
352,哈尔滨文化公园,20221218,63,0,63,73.0,79.6,65.9
353,哈尔滨文化公园,20221219,127,61,66,63.0,79.8,72.1
354,哈尔滨文化公园,20221220,63,0,63,127.0,79.2,71.7
355,哈尔滨文化公园,20221221,0,0,0,63.0,65.2,65.4
356,哈尔滨文化公园,20221222,61,0,61,0.0,62.8,64.9
357,哈尔滨文化公园,20221223,65,0,65,61.0,63.2,71.4
358,哈尔滨文化公园,20221224,0,0,0,65.0,37.8,58.8
359,哈尔滨文化公园,20221225,63,0,63,0.0,37.8,58.5
360,哈尔滨文化公园,20221226,0,0,0,63.0,37.8,51.5
361,哈尔滨文化公园,20221227,122,61,61,0.0,50.0,56.4
362,哈尔滨文化公园,20221228,128,63,65,122.0,62.6,62.9
363,哈尔滨文化公园,20221229,65,0,65,128.0,75.6,56.7
364,哈尔滨文化公园,20221230,83,0,83,65.0,79.6,58.7
365,哈尔滨文化公园,20221231,69,0,69,83.0,93.4,65.6
366,哈尔滨文化公园,20230101,61,0,61,69.0,81.2,65.6
367,哈尔滨文化公园,20230102,80,0,80,61.0,71.6,67.1
368,哈尔滨文化公园,20230103,69,0,69,80.0,72.4,74.0
369,哈尔滨文化公园,20230104,135,59,76,69.0,82.8,81.2
370,哈尔滨文化公园,20230105,132,59,73,135.0,95.4,94.4
371,哈尔滨文化公园,20230106,66,0,66,132.0,96.4,88.8
372,哈尔滨文化公园,20230107,84,0,84,66.0,97.2,84.4
373,哈尔滨文化公园,20230108,70,0,70,84.0,97.4,84.9
374,哈尔滨文化公园,20230109,132,59,73,70.0,96.8,89.8
375,哈尔滨文化公园,20230110,137,59,78,132.0,97.8,96.6
376,哈尔滨文化公园,20230111,130,59,71,137.0,110.6,103.5
377,哈尔滨文化公园,20230112,130,63,67,130.0,119.8,108.5
378,哈尔滨文化公园,20230113,137,61,76,130.0,133.2,115.3
379,哈尔滨文化公园,20230114,79,0,79,137.0,122.6,109.7
380,哈尔滨文化公园,20230115,92,0,92,79.0,113.6,105.7
381,哈尔滨文化公园,20230116,74,0,74,92.0,102.4,106.5
382,哈尔滨文化公园,20230117,79,0,79,74.0,92.2,106.0
383,哈尔滨文化公园,20230118,65,0,65,79.0,77.8,105.5
384,哈尔滨文化公园,20230119,74,0,74,65.0,76.8,99.7
385,哈尔滨文化公园,20230120,66,0,66,74.0,71.6,92.6
386,哈尔滨文化公园,20230121,69,0,69,66.0,70.6,86.5
387,哈尔滨文化公园,20230122,137,61,76,69.0,82.2,87.2
388,哈尔滨文化公园,20230123,87,0,87,137.0,86.6,82.2
389,哈尔滨文化公园,20230124,71,0,71,87.0,86.0,81.4
390,哈尔滨文化公园,20230125,73,0,73,71.0,87.4,79.5
391,哈尔滨文化公园,20230126,79,0,79,73.0,89.4,80.0
392,哈尔滨文化公园,20230127,84,0,84,79.0,78.8,80.5
393,哈尔滨文化公园,20230128,74,0,74,84.0,76.2,81.4
394,哈尔滨文化公园,20230129,73,0,73,74.0,76.6,81.3
395,哈尔滨文化公园,20230130,74,0,74,73.0,76.8,82.1
396,哈尔滨文化公园,20230131,137,61,76,74.0,88.4,88.9
397,哈尔滨文化公园,20230201,76,0,76,137.0,86.8,82.8
398,哈尔滨文化公园,20230202,76,0,76,76.0,87.2,81.7
399,哈尔滨文化公园,20230203,86,0,86,76.0,89.8,83.2
400,哈尔滨文化公园,20230204,83,0,83,86.0,91.6,84.2
401,哈尔滨文化公园,20230205,95,0,95,83.0,83.2,85.8
402,哈尔滨文化公园,20230206,74,0,74,95.0,82.8,84.8
403,哈尔滨文化公园,20230207,141,61,80,74.0,95.8,91.5
404,哈尔滨文化公园,20230208,86,0,86,141.0,95.8,92.8
405,哈尔滨文化公园,20230209,78,0,78,86.0,94.8,93.2
406,哈尔滨文化公园,20230210,100,0,100,78.0,95.8,89.5
407,哈尔滨文化公园,20230211,87,0,87,100.0,98.4,90.6
408,哈尔滨文化公园,20230212,80,0,80,87.0,86.2,91.0
409,哈尔滨文化公园,20230213,80,0,80,80.0,85.0,90.4
410,哈尔滨文化公园,20230214,76,0,76,80.0,84.6,89.7
411,哈尔滨文化公园,20230215,79,0,79,76.0,80.4,88.1
412,哈尔滨文化公园,20230216,78,0,78,79.0,78.6,88.5
413,哈尔滨文化公园,20230217,79,0,79,78.0,78.4,82.3
414,哈尔滨文化公园,20230218,92,0,92,79.0,80.8,82.9
415,哈尔滨文化公园,20230219,143,59,84,92.0,94.2,89.4
416,哈尔滨文化公园,20230220,74,0,74,143.0,93.2,86.8
417,哈尔滨文化公园,20230221,84,0,84,74.0,94.4,86.5
418,哈尔滨文化公园,20230222,80,0,80,84.0,94.6,86.5
419,哈尔滨文化公园,20230223,143,64,79,80.0,104.8,92.8
420,哈尔滨文化公园,20230224,140,61,79,143.0,104.2,99.2
421,哈尔滨文化公园,20230225,119,0,119,140.0,113.2,103.2
422,哈尔滨文化公园,20230226,92,0,92,119.0,114.8,104.6
423,哈尔滨文化公园,20230227,145,59,86,92.0,127.8,111.2
424,哈尔滨文化公园,20230228,69,0,69,145.0,113.0,108.9
425,哈尔滨文化公园,20230301,133,59,74,69.0,111.6,107.9
426,哈尔滨文化公园,20230302,141,61,80,133.0,116.0,114.6
427,哈尔滨文化公园,20230303,142,63,79,141.0,126.0,120.4
428,哈尔滨文化公园,20230304,109,0,109,142.0,118.8,123.3
429,哈尔滨文化公园,20230305,117,0,117,109.0,128.4,120.7
430,哈尔滨文化公园,20230306,83,0,83,117.0,118.4,115.0
431,哈尔滨文化公园,20230307,141,59,82,83.0,118.4,117.2
432,哈尔滨文化公园,20230308,118,0,118,141.0,113.6,119.8
433,哈尔滨文化公园,20230309,136,63,73,118.0,119.0,118.9
434,哈尔滨文化公园,20230310,89,0,89,136.0,113.4,120.9
435,哈尔滨文化公园,20230311,95,0,95,89.0,115.8,117.1
436,哈尔滨文化公园,20230312,105,0,105,95.0,108.6,113.5
437,哈尔滨文化公园,20230313,82,0,82,105.0,101.4,107.5
438,哈尔滨文化公园,20230314,99,0,99,82.0,94.0,106.5
439,哈尔滨文化公园,20230315,79,0,79,99.0,92.0,102.7
440,哈尔滨文化公园,20230316,87,0,87,79.0,90.4,103.1
441,哈尔滨文化公园,20230317,95,0,95,87.0,88.4,98.5
442,哈尔滨文化公园,20230318,110,0,110,95.0,94.0,97.7
443,哈尔滨文化公园,20230319,106,0,106,110.0,95.4,94.7
444,哈尔滨文化公园,20230320,161,61,100,106.0,111.8,101.9
445,哈尔滨文化公园,20230321,92,0,92,161.0,112.8,101.6
446,哈尔滨文化公园,20230322,86,0,86,92.0,111.0,99.7
447,哈尔滨文化公园,20230323,152,63,89,86.0,119.4,106.7
448,哈尔滨文化公园,20230324,86,0,86,152.0,115.4,105.4
449,哈尔滨文化公园,20230325,108,0,108,86.0,104.8,108.3
450,哈尔滨文化公园,20230326,99,0,99,108.0,106.2,109.5
451,哈尔滨文化公园,20230327,165,59,106,99.0,122.0,116.5
452,哈尔滨文化公园,20230328,91,0,91,165.0,109.8,114.6
453,哈尔滨文化公园,20230329,139,59,80,91.0,120.4,117.9
454,哈尔滨文化公园,20230330,153,61,92,139.0,129.4,117.1
455,哈尔滨文化公园,20230331,169,61,108,153.0,143.4,124.8
456,哈尔滨文化公园,20230401,224,61,163,169.0,155.2,138.6
457,哈尔滨文化公园,20230402,190,59,131,224.0,175.0,142.4
458,哈尔滨文化公园,20230403,156,61,95,190.0,178.4,149.4
459,哈尔滨文化公园,20230404,109,0,109,156.0,169.6,149.5
460,哈尔滨文化公园,20230405,193,61,132,109.0,174.4,158.9
461,哈尔滨文化公园,20230406,153,61,92,193.0,160.2,157.7
462,哈尔滨文化公园,20230407,108,0,108,153.0,143.8,159.4
463,哈尔滨文化公园,20230408,171,61,110,108.0,146.8,162.6
464,哈尔滨文化公园,20230409,138,0,138,171.0,152.6,161.1
465,哈尔滨文化公园,20230410,145,59,86,138.0,143.0,158.7
466,哈尔滨文化公园,20230411,96,0,96,145.0,131.6,145.9
467,哈尔滨文化公园,20230412,157,64,93,96.0,141.4,142.6
468,哈尔滨文化公园,20230413,147,61,86,157.0,136.6,141.7
469,哈尔滨文化公园,20230414,110,0,110,147.0,131.0,141.8
470,哈尔滨文化公园,20230415,195,59,136,110.0,141.0,142.0
471,哈尔滨文化公园,20230416,136,0,136,195.0,149.0,140.3
472,哈尔滨文化公园,20230417,162,63,99,136.0,150.0,145.7
473,哈尔滨文化公园,20230418,100,0,100,162.0,140.6,138.6
474,哈尔滨文化公园,20230419,146,59,87,100.0,147.8,139.4
475,哈尔滨文化公园,20230420,165,70,95,146.0,141.8,141.4
476,哈尔滨文化公园,20230421,167,63,104,165.0,148.0,148.5
477,哈尔滨文化公园,20230422,105,0,105,167.0,136.6,143.3
478,哈尔滨文化公园,20230423,152,59,93,105.0,147.0,143.8
479,哈尔滨文化公园,20230424,108,0,108,152.0,139.4,143.6
480,哈尔滨文化公园,20230425,163,61,102,108.0,139.0,140.4
481,哈尔滨文化公园,20230426,180,61,119,163.0,141.6,144.8
482,哈尔滨文化公园,20230427,135,0,135,180.0,147.6,142.1
483,哈尔滨文化公园,20230428,222,59,163,135.0,161.6,154.3
484,哈尔滨文化公园,20230429,177,0,177,222.0,175.4,157.4
485,哈尔滨文化公园,20230430,259,59,200,177.0,194.6,166.8
486,哈尔滨文化公园,20230501,334,59,275,259.0,225.4,183.5
487,哈尔滨文化公园,20230502,209,0,209,334.0,240.2,193.9
488,哈尔滨文化公园,20230503,191,59,132,209.0,234.0,197.8
489,哈尔滨文化公园,20230504,179,61,118,191.0,234.4,204.9
490,哈尔滨文化公园,20230505,118,0,118,179.0,206.2,200.4
491,哈尔滨文化公园,20230506,110,0,110,118.0,161.4,193.4
492,哈尔滨文化公园,20230507,169,59,110,110.0,153.4,196.8
493,哈尔滨文化公园,20230508,93,0,93,169.0,133.8,183.9
494,哈尔滨文化公园,20230509,100,0,100,93.0,118.0,176.2
495,哈尔滨文化公园,20230510,95,0,95,100.0,113.4,159.8
496,哈尔滨文化公园,20230511,99,0,99,95.0,111.2,136.3
497,哈尔滨文化公园,20230512,170,61,109,99.0,111.4,132.4
498,哈尔滨文化公园,20230513,161,59,102,170.0,125.0,129.4
499,哈尔滨文化公园,20230514,115,0,115,161.0,128.0,123.0
500,哈尔滨文化公园,20230515,117,0,117,115.0,132.4,122.9
501,哈尔滨文化公园,20230516,128,0,128,117.0,138.2,124.7
502,哈尔滨文化公园,20230517,173,61,112,128.0,138.8,125.1
503,哈尔滨文化公园,20230518,180,59,121,173.0,142.6,133.8
504,哈尔滨文化公园,20230519,157,61,96,180.0,151.0,139.5
505,哈尔滨文化公园,20230520,178,59,119,157.0,163.2,147.8
506,哈尔滨文化公园,20230521,99,0,99,178.0,157.4,147.8
507,哈尔滨文化公园,20230522,100,0,100,99.0,142.8,140.8
508,哈尔滨文化公园,20230523,112,0,112,100.0,129.2,135.9
509,哈尔滨文化公园,20230524,108,0,108,112.0,119.4,135.2
510,哈尔滨文化公园,20230525,165,63,102,108.0,116.8,140.0
511,哈尔滨文化公园,20230526,180,59,121,165.0,133.0,145.2
512,哈尔滨文化公园,20230527,200,59,141,180.0,153.0,147.9
513,哈尔滨文化公园,20230528,134,0,134,200.0,157.4,143.3
514,哈尔滨文化公园,20230529,165,63,102,134.0,168.8,144.1
515,哈尔滨文化公园,20230530,121,0,121,165.0,160.0,138.4
516,哈尔滨文化公园,20230531,110,0,110,121.0,146.0,139.5
517,哈尔滨文化公园,20230601,144,0,144,110.0,134.8,143.9
518,哈尔滨文化公园,20230602,119,0,119,144.0,131.8,144.6
519,哈尔滨文化公园,20230603,108,0,108,119.0,120.4,144.6
520,哈尔滨文化公园,20230604,131,0,131,108.0,122.4,141.2
521,哈尔滨文化公园,20230605,178,59,119,131.0,136.0,141.0
522,哈尔滨文化公园,20230606,165,59,106,178.0,140.2,137.5
523,哈尔滨文化公园,20230607,165,66,99,165.0,149.4,140.6
524,哈尔滨文化公园,20230608,173,64,109,165.0,162.4,141.4
525,哈尔滨文化公园,20230609,83,0,83,173.0,152.8,137.6
526,哈尔滨文化公园,20230610,99,0,99,83.0,137.0,136.5
527,哈尔滨文化公园,20230611,105,0,105,99.0,125.0,132.6
528,哈尔滨文化公园,20230612,105,0,105,105.0,113.0,131.2
529,哈尔滨文化公园,20230613,165,59,106,105.0,111.4,136.9
530,哈尔滨文化公园,20230614,167,59,108,165.0,128.2,140.5
531,哈尔滨文化公园,20230615,151,59,92,167.0,138.6,137.8
532,哈尔滨文化公园,20230616,158,63,95,151.0,149.2,137.1
533,哈尔滨文化公园,20230617,165,59,106,158.0,161.2,137.1
534,哈尔滨文化公园,20230618,108,0,108,165.0,149.8,130.6
535,哈尔滨文化公园,20230619,100,0,100,108.0,136.4,132.3
536,哈尔滨文化公园,20230620,91,0,91,100.0,124.4,131.5
537,哈尔滨文化公园,20230621,160,63,97,91.0,124.8,137.0
538,哈尔滨文化公园,20230622,132,0,132,160.0,118.2,139.7
539,哈尔滨文化公园,20230623,208,59,149,132.0,138.2,144.0
540,哈尔滨文化公园,20230624,95,0,95,208.0,137.2,136.8
541,哈尔滨文化公园,20230625,147,63,84,95.0,148.4,136.4
542,哈尔滨文化公园,20230626,172,63,109,147.0,150.8,137.8
543,哈尔滨文化公园,20230627,102,0,102,172.0,144.8,131.5
544,哈尔滨文化公园,20230628,142,59,83,102.0,131.6,134.9
545,哈尔滨文化公园,20230629,99,0,99,142.0,132.4,134.8
546,哈尔滨文化公园,20230630,99,0,99,99.0,122.8,135.6
547,哈尔滨文化公园,20230701,119,0,119,99.0,112.2,131.5
548,哈尔滨文化公园,20230702,123,0,123,119.0,116.4,130.6
549,哈尔滨文化公园,20230703,100,0,100,123.0,108.0,119.8
550,哈尔滨文化公园,20230704,99,0,99,100.0,108.0,120.2
551,哈尔滨文化公园,20230705,104,0,104,99.0,109.0,115.9
552,哈尔滨文化公园,20230706,184,61,123,104.0,122.0,117.1
553,哈尔滨文化公园,20230707,106,0,106,184.0,118.6,117.5
554,哈尔滨文化公园,20230708,130,0,130,106.0,124.6,116.3
555,哈尔滨文化公园,20230709,172,59,113,130.0,139.2,123.6
556,哈尔滨文化公园,20230710,172,59,113,172.0,152.8,130.9
557,哈尔滨文化公园,20230711,121,0,121,172.0,140.2,131.1
558,哈尔滨文化公园,20230712,179,64,115,121.0,154.8,136.7
559,哈尔滨文化公园,20230713,182,59,123,179.0,165.2,144.9
560,哈尔滨文化公园,20230714,104,0,104,182.0,151.6,145.4
561,哈尔滨文化公园,20230715,148,59,89,104.0,146.8,149.8
562,哈尔滨文化公园,20230716,91,0,91,148.0,140.8,140.5
563,哈尔滨文化公园,20230717,187,64,123,91.0,142.4,148.6
564,哈尔滨文化公园,20230718,184,61,123,187.0,142.8,154.0
565,哈尔滨文化公园,20230719,206,61,145,184.0,163.2,157.4
566,哈尔滨文化公园,20230720,168,59,109,206.0,167.2,157.0
567,哈尔滨文化公园,20230721,144,0,144,168.0,177.8,159.3
568,哈尔滨文化公园,20230722,117,0,117,144.0,163.8,153.1
569,哈尔滨文化公园,20230723,168,63,105,117.0,160.6,151.7
570,哈尔滨文化公园,20230724,110,0,110,168.0,141.4,152.3
571,哈尔滨文化公园,20230725,121,0,121,110.0,132.0,149.6
572,哈尔滨文化公园,20230726,123,0,123,121.0,127.8,152.8
573,哈尔滨文化公园,20230727,186,61,125,123.0,141.6,152.7
574,哈尔滨文化公园,20230728,193,59,134,186.0,146.6,153.6
575,哈尔滨文化公园,20230729,119,0,119,193.0,148.4,144.9
576,哈尔滨文化公园,20230730,193,59,134,119.0,162.8,147.4
577,哈尔滨文化公园,20230731,152,0,152,193.0,168.6,148.2
578,哈尔滨文化公园,20230801,131,0,131,152.0,157.6,149.6
579,哈尔滨文化公园,20230802,148,64,84,131.0,148.6,147.6
580,哈尔滨文化公园,20230803,117,0,117,148.0,148.2,148.3
581,哈尔滨文化公园,20230804,130,0,130,117.0,135.6,149.2
582,哈尔滨文化公园,20230805,181,64,117,130.0,141.4,155.0
583,哈尔滨文化公园,20230806,149,0,149,181.0,145.0,151.3
584,哈尔滨文化公园,20230807,106,0,106,149.0,136.6,142.6
585,哈尔滨文化公园,20230808,206,59,147,106.0,154.4,151.3
586,哈尔滨文化公园,20230809,117,0,117,206.0,151.8,143.7
587,哈尔滨文化公园,20230810,182,59,123,117.0,152.0,146.7
588,哈尔滨文化公园,20230811,185,64,121,182.0,159.2,152.1
589,哈尔滨文化公园,20230812,110,0,110,185.0,160.0,148.3
590,哈尔滨文化公园,20230813,130,0,130,110.0,144.8,149.6
591,哈尔滨文化公园,20230814,135,0,135,130.0,148.4,150.1
592,哈尔滨文化公园,20230815,212,61,151,135.0,154.4,153.2
593,哈尔滨文化公园,20230816,119,0,119,212.0,141.2,150.2
594,哈尔滨文化公园,20230817,119,0,119,119.0,143.0,151.5
595,哈尔滨文化公园,20230818,130,0,130,119.0,143.0,143.9
596,哈尔滨文化公园,20230819,128,0,128,130.0,141.6,145.0
597,哈尔滨文化公园,20230820,143,0,143,128.0,127.8,141.1
598,哈尔滨文化公园,20230821,175,63,112,143.0,139.0,140.1
599,哈尔滨文化公园,20230822,164,59,105,175.0,148.0,145.5
600,哈尔滨文化公园,20230823,147,0,147,164.0,151.4,147.2
601,哈尔滨文化公园,20230824,128,0,128,147.0,151.4,146.5
602,哈尔滨文化公园,20230825,160,63,97,128.0,154.8,141.3
603,哈尔滨文化公园,20230826,119,0,119,160.0,143.6,141.3
604,哈尔滨文化公园,20230827,167,59,108,119.0,144.2,146.1
605,哈尔滨文化公园,20230828,153,61,92,167.0,145.4,148.4
606,哈尔滨文化公园,20230829,140,61,79,153.0,147.8,149.6
607,哈尔滨文化公园,20230830,93,0,93,140.0,134.4,144.6
608,哈尔滨文化公园,20230831,89,0,89,93.0,128.4,136.0
609,哈尔滨文化公园,20230901,105,0,105,89.0,116.0,130.1
610,哈尔滨文化公园,20230902,113,0,113,105.0,108.0,126.7
611,哈尔滨文化公园,20230903,115,0,115,113.0,103.0,125.4
612,哈尔滨文化公园,20230904,86,0,86,115.0,101.6,118.0
613,哈尔滨文化公园,20230905,84,0,84,86.0,100.6,114.5
614,哈尔滨文化公园,20230906,96,0,96,84.0,98.8,107.4
615,哈尔滨文化公园,20230907,95,0,95,96.0,95.2,101.6
616,哈尔滨文化公园,20230908,110,0,110,95.0,94.2,98.6
617,哈尔滨文化公园,20230909,115,0,115,110.0,100.0,100.8
618,哈尔滨文化公园,20230910,171,59,112,115.0,117.4,109.0
619,哈尔滨文化公园,20230911,118,0,118,171.0,121.8,110.3
620,哈尔滨文化公园,20230912,158,61,97,118.0,134.4,114.8
621,哈尔滨文化公园,20230913,100,0,100,158.0,132.4,113.3
622,哈尔滨文化公园,20230914,165,61,104,100.0,142.4,121.2
623,哈尔滨文化公园,20230915,159,59,100,165.0,140.0,128.7
624,哈尔滨文化公园,20230916,162,63,99,159.0,148.8,135.3
625,哈尔滨文化公园,20230917,112,0,112,162.0,139.6,137.0
626,哈尔滨文化公园,20230918,80,0,80,112.0,135.6,134.0
627,哈尔滨文化公园,20230919,110,0,110,80.0,124.6,133.5
628,哈尔滨文化公园,20230920,93,0,93,110.0,111.4,125.7
629,哈尔滨文化公园,20230921,87,0,87,93.0,96.4,122.6
630,哈尔滨文化公园,20230922,92,0,92,87.0,92.4,116.0
631,哈尔滨文化公园,20230923,87,0,87,92.0,93.8,114.7
632,哈尔滨文化公园,20230924,89,0,89,87.0,89.6,107.1
633,哈尔滨文化公园,20230925,86,0,86,89.0,88.2,99.8
634,哈尔滨文化公园,20230926,99,0,99,86.0,90.6,93.5
635,哈尔滨文化公园,20230927,80,0,80,99.0,88.2,90.3
636,哈尔滨文化公园,20230928,163,61,102,80.0,103.4,98.6
637,哈尔滨文化公园,20230929,109,0,109,163.0,107.4,98.5
638,哈尔滨文化公园,20230930,104,0,104,109.0,111.0,99.6
639,哈尔滨文化公园,20231001,148,0,148,104.0,120.8,105.7
640,哈尔滨文化公园,20231002,118,0,118,148.0,128.4,108.3
641,哈尔滨文化公园,20231003,169,59,110,118.0,129.6,116.5
642,哈尔滨文化公园,20231004,108,0,108,169.0,129.4,118.4
643,哈尔滨文化公园,20231005,109,0,109,108.0,130.4,120.7
644,哈尔滨文化公园,20231006,89,0,89,109.0,118.6,119.7
645,哈尔滨文化公园,20231007,129,59,70,89.0,120.8,124.6
646,哈尔滨文化公园,20231008,147,63,84,129.0,116.4,123.0
647,哈尔滨文化公园,20231009,146,59,87,147.0,124.0,126.7
648,哈尔滨文化公园,20231010,74,0,74,146.0,117.0,123.7
649,哈尔滨文化公园,20231011,132,59,73,74.0,125.6,122.1
650,哈尔滨文化公园,20231012,84,0,84,132.0,116.6,118.7
651,哈尔滨文化公园,20231013,80,0,80,84.0,103.2,109.8
652,哈尔滨文化公园,20231014,93,0,93,80.0,92.6,108.3
653,哈尔滨文化公园,20231015,143,59,84,93.0,106.4,111.7
654,哈尔滨文化公园,20231016,80,0,80,143.0,96.0,110.8
655,哈尔滨文化公园,20231017,137,59,78,80.0,106.6,111.6
656,哈尔滨文化公园,20231018,67,0,67,137.0,104.0,103.6
657,哈尔滨文化公园,20231019,79,0,79,67.0,101.2,96.9
658,哈尔滨文化公园,20231020,67,0,67,79.0,86.0,96.2
659,哈尔滨文化公园,20231021,69,0,69,67.0,83.8,89.9
660,哈尔滨文化公园,20231022,70,0,70,69.0,70.4,88.5
661,哈尔滨文化公园,20231023,69,0,69,70.0,70.8,87.4
662,哈尔滨文化公园,20231024,67,0,67,69.0,68.4,84.8
663,哈尔滨文化公园,20231025,71,0,71,67.0,69.2,77.6
664,哈尔滨文化公园,20231026,63,0,63,71.0,68.0,75.9
665,哈尔滨文化公园,20231027,126,59,67,63.0,79.2,74.8
666,哈尔滨文化公园,20231028,78,0,78,126.0,81.0,75.9
667,哈尔滨文化公园,20231029,74,0,74,78.0,82.4,75.4
668,哈尔滨文化公园,20231030,70,0,70,74.0,82.2,75.7
669,哈尔滨文化公园,20231031,127,61,66,70.0,95.0,81.5
670,哈尔滨文化公园,20231101,122,59,63,127.0,94.2,86.7
671,哈尔滨文化公园,20231102,0,0,0,122.0,78.6,79.8
672,哈尔滨文化公园,20231103,0,0,0,0.0,63.8,73.1
673,哈尔滨文化公园,20231104,65,0,65,0.0,62.8,72.5
674,哈尔滨文化公园,20231105,66,0,66,65.0,50.6,72.8
675,哈尔滨文化公园,20231106,0,0,0,66.0,26.2,60.2
676,哈尔滨文化公园,20231107,61,0,61,0.0,38.4,58.5
677,哈尔滨文化公园,20231108,61,0,61,61.0,50.6,57.2
678,哈尔滨文化公园,20231109,0,0,0,61.0,37.6,50.2
679,哈尔滨文化公园,20231110,63,0,63,0.0,37.0,43.8
680,哈尔滨文化公园,20231111,0,0,0,63.0,37.0,31.6
681,哈尔滨文化公园,20231112,66,0,66,0.0,38.0,38.2
682,哈尔滨文化公园,20231113,61,0,61,66.0,38.0,44.3
683,哈尔滨文化公园,20231114,130,63,67,61.0,64.0,50.8
684,哈尔滨文化公园,20231115,0,0,0,130.0,51.4,44.2
685,哈尔滨文化公园,20231116,61,61,0,0.0,63.6,50.3
686,哈尔滨文化公园,20231117,59,59,0,61.0,62.2,50.1
687,哈尔滨文化公园,20231118,0,0,0,59.0,50.0,44.0
688,哈尔滨文化公园,20231119,65,0,65,0.0,37.0,50.5
689,哈尔滨文化公园,20231120,0,0,0,65.0,37.0,44.2
690,哈尔滨文化公园,20231121,63,63,0,0.0,37.4,50.5
691,哈尔滨文化公园,20231122,122,59,63,63.0,50.0,56.1
692,哈尔滨文化公园,20231123,59,59,0,122.0,61.8,55.9
693,哈尔滨文化公园,20231124,125,59,66,59.0,73.8,55.4
694,哈尔滨文化公园,20231125,70,0,70,125.0,87.8,62.4
695,哈尔滨文化公园,20231126,122,59,63,70.0,99.6,68.5
696,哈尔滨文化公园,20231127,61,0,61,122.0,87.4,68.7
697,哈尔滨文化公园,20231128,0,0,0,61.0,75.6,68.7
698,哈尔滨文化公园,20231129,67,0,67,0.0,64.0,68.9
699,哈尔滨文化公园,20231130,69,0,69,67.0,63.8,75.8
700,哈尔滨文化公园,20231201,122,59,63,69.0,63.8,81.7
701,哈尔滨文化公园,20231202,66,0,66,122.0,64.8,76.1
702,哈尔滨文化公园,20231203,132,59,73,66.0,91.2,83.4
703,哈尔滨文化公园,20231204,0,0,0,132.0,77.8,70.9
704,哈尔滨文化公园,20231205,73,0,73,0.0,78.6,71.2
705,哈尔滨文化公园,20231206,124,59,65,73.0,79.0,71.4
706,哈尔滨文化公园,20231207,63,0,63,124.0,78.4,71.6
707,哈尔滨文化公园,20231208,63,0,63,63.0,64.6,77.9
708,哈尔滨文化公园,20231209,124,59,65,63.0,89.4,83.6
709,哈尔滨文化公园,20231210,0,0,0,124.0,74.8,76.7
710,哈尔滨文化公园,20231211,0,0,0,0.0,50.0,64.5
711,哈尔滨文化公园,20231212,59,59,0,0.0,49.2,63.8
712,哈尔滨文化公园,20231213,61,61,0,59.0,48.8,56.7
713,哈尔滨文化公园,20231214,0,0,0,61.0,24.0,56.7
714,哈尔滨文化公园,20231215,0,0,0,0.0,24.0,49.4
715,哈尔滨文化公园,20231216,63,0,63,0.0,36.6,43.3
716,哈尔滨文化公园,20231217,65,0,65,63.0,37.8,43.5
717,哈尔滨文化公园,20231218,134,61,73,65.0,52.4,50.6
718,哈尔滨文化公园,20231219,128,59,69,134.0,78.0,51.0
719,哈尔滨文化公园,20231220,122,61,61,128.0,102.4,63.2
720,哈尔滨文化公园,20231221,59,59,0,122.0,101.6,69.1
721,哈尔滨文化公园,20231222,122,59,63,59.0,113.0,75.4
722,哈尔滨文化公园,20231223,70,0,70,122.0,100.2,76.3
723,哈尔滨文化公园,20231224,66,0,66,70.0,87.8,82.9
724,哈尔滨文化公园,20231225,0,0,0,66.0,63.4,82.9
725,哈尔滨文化公园,20231226,130,59,71,0.0,77.6,89.6
726,哈尔滨文化公园,20231227,61,0,61,130.0,65.4,89.2
727,哈尔滨文化公园,20231228,130,59,71,61.0,77.4,88.8
728,哈尔滨文化公园,20231229,135,66,69,130.0,91.2,89.5
729,哈尔滨文化公园,20231230,66,0,66,135.0,104.4,83.9
730,哈尔滨文化公园,20231231,71,0,71,66.0,92.6,85.1
731,哈尔滨文化公园,20240101,66,0,66,71.0,93.6,79.5
732,哈尔滨文化公园,20240102,59,59,0,66.0,79.4,78.4
733,哈尔滨文化公园,20240103,67,0,67,59.0,65.8,78.5
734,哈尔滨文化公园,20240104,78,0,78,67.0,68.2,86.3
735,哈尔滨文化公园,20240105,78,0,78,78.0,69.6,81.1
736,哈尔滨文化公园,20240106,69,0,69,78.0,70.2,81.9
737,哈尔滨文化公园,20240107,125,59,66,69.0,83.4,81.4
738,哈尔滨文化公园,20240108,74,0,74,125.0,84.8,75.3
739,哈尔滨文化公园,20240109,67,0,67,74.0,82.6,75.4
740,哈尔滨文化公园,20240110,61,0,61,67.0,79.2,74.4
741,哈尔滨文化公园,20240111,135,66,69,61.0,92.4,81.3
742,哈尔滨文化公园,20240112,71,0,71,135.0,81.6,82.5
743,哈尔滨文化公园,20240113,135,61,74,71.0,93.8,89.3
744,哈尔滨文化公园,20240114,61,0,61,135.0,92.6,87.6
745,哈尔滨文化公园,20240115,0,0,0,61.0,80.4,79.8
746,哈尔滨文化公园,20240116,61,0,61,0.0,65.6,79.0
747,哈尔滨文化公园,20240117,73,0,73,61.0,66.0,73.8
748,哈尔滨文化公园,20240118,61,0,61,73.0,51.2,72.5
749,哈尔滨文化公园,20240119,76,0,76,61.0,54.2,73.4
750,哈尔滨文化公园,20240120,80,0,80,76.0,70.2,75.3
751,哈尔滨文化公园,20240121,66,0,66,80.0,71.2,68.4
752,哈尔滨文化公园,20240122,61,0,61,66.0,68.8,67.4
753,哈尔滨文化公园,20240123,73,0,73,61.0,71.2,61.2
754,哈尔滨文化公园,20240124,73,0,73,73.0,70.6,62.4
755,哈尔滨文化公园,20240125,127,61,66,73.0,80.0,75.1
756,哈尔滨文化公园,20240126,63,0,63,127.0,79.4,75.3
757,哈尔滨文化公园,20240127,67,0,67,63.0,80.6,74.7
758,哈尔滨文化公园,20240128,127,61,66,67.0,91.4,81.3
759,哈尔滨文化公园,20240129,131,61,70,127.0,103.0,86.8
760,哈尔滨文化公园,20240130,70,0,70,131.0,91.6,85.8
761,哈尔滨文化公园,20240131,63,0,63,70.0,91.6,85.5
762,哈尔滨文化公园,20240201,0,0,0,63.0,78.2,79.4
763,哈尔滨文化公园,20240202,71,0,71,0.0,67.0,79.2
764,哈尔滨文化公园,20240203,67,0,67,71.0,54.2,78.6
765,哈尔滨文化公园,20240204,76,0,76,67.0,55.4,73.5
766,哈尔滨文化公园,20240205,69,0,69,76.0,56.6,74.1
767,哈尔滨文化公园,20240206,66,0,66,69.0,69.8,74.0
768,哈尔滨文化公园,20240207,73,0,73,66.0,70.2,68.6
769,哈尔滨文化公园,20240208,61,0,61,73.0,69.0,61.6
770,哈尔滨文化公园,20240209,0,0,0,61.0,53.8,54.6
771,哈尔滨文化公园,20240210,66,0,66,0.0,53.2,54.9
772,哈尔滨文化公园,20240211,71,0,71,66.0,54.2,62.0
773,哈尔滨文化公园,20240212,69,0,69,71.0,53.4,61.8
774,哈尔滨文化公园,20240213,71,0,71,69.0,55.4,62.2
775,哈尔滨文化公园,20240214,80,0,80,71.0,71.4,62.6
776,哈尔滨文化公园,20240215,76,0,76,80.0,73.4,63.3
777,哈尔滨文化公园,20240216,73,0,73,76.0,73.8,64.0
778,哈尔滨文化公园,20240217,73,0,73,73.0,74.6,64.0
779,哈尔滨文化公园,20240218,65,0,65,73.0,73.4,64.4
780,哈尔滨文化公园,20240219,136,63,73,65.0,84.6,78.0
781,哈尔滨文化公园,20240220,66,0,66,136.0,82.6,78.0
782,哈尔滨文化公园,20240221,66,0,66,66.0,81.2,77.5
783,哈尔滨文化公园,20240222,125,59,66,66.0,91.6,83.1
784,哈尔滨文化公园,20240223,126,61,65,125.0,103.8,88.6
785,哈尔滨文化公园,20240224,78,0,78,126.0,92.2,88.4
786,哈尔滨文化公园,20240225,65,0,65,78.0,92.0,87.3
787,哈尔滨文化公园,20240226,125,59,66,65.0,103.8,92.5
788,哈尔滨文化公园,20240227,0,0,0,125.0,78.8,85.2
789,哈尔滨文化公园,20240228,65,0,65,0.0,66.6,85.2
790,哈尔滨文化公园,20240229,63,0,63,65.0,63.6,77.9
791,哈尔滨文化公园,20240301,134,63,71,63.0,77.4,84.7
792,哈尔滨文化公园,20240302,0,0,0,134.0,52.4,78.1
793,哈尔滨文化公园,20240303,61,0,61,0.0,64.6,71.7
794,哈尔滨文化公园,20240304,65,0,65,61.0,64.6,65.6
795,哈尔滨文化公园,20240305,65,0,65,65.0,65.0,64.3
796,哈尔滨文化公园,20240306,0,0,0,65.0,38.2,57.8
797,哈尔滨文化公园,20240307,63,0,63,0.0,50.8,51.6
798,哈尔滨文化公园,20240308,69,0,69,63.0,52.4,58.5
799,哈尔滨文化公园,20240309,126,59,67,69.0,64.6,64.6
800,哈尔滨文化公园,20240310,74,0,74,126.0,66.4,65.7
801,哈尔滨文化公园,20240311,79,0,79,74.0,82.2,60.2
802,哈尔滨文化公园,20240312,128,59,69,79.0,95.2,73.0
803,哈尔滨文化公园,20240313,76,0,76,128.0,96.6,74.5
804,哈尔滨文化公园,20240314,130,59,71,76.0,97.4,81.0
805,哈尔滨文化公园,20240315,74,0,74,130.0,97.4,81.9
806,哈尔滨文化公园,20240316,76,0,76,74.0,96.8,89.5
807,哈尔滨文化公园,20240317,79,0,79,76.0,87.0,91.1
808,哈尔滨文化公园,20240318,79,0,79,79.0,87.6,92.1
809,哈尔滨文化公园,20240319,59,59,0,79.0,73.4,85.4
810,哈尔滨文化公园,20240320,133,66,67,59.0,85.2,91.3
811,哈尔滨文化公园,20240321,83,0,83,133.0,86.6,91.7
812,哈尔滨文化公园,20240322,74,0,74,83.0,85.6,86.3
813,哈尔滨文化公园,20240323,133,59,74,74.0,96.4,92.0
814,哈尔滨文化公园,20240324,76,0,76,133.0,99.8,86.6
815,哈尔滨文化公园,20240325,140,74,66,76.0,101.2,93.2
816,哈尔滨文化公园,20240326,0,0,0,140.0,84.6,85.6
817,哈尔滨文化公园,20240327,73,0,73,0.0,84.4,85.0
818,哈尔滨文化公园,20240328,78,0,78,73.0,73.4,84.9
819,哈尔滨文化公园,20240329,65,0,65,78.0,71.2,85.5
820,哈尔滨文化公园,20240330,133,63,70,65.0,69.8,85.5
821,哈尔滨文化公园,20240331,136,63,73,133.0,97.0,90.8
822,哈尔滨文化公园,20240401,146,63,83,136.0,111.6,98.0
823,哈尔滨文化公园,20240402,130,61,69,146.0,122.0,97.7
824,哈尔滨文化公园,20240403,126,59,67,130.0,134.2,102.7
825,哈尔滨文化公园,20240404,109,0,109,126.0,129.4,99.6
826,哈尔滨文化公园,20240405,110,0,110,109.0,124.2,110.6
827,哈尔滨文化公园,20240406,89,0,89,110.0,112.8,112.2
828,哈尔滨文化公园,20240407,137,61,76,89.0,114.2,118.1
829,哈尔滨文化公园,20240408,120,59,61,137.0,113.0,123.6
830,哈尔滨文化公园,20240409,63,0,63,120.0,103.8,116.6
831,哈尔滨文化公园,20240410,67,0,67,63.0,95.2,109.7
832,哈尔滨文化公园,20240411,69,0,69,67.0,91.2,102.0
833,哈尔滨文化公园,20240412,80,0,80,69.0,79.8,97.0
834,哈尔滨文化公园,20240413,134,61,73,80.0,82.6,97.8
835,哈尔滨文化公园,20240414,137,57,80,134.0,97.4,100.6
836,哈尔滨文化公园,20240415,73,0,73,137.0,98.6,96.9
837,哈尔滨文化公园,20240416,128,59,69,73.0,110.4,100.8
838,哈尔滨文化公园,20240417,130,57,73,128.0,120.4,100.1
839,哈尔滨文化公园,20240418,133,57,76,130.0,120.2,101.4
840,哈尔滨文化公园,20240419,135,61,74,133.0,119.8,108.6
841,哈尔滨文化公园,20240420,139,57,82,135.0,133.0,115.8
842,哈尔滨文化公园,20240421,163,57,106,139.0,140.0,125.2
843,哈尔滨文化公园,20240422,133,59,74,163.0,140.6,130.5
844,哈尔滨文化公园,20240423,78,0,78,133.0,129.6,124.9
845,哈尔滨文化公园,20240424,126,59,67,78.0,127.8,123.8
846,哈尔滨文化公园,20240425,70,0,70,126.0,114.0,123.5
847,哈尔滨文化公园,20240426,144,61,83,70.0,110.2,125.1
848,哈尔滨文化公园,20240427,84,0,84,144.0,100.4,120.5
849,哈尔滨文化公园,20240428,145,59,86,84.0,113.8,121.7
850,哈尔滨文化公园,20240429,135,61,74,145.0,115.6,121.7
851,哈尔滨文化公园,20240430,182,57,125,135.0,138.0,126.0
1,哈尔滨极地馆,20220101,200,59,141,182.0,149.2,129.7
2,哈尔滨极地馆,20220102,115,0,115,200.0,155.4,127.9
3,哈尔滨极地馆,20220103,181,68,113,115.0,162.6,138.2
4,哈尔滨极地馆,20220104,155,59,96,181.0,166.6,141.1
5,哈尔滨极地馆,20220105,178,66,112,155.0,165.8,151.9
6,哈尔滨极地馆,20220106,167,59,108,178.0,159.2,154.2
7,哈尔滨极地馆,20220107,192,61,131,167.0,174.6,165.0
8,哈尔滨极地馆,20220108,125,0,125,192.0,163.4,163.0
9,哈尔滨极地馆,20220109,123,0,123,125.0,157.0,161.8
10,哈尔滨极地馆,20220110,178,70,108,123.0,157.0,161.4
11,哈尔滨极地馆,20220111,109,0,109,178.0,145.4,152.3
12,哈尔滨极地馆,20220112,171,66,105,109.0,141.2,157.9
13,哈尔滨极地馆,20220113,162,63,99,171.0,148.6,156.0
14,哈尔滨极地馆,20220114,177,64,113,162.0,159.4,158.2
15,哈尔滨极地馆,20220115,227,66,161,177.0,169.2,163.1
16,哈尔滨极地馆,20220116,130,0,130,227.0,173.4,159.4
17,哈尔滨极地馆,20220117,184,59,125,130.0,176.0,158.6
18,哈尔滨极地馆,20220118,177,64,113,184.0,179.0,163.8
19,哈尔滨极地馆,20220119,157,64,93,177.0,175.0,167.2
20,哈尔滨极地馆,20220120,164,59,105,157.0,162.4,165.8
21,哈尔滨极地馆,20220121,160,64,96,164.0,168.4,170.9
22,哈尔滨极地馆,20220122,180,61,119,160.0,167.6,171.8
23,哈尔滨极地馆,20220123,158,63,95,180.0,163.8,171.4
24,哈尔滨极地馆,20220124,173,61,112,158.0,167.0,171.0
25,哈尔滨极地馆,20220125,155,59,96,173.0,165.2,163.8
26,哈尔滨极地馆,20220126,152,61,91,155.0,163.6,166.0
27,哈尔滨极地馆,20220127,176,66,110,152.0,162.8,165.2
28,哈尔滨极地馆,20220128,165,63,102,176.0,164.2,164.0
29,哈尔滨极地馆,20220129,168,64,104,165.0,163.2,165.1
30,哈尔滨极地馆,20220130,138,59,79,168.0,159.8,162.5
31,哈尔滨极地馆,20220131,95,0,95,138.0,148.4,156.0
32,哈尔滨极地馆,20220201,151,0,151,95.0,143.4,153.1
33,哈尔滨极地馆,20220202,180,0,180,151.0,146.4,155.3
34,哈尔滨极地馆,20220203,202,0,202,180.0,153.2,158.2
35,哈尔滨极地馆,20220204,255,59,196,202.0,176.6,168.2
36,哈尔滨极地馆,20220205,247,66,181,255.0,207.0,177.7
37,哈尔滨极地馆,20220206,179,0,179,247.0,212.6,178.0
38,哈尔滨极地馆,20220207,221,66,155,179.0,220.8,183.6
39,哈尔滨极地馆,20220208,221,66,155,221.0,224.6,188.9
40,哈尔滨极地馆,20220209,218,63,155,221.0,217.2,196.9
41,哈尔滨极地馆,20220210,211,66,145,218.0,210.0,208.5
42,哈尔滨极地馆,20220211,223,64,159,211.0,218.8,215.7
43,哈尔滨极地馆,20220212,254,68,186,223.0,225.4,223.1
44,哈尔滨极地馆,20220213,240,59,181,254.0,229.2,226.9
45,哈尔滨极地馆,20220214,234,70,164,240.0,232.4,224.8
46,哈尔滨极地馆,20220215,209,61,148,234.0,232.0,221.0
47,哈尔滨极地馆,20220216,191,72,119,209.0,225.6,222.2
48,哈尔滨极地馆,20220217,208,64,144,191.0,216.4,220.9
49,哈尔滨极地馆,20220218,157,0,157,208.0,199.8,214.5
50,哈尔滨极地馆,20220219,247,61,186,157.0,202.4,217.4
51,哈尔滨极地馆,20220220,211,63,148,247.0,202.8,217.4
52,哈尔滨极地馆,20220221,194,63,131,211.0,203.4,214.5
53,哈尔滨极地馆,20220222,185,66,119,194.0,198.8,207.6
54,哈尔滨极地馆,20220223,173,61,112,185.0,202.0,200.9
55,哈尔滨极地馆,20220224,145,0,145,173.0,181.6,192.0
56,哈尔滨极地馆,20220225,198,64,134,145.0,179.0,190.9
57,哈尔滨极地馆,20220226,197,61,136,198.0,179.6,191.5
58,哈尔滨极地馆,20220227,204,61,143,197.0,183.4,191.1
59,哈尔滨极地馆,20220228,185,72,113,204.0,185.8,193.9
60,哈尔滨极地馆,20220301,169,64,105,185.0,190.6,186.1
61,哈尔滨极地馆,20220302,159,66,93,169.0,182.8,180.9
62,哈尔滨极地馆,20220303,170,70,100,159.0,177.4,178.5
63,哈尔滨极地馆,20220304,172,63,109,170.0,171.0,177.2
64,哈尔滨极地馆,20220305,181,59,122,172.0,170.2,178.0
65,哈尔滨极地馆,20220306,122,0,122,181.0,160.8,175.7
66,哈尔滨极地馆,20220307,173,63,110,122.0,163.6,173.2
67,哈尔滨极地馆,20220308,156,59,97,173.0,160.8,169.1
68,哈尔滨极地馆,20220309,158,63,95,156.0,158.0,164.5
69,哈尔滨极地馆,20220310,168,64,104,158.0,155.4,162.8
70,哈尔滨极地馆,20220311,191,70,121,168.0,169.2,165.0
71,哈尔滨极地馆,20220312,171,59,112,191.0,168.8,166.2
72,哈尔滨极地馆,20220313,95,0,95,171.0,156.6,158.7
73,哈尔滨极地馆,20220314,135,59,76,95.0,152.0,155.0
74,哈尔滨极地馆,20220315,147,61,86,135.0,147.8,151.6
75,哈尔滨极地馆,20220316,140,64,76,147.0,137.6,153.4
76,哈尔滨极地馆,20220317,154,63,91,140.0,134.2,151.5
77,哈尔滨极地馆,20220318,143,64,79,154.0,143.8,150.2
78,哈尔滨极地馆,20220319,78,0,78,143.0,132.4,142.2
79,哈尔滨极地馆,20220320,167,63,104,78.0,136.4,142.1
80,哈尔滨极地馆,20220321,139,63,76,167.0,136.2,136.9
81,哈尔滨极地馆,20220322,151,72,79,139.0,135.6,134.9
82,哈尔滨极地馆,20220323,139,61,78,151.0,134.8,139.3
83,哈尔滨极地馆,20220324,145,63,82,139.0,148.2,140.3
84,哈尔滨极地馆,20220325,146,68,78,145.0,144.0,140.2
85,哈尔滨极地馆,20220326,134,61,73,146.0,143.0,139.6
86,哈尔滨极地馆,20220327,74,0,74,134.0,127.6,131.6
87,哈尔滨极地馆,20220328,141,61,80,74.0,128.0,131.4
88,哈尔滨极地馆,20220329,126,63,63,141.0,124.2,136.2
89,哈尔滨极地馆,20220330,139,63,76,126.0,122.8,133.4
90,哈尔滨极地馆,20220331,146,66,80,139.0,125.2,134.1
91,哈尔滨极地馆,20220401,79,0,79,146.0,126.2,126.9
92,哈尔滨极地馆,20220402,135,59,76,79.0,125.0,126.5
93,哈尔滨极地馆,20220403,69,0,69,135.0,113.6,118.9
94,哈尔滨极地馆,20220404,86,0,86,69.0,103.0,112.9
95,哈尔滨极地馆,20220405,91,0,91,86.0,92.0,108.6
96,哈尔滨极地馆,20220406,126,63,63,91.0,101.4,113.8
97,哈尔滨极地馆,20220407,152,66,86,126.0,104.8,114.9
98,哈尔滨极地馆,20220408,138,59,79,152.0,118.6,116.1
99,哈尔滨极地馆,20220409,82,0,82,138.0,117.8,110.4
100,哈尔滨极地馆,20220410,163,63,100,82.0,132.2,112.1
101,哈尔滨极地馆,20220411,161,66,95,163.0,139.2,120.3
102,哈尔滨极地馆,20220412,176,72,104,161.0,144.0,124.4
103,哈尔滨极地馆,20220413,146,64,82,176.0,145.6,132.1
104,哈尔滨极地馆,20220414,155,59,96,146.0,160.2,139.0
105,哈尔滨极地馆,20220415,141,61,80,155.0,155.8,144.0
106,哈尔滨极地馆,20220416,130,59,71,141.0,149.6,144.4
107,哈尔滨极地馆,20220417,152,59,93,130.0,144.8,144.4
108,哈尔滨极地馆,20220418,129,59,70,152.0,141.4,143.5
109,哈尔滨极地馆,20220419,74,0,74,129.0,125.2,142.7
110,哈尔滨极地馆,20220420,87,0,87,74.0,114.4,135.1
111,哈尔滨极地馆,20220421,148,59,89,87.0,118.0,133.8
112,哈尔滨极地馆,20220422,164,72,92,148.0,120.4,132.6
113,哈尔滨极地馆,20220423,152,59,93,164.0,125.0,133.2
114,哈尔滨极地馆,20220424,96,0,96,152.0,129.4,127.3
115,哈尔滨极地馆,20220425,146,63,83,96.0,141.2,127.8
116,哈尔滨极地馆,20220426,142,64,78,146.0,140.0,129.0
117,哈尔滨极地馆,20220427,156,59,97,142.0,138.4,129.4
118,哈尔滨极地馆,20220428,146,59,87,156.0,137.2,131.1
119,哈尔滨极地馆,20220429,146,59,87,146.0,147.2,138.3
120,哈尔滨极地馆,20220430,100,0,100,146.0,138.0,139.6
121,哈尔滨极地馆,20220501,150,61,89,100.0,139.6,139.8
122,哈尔滨极地馆,20220502,153,64,89,150.0,139.0,138.7
123,哈尔滨极地馆,20220503,141,59,82,153.0,138.0,137.6
124,哈尔滨极地馆,20220504,158,63,95,141.0,140.4,143.8
125,哈尔滨极地馆,20220505,161,68,93,158.0,152.6,145.3
126,哈尔滨极地馆,20220506,167,68,99,161.0,156.0,147.8
127,哈尔滨极地馆,20220507,171,66,105,167.0,159.6,149.3
128,哈尔滨极地馆,20220508,118,0,118,171.0,155.0,146.5
129,哈尔滨极地馆,20220509,168,68,100,118.0,157.0,148.7
130,哈尔滨极地馆,20220510,80,0,80,168.0,140.8,146.7
131,哈尔滨极地馆,20220511,152,63,89,80.0,137.8,146.9
132,哈尔滨极地馆,20220512,163,68,95,152.0,136.2,147.9
133,哈尔滨极地馆,20220513,160,63,97,163.0,144.6,149.8
134,哈尔滨极地馆,20220514,174,64,110,160.0,145.8,151.4
135,哈尔滨极地馆,20220515,168,59,109,174.0,163.4,152.1
136,哈尔滨极地馆,20220516,159,66,93,168.0,164.8,151.3
137,哈尔滨极地馆,20220517,148,61,87,159.0,161.8,149.0
138,哈尔滨极地馆,20220518,180,72,108,148.0,165.8,155.2
139,哈尔滨极地馆,20220519,181,66,115,180.0,167.2,156.5
140,哈尔滨极地馆,20220520,181,72,109,181.0,169.8,166.6
141,哈尔滨极地馆,20220521,193,59,134,181.0,176.6,170.7
142,哈尔滨极地馆,20220522,245,59,186,193.0,196.0,178.9
143,哈尔滨极地馆,20220523,202,61,141,245.0,200.4,183.1
144,哈尔滨极地馆,20220524,199,61,138,202.0,204.0,185.6
145,哈尔滨极地馆,20220525,222,74,148,199.0,212.2,191.0
146,哈尔滨极地馆,20220526,201,70,131,222.0,213.8,195.2
147,哈尔滨极地馆,20220527,214,63,151,201.0,207.6,201.8
148,哈尔滨极地馆,20220528,210,63,147,214.0,209.2,204.8
149,哈尔滨极地馆,20220529,216,59,157,210.0,212.6,208.3
150,哈尔滨极地馆,20220530,208,61,147,216.0,209.8,211.0
151,哈尔滨极地馆,20220531,231,61,170,208.0,215.8,214.8
152,哈尔滨极地馆,20220601,284,85,199,231.0,229.8,218.7
153,哈尔滨极地馆,20220602,289,74,215,284.0,245.6,227.4
154,哈尔滨极地馆,20220603,220,0,220,289.0,246.4,229.5
155,哈尔滨极地馆,20220604,269,80,189,220.0,258.6,234.2
156,哈尔滨极地馆,20220605,227,61,166,269.0,257.8,236.8
157,哈尔滨极地馆,20220606,211,72,139,227.0,243.2,236.5
158,哈尔滨极地馆,20220607,202,63,139,211.0,225.8,235.7
159,哈尔滨极地馆,20220608,205,64,141,202.0,222.8,234.6
160,哈尔滨极地馆,20220609,222,63,159,205.0,213.4,236.0
161,哈尔滨极地馆,20220610,243,64,179,222.0,216.6,237.2
162,哈尔滨极地馆,20220611,250,72,178,243.0,224.4,233.8
163,哈尔滨极地馆,20220612,178,0,178,250.0,219.6,222.7
164,哈尔滨极地馆,20220613,210,59,151,178.0,220.6,221.7
165,哈尔滨极地馆,20220614,221,66,155,210.0,220.4,216.9
166,哈尔滨极地馆,20220615,191,63,128,221.0,210.0,213.3
167,哈尔滨极地馆,20220616,221,76,145,191.0,204.2,214.3
168,哈尔滨极地馆,20220617,254,70,184,221.0,219.4,219.5
169,哈尔滨极地馆,20220618,248,63,185,254.0,227.0,223.8
170,哈尔滨极地馆,20220619,231,64,167,248.0,229.0,224.7
171,哈尔滨极地馆,20220620,198,63,135,231.0,230.4,220.2
172,哈尔滨极地馆,20220621,223,64,159,198.0,230.8,217.5
173,哈尔滨极地馆,20220622,216,61,155,223.0,223.2,221.3
174,哈尔滨极地馆,20220623,247,70,177,216.0,223.0,225.0
175,哈尔滨极地馆,20220624,255,76,179,247.0,227.8,228.4
176,哈尔滨极地馆,20220625,247,63,184,255.0,237.6,234.0
177,哈尔滨极地馆,20220626,256,64,192,247.0,244.2,237.5
178,哈尔滨极地馆,20220627,260,74,186,256.0,253.0,238.1
179,哈尔滨极地馆,20220628,279,70,209,260.0,259.4,241.2
180,哈尔滨极地馆,20220629,270,68,202,279.0,262.4,245.1
181,哈尔滨极地馆,20220630,294,70,224,270.0,271.8,254.7
182,哈尔滨极地馆,20220701,309,74,235,294.0,282.4,263.3
183,哈尔滨极地馆,20220702,320,63,257,309.0,294.4,273.7
184,哈尔滨极地馆,20220703,287,63,224,320.0,296.0,277.7
185,哈尔滨极地馆,20220704,279,68,211,287.0,297.8,280.1
186,哈尔滨极地馆,20220705,298,74,224,279.0,298.6,285.2
187,哈尔滨极地馆,20220706,333,72,261,298.0,303.4,292.9
188,哈尔滨极地馆,20220707,331,72,259,333.0,305.6,300.0
189,哈尔滨极地馆,20220708,332,80,252,331.0,314.6,305.3
190,哈尔滨极地馆,20220709,378,66,312,332.0,334.4,316.1
191,哈尔滨极地馆,20220710,385,61,324,378.0,351.8,325.2
192,哈尔滨极地馆,20220711,342,64,278,385.0,353.6,328.5
193,哈尔滨极地馆,20220712,379,85,294,342.0,363.2,334.4
194,哈尔滨极地馆,20220713,402,93,309,379.0,377.2,345.9
195,哈尔滨极地馆,20220714,433,82,351,402.0,388.2,361.3
196,哈尔滨极地馆,20220715,364,72,292,433.0,384.0,367.9
197,哈尔滨极地馆,20220716,350,76,274,364.0,385.6,369.6
198,哈尔滨极地馆,20220717,366,59,307,350.0,383.0,373.1
199,哈尔滨极地馆,20220718,342,72,270,366.0,371.0,374.1
200,哈尔滨极地馆,20220719,327,80,247,342.0,349.8,369.0
201,哈尔滨极地馆,20220720,380,91,289,327.0,353.0,368.5
202,哈尔滨极地馆,20220721,376,78,298,380.0,358.2,371.9
203,哈尔滨极地馆,20220722,428,83,345,376.0,370.6,376.8
204,哈尔滨极地馆,20220723,409,78,331,428.0,384.0,377.5
205,哈尔滨极地馆,20220724,366,59,307,409.0,391.8,370.8
206,哈尔滨极地馆,20220725,396,87,309,366.0,395.0,374.0
207,哈尔滨极地馆,20220726,429,87,342,396.0,405.6,381.9
208,哈尔滨极地馆,20220727,447,78,369,429.0,409.4,390.0
209,哈尔滨极地馆,20220728,441,83,358,447.0,415.8,399.9
210,哈尔滨极地馆,20220729,477,93,384,441.0,438.0,414.9
211,哈尔滨极地馆,20220730,459,68,391,477.0,450.6,422.8
212,哈尔滨极地馆,20220731,474,66,408,459.0,459.6,432.6
213,哈尔滨极地馆,20220801,472,70,402,474.0,464.6,437.0
214,哈尔滨极地馆,20220802,548,82,466,472.0,486.0,450.9
215,哈尔滨极地馆,20220803,507,87,420,548.0,492.0,465.0
216,哈尔滨极地馆,20220804,519,82,437,507.0,504.0,477.3
217,哈尔滨极地馆,20220805,519,99,420,519.0,513.0,486.3
218,哈尔滨极地馆,20220806,546,78,468,519.0,527.8,496.2
219,哈尔滨极地馆,20220807,510,64,446,546.0,520.2,503.1
220,哈尔滨极地馆,20220808,476,78,398,510.0,514.0,503.0
221,哈尔滨极地馆,20220809,292,64,228,476.0,468.6,486.3
222,哈尔滨极地馆,20220810,275,80,195,292.0,419.8,466.4
223,哈尔滨极地馆,20220811,272,64,208,275.0,365.0,446.4
224,哈尔滨极地馆,20220812,331,76,255,272.0,329.2,424.7
225,哈尔滨极地馆,20220813,285,63,222,331.0,291.0,402.5
226,哈尔滨极地馆,20220814,246,0,246,285.0,281.8,375.2
227,哈尔滨极地馆,20220815,307,66,241,246.0,288.2,354.0
228,哈尔滨极地馆,20220816,312,70,242,307.0,296.2,330.6
229,哈尔滨极地馆,20220817,320,74,246,312.0,294.0,311.6
230,哈尔滨极地馆,20220818,283,72,211,320.0,293.6,292.3
231,哈尔滨极地馆,20220819,291,80,211,283.0,302.6,292.2
232,哈尔滨极地馆,20220820,275,76,199,291.0,296.2,292.2
233,哈尔滨极地馆,20220821,208,59,149,275.0,275.4,285.8
234,哈尔滨极地馆,20220822,232,70,162,208.0,257.8,275.9
235,哈尔滨极地馆,20220823,208,64,144,232.0,242.8,268.2
236,哈尔滨极地馆,20220824,212,61,151,208.0,227.0,264.8
237,哈尔滨极地馆,20220825,208,63,145,212.0,213.6,254.9
238,哈尔滨极地馆,20220826,242,72,170,208.0,220.4,247.9
239,哈尔滨极地馆,20220827,240,74,166,242.0,222.0,239.9
240,哈尔滨极地馆,20220828,130,0,130,240.0,206.4,224.6
241,哈尔滨极地馆,20220829,158,59,99,130.0,195.6,211.3
242,哈尔滨极地馆,20220830,156,63,93,158.0,185.2,199.4
243,哈尔滨极地馆,20220831,165,63,102,156.0,169.8,195.1
244,哈尔滨极地馆,20220901,76,0,76,165.0,137.0,179.5
245,哈尔滨极地馆,20220902,155,64,91,76.0,142.0,174.2
246,哈尔滨极地馆,20220903,142,59,83,155.0,138.8,167.2
247,哈尔滨极地馆,20220904,163,63,100,142.0,140.2,162.7
248,哈尔滨极地馆,20220905,138,64,74,163.0,134.8,152.3
249,哈尔滨极地馆,20220906,146,63,83,138.0,148.8,142.9
250,哈尔滨极地馆,20220907,160,61,99,146.0,149.8,145.9
251,哈尔滨极地馆,20220908,158,63,95,160.0,153.0,145.9
252,哈尔滨极地馆,20220909,159,63,96,158.0,152.2,146.2
253,哈尔滨极地馆,20220910,117,0,117,159.0,148.0,141.4
254,哈尔滨极地馆,20220911,221,66,155,117.0,163.0,155.9
255,哈尔滨极地馆,20220912,204,61,143,221.0,171.8,160.8
256,哈尔滨极地馆,20220913,184,72,112,204.0,177.0,165.0
257,哈尔滨极地馆,20220914,187,66,121,184.0,182.6,167.4
258,哈尔滨极地馆,20220915,182,59,123,187.0,195.6,171.8
259,哈尔滨极地馆,20220916,215,68,147,182.0,194.4,178.7
260,哈尔滨极地馆,20220917,220,61,159,215.0,197.6,184.7
261,哈尔滨极地馆,20220918,123,0,123,220.0,185.4,181.2
262,哈尔滨极地馆,20220919,154,63,91,123.0,178.8,180.7
263,哈尔滨极地馆,20220920,177,64,113,154.0,177.8,186.7
264,哈尔滨极地馆,20220921,156,63,93,177.0,166.0,180.2
265,哈尔滨极地馆,20220922,169,64,105,156.0,155.8,176.7
266,哈尔滨极地馆,20220923,156,64,92,169.0,162.4,173.9
267,哈尔滨极地馆,20220924,102,0,102,156.0,152.0,165.4
268,哈尔滨极地馆,20220925,166,64,102,102.0,149.8,163.8
269,哈尔滨极地馆,20220926,145,61,84,166.0,147.6,156.8
270,哈尔滨极地馆,20220927,150,61,89,145.0,143.8,149.8
271,哈尔滨极地馆,20220928,165,70,95,150.0,145.6,154.0
272,哈尔滨极地馆,20220929,179,66,113,165.0,161.0,156.5
273,哈尔滨极地馆,20220930,184,66,118,179.0,164.6,157.2
274,哈尔滨极地馆,20221001,119,0,119,184.0,159.4,153.5
275,哈尔滨极地馆,20221002,202,63,139,119.0,169.8,156.8
276,哈尔滨极地馆,20221003,174,59,115,202.0,171.6,158.6
277,哈尔滨极地馆,20221004,169,63,106,174.0,169.6,165.3
278,哈尔滨极地馆,20221005,168,63,105,169.0,166.4,165.5
279,哈尔滨极地馆,20221006,168,63,105,168.0,176.2,167.8
280,哈尔滨极地馆,20221007,142,59,83,168.0,164.2,167.0
281,哈尔滨极地馆,20221008,169,64,105,142.0,163.2,167.4
282,哈尔滨极地馆,20221009,146,70,76,169.0,158.6,164.1
283,哈尔滨极地馆,20221010,148,61,87,146.0,154.6,160.5
284,哈尔滨极地馆,20221011,169,72,97,148.0,154.8,165.5
285,哈尔滨极地馆,20221012,170,74,96,169.0,160.4,162.3
286,哈尔滨极地馆,20221013,161,70,91,170.0,158.8,161.0
287,哈尔滨极地馆,20221014,173,63,110,161.0,164.2,161.4
288,哈尔滨极地馆,20221015,100,0,100,173.0,154.6,154.6
289,哈尔滨极地馆,20221016,117,0,117,100.0,144.2,149.5
290,哈尔滨极地馆,20221017,191,72,119,117.0,148.4,154.4
291,哈尔滨极地馆,20221018,151,59,92,191.0,146.4,152.6
292,哈尔滨极地馆,20221019,155,64,91,151.0,142.8,153.5
293,哈尔滨极地馆,20221020,178,68,110,155.0,158.4,156.5
294,哈尔滨极地馆,20221021,157,61,96,178.0,166.4,155.3
295,哈尔滨极地馆,20221022,108,0,108,157.0,149.8,149.1
296,哈尔滨极地馆,20221023,168,66,102,108.0,153.2,149.8
297,哈尔滨极地馆,20221024,157,68,89,168.0,153.6,148.2
298,哈尔滨极地馆,20221025,158,63,95,157.0,149.6,154.0
299,哈尔滨极地馆,20221026,183,74,109,158.0,154.8,160.6
300,哈尔滨极地馆,20221027,178,68,110,183.0,168.8,159.3
301,哈尔滨极地馆,20221028,160,64,96,178.0,167.2,160.2
302,哈尔滨极地馆,20221029,159,59,100,160.0,167.6,160.6
303,哈尔滨极地馆,20221030,89,0,89,159.0,153.8,151.7
304,哈尔滨极地馆,20221031,92,0,92,89.0,135.6,145.2
305,哈尔滨极地馆,20221101,180,61,119,92.0,136.0,152.4
306,哈尔滨极地馆,20221102,146,59,87,180.0,133.2,150.2
307,哈尔滨极地馆,20221103,141,59,82,146.0,129.6,148.6
308,哈尔滨极地馆,20221104,158,63,95,141.0,143.4,148.6
309,哈尔滨极地馆,20221105,82,0,82,158.0,141.4,138.5
310,哈尔滨极地馆,20221106,142,59,83,82.0,133.8,134.9
311,哈尔滨极地馆,20221107,149,66,83,142.0,134.4,133.8
312,哈尔滨极地馆,20221108,133,59,74,149.0,132.8,131.2
313,哈尔滨极地馆,20221109,143,64,79,133.0,129.8,136.6
314,哈尔滨极地馆,20221110,146,68,78,143.0,142.6,142.0
315,哈尔滨极地馆,20221111,87,0,87,146.0,131.6,132.7
316,哈尔滨极地馆,20221112,160,64,96,87.0,133.8,134.1
317,哈尔滨极地馆,20221113,96,0,96,160.0,126.4,129.6
318,哈尔滨极地馆,20221114,128,59,69,96.0,123.4,126.6
319,哈尔滨极地馆,20221115,143,61,82,128.0,122.8,132.7
320,哈尔滨极地馆,20221116,153,61,92,143.0,136.0,133.8
321,哈尔滨极地馆,20221117,155,63,92,153.0,135.0,134.4
322,哈尔滨极地馆,20221118,161,61,100,155.0,148.0,137.2
323,哈尔滨极地馆,20221119,182,78,104,161.0,158.8,141.1
324,哈尔滨极地馆,20221120,146,66,80,182.0,159.4,141.1
325,哈尔滨极地馆,20221121,158,63,95,146.0,160.4,148.2
326,哈尔滨极地馆,20221122,145,63,82,158.0,158.4,146.7
327,哈尔滨极地馆,20221123,143,61,82,145.0,154.8,151.4
328,哈尔滨极地馆,20221124,181,76,105,143.0,154.6,156.7
329,哈尔滨极地馆,20221125,138,68,70,181.0,153.0,156.2
330,哈尔滨极地馆,20221126,132,61,71,138.0,147.8,154.1
331,哈尔滨极地馆,20221127,80,0,80,132.0,134.8,146.6
332,哈尔滨极地馆,20221128,137,63,74,80.0,133.6,144.2
333,哈尔滨极地馆,20221129,139,59,80,137.0,125.2,139.9
334,哈尔滨极地馆,20221130,142,66,76,139.0,126.0,139.5
335,哈尔滨极地馆,20221201,84,0,84,142.0,116.4,132.1
336,哈尔滨极地馆,20221202,84,0,84,84.0,117.2,126.0
337,哈尔滨极地馆,20221203,82,0,82,84.0,106.2,119.9
338,哈尔滨极地馆,20221204,147,64,83,82.0,107.8,116.5
339,哈尔滨极地馆,20221205,143,63,80,147.0,108.0,117.0
340,哈尔滨极地馆,20221206,163,64,99,143.0,123.8,120.1
341,哈尔滨极地馆,20221207,95,0,95,163.0,126.0,121.6
342,哈尔滨极地馆,20221208,166,74,92,95.0,142.8,124.5
343,哈尔滨极地馆,20221209,161,61,100,166.0,145.6,126.7
344,哈尔滨极地馆,20221210,154,63,91,161.0,147.8,127.9
345,哈尔滨极地馆,20221211,152,66,86,154.0,145.6,134.7
346,哈尔滨极地馆,20221212,177,68,109,152.0,162.0,144.0
347,哈尔滨极地馆,20221213,92,0,92,177.0,147.2,145.0
348,哈尔滨极地馆,20221214,165,68,97,92.0,148.0,146.8
349,哈尔滨极地馆,20221215,143,59,84,165.0,145.8,146.8
350,哈尔滨极地馆,20221216,171,59,112,143.0,149.6,147.6
351,哈尔滨极地馆,20221217,175,66,109,171.0,149.2,155.6
352,哈尔滨极地馆,20221218,91,0,91,175.0,149.0,148.1
353,哈尔滨极地馆,20221219,146,59,87,91.0,145.2,146.6
354,哈尔滨极地馆,20221220,150,68,82,146.0,146.6,146.2
355,哈尔滨极地馆,20221221,157,64,93,150.0,143.8,146.7
356,哈尔滨极地馆,20221222,141,61,80,157.0,137.0,143.1
357,哈尔滨极地馆,20221223,159,63,96,141.0,150.6,149.8
358,哈尔滨极地馆,20221224,160,61,99,159.0,153.4,149.3
359,哈尔滨极地馆,20221225,161,61,100,160.0,155.6,151.1
360,哈尔滨极地馆,20221226,163,66,97,161.0,156.8,150.3
361,哈尔滨极地馆,20221227,148,66,82,163.0,158.2,147.6
362,哈尔滨极地馆,20221228,166,64,102,148.0,159.6,155.1
363,哈尔滨极地馆,20221229,176,66,110,166.0,162.8,158.1
364,哈尔滨极地馆,20221230,175,66,109,176.0,165.6,160.6
365,哈尔滨极地馆,20221231,199,61,138,175.0,172.8,164.8
366,哈尔滨极地馆,20230101,199,63,136,199.0,183.0,170.6
367,哈尔滨极地馆,20230102,218,63,155,199.0,193.4,176.5
368,哈尔滨极地馆,20230103,218,63,155,218.0,201.8,182.3
369,哈尔滨极地馆,20230104,210,78,132,218.0,208.8,187.2
370,哈尔滨极地馆,20230105,233,66,167,210.0,215.6,194.2
371,哈尔滨极地馆,20230106,356,101,255,233.0,247.0,215.0
372,哈尔滨极地馆,20230107,300,76,224,356.0,263.4,228.4
373,哈尔滨极地馆,20230108,301,70,231,300.0,280.0,240.9
374,哈尔滨极地馆,20230109,287,89,198,301.0,295.4,252.1
375,哈尔滨极地馆,20230110,305,76,229,287.0,309.8,262.7
376,哈尔滨极地馆,20230111,311,68,243,305.0,300.8,273.9
377,哈尔滨极地馆,20230112,335,99,236,311.0,307.8,285.6
378,哈尔滨极地馆,20230113,294,70,224,335.0,306.4,293.2
379,哈尔滨极地馆,20230114,325,66,259,294.0,314.0,304.7
380,哈尔滨极地馆,20230115,319,59,260,325.0,316.8,313.3
381,哈尔滨极地馆,20230116,349,87,262,319.0,324.4,312.6
382,哈尔滨极地馆,20230117,321,82,239,349.0,321.6,314.7
383,哈尔滨极地馆,20230118,295,80,215,321.0,321.8,314.1
384,哈尔滨极地馆,20230119,278,76,202,295.0,312.4,313.2
385,哈尔滨极地馆,20230120,260,64,196,278.0,300.6,308.7
386,哈尔滨极地馆,20230121,236,66,170,260.0,278.0,301.2
387,哈尔滨极地馆,20230122,395,64,331,236.0,292.8,307.2
388,哈尔滨极地馆,20230123,402,64,338,395.0,314.2,318.0
389,哈尔滨极地馆,20230124,438,61,377,402.0,346.2,329.3
390,哈尔滨极地馆,20230125,397,70,327,438.0,373.6,337.1
391,哈尔滨极地馆,20230126,451,63,388,397.0,416.6,347.3
392,哈尔滨极地馆,20230127,366,70,296,451.0,410.8,351.8
393,哈尔滨极地馆,20230128,416,70,346,366.0,413.6,363.9
394,哈尔滨极地馆,20230129,371,91,280,416.0,400.2,373.2
395,哈尔滨极地馆,20230130,342,74,268,371.0,389.2,381.4
396,哈尔滨极地馆,20230131,325,80,245,342.0,364.0,390.3
397,哈尔滨极地馆,20230201,360,87,273,325.0,362.8,386.8
398,哈尔滨极地馆,20230202,321,72,249,360.0,343.8,378.7
399,哈尔滨极地馆,20230203,372,76,296,321.0,344.0,372.1
400,哈尔滨极地馆,20230204,340,74,266,372.0,343.6,366.4
401,哈尔滨极地馆,20230205,260,59,201,340.0,330.6,347.3
402,哈尔滨极地馆,20230206,324,85,239,260.0,323.4,343.1
403,哈尔滨极地馆,20230207,317,83,234,324.0,322.6,333.2
404,哈尔滨极地馆,20230208,288,70,218,317.0,305.8,324.9
405,哈尔滨极地馆,20230209,365,80,285,288.0,310.8,327.2
406,哈尔滨极地馆,20230210,365,66,299,365.0,331.8,331.2
407,哈尔滨极地馆,20230211,319,70,249,365.0,330.8,327.1
408,哈尔滨极地馆,20230212,329,59,270,319.0,333.2,327.9
409,哈尔滨极地馆,20230213,309,70,239,329.0,337.4,321.6
410,哈尔滨极地馆,20230214,264,63,201,309.0,317.2,314.0
411,哈尔滨极地馆,20230215,282,63,219,264.0,300.6,316.2
412,哈尔滨极地馆,20230216,310,72,238,282.0,298.8,314.8
413,哈尔滨极地馆,20230217,335,85,250,310.0,300.0,316.6
414,哈尔滨极地馆,20230218,274,66,208,335.0,293.0,315.2
415,哈尔滨极地馆,20230219,201,0,201,274.0,280.4,298.8
416,哈尔滨极地馆,20230220,263,78,185,201.0,276.6,288.6
417,哈尔滨极地馆,20230221,230,66,164,263.0,260.6,279.7
418,哈尔滨极地馆,20230222,228,66,162,230.0,239.2,269.6
419,哈尔滨极地馆,20230223,237,70,167,228.0,231.8,262.4
420,哈尔滨极地馆,20230224,252,66,186,237.0,242.0,261.2
421,哈尔滨极地馆,20230225,241,68,173,252.0,237.6,257.1
422,哈尔滨极地馆,20230226,238,64,174,241.0,239.2,249.9
423,哈尔滨极地馆,20230227,205,66,139,238.0,234.6,236.9
424,哈尔滨极地馆,20230228,220,63,157,205.0,231.2,231.5
425,哈尔滨极地馆,20230301,233,70,163,220.0,227.4,234.7
426,哈尔滨极地馆,20230302,202,66,136,233.0,219.6,228.6
427,哈尔滨极地馆,20230303,243,76,167,202.0,220.6,229.9
428,哈尔滨极地馆,20230304,282,63,219,243.0,236.0,235.3
429,哈尔滨极地馆,20230305,232,59,173,282.0,238.4,234.8
430,哈尔滨极地馆,20230306,230,68,162,232.0,237.8,232.6
431,哈尔滨极地馆,20230307,221,74,147,230.0,241.6,230.6
432,哈尔滨极地馆,20230308,200,66,134,221.0,233.0,226.8
433,哈尔滨极地馆,20230309,206,61,145,200.0,217.8,226.9
434,哈尔滨极地馆,20230310,223,63,160,206.0,216.0,227.2
435,哈尔滨极地馆,20230311,158,0,158,223.0,201.6,219.7
436,哈尔滨极地馆,20230312,231,61,170,158.0,203.6,222.6
437,哈尔滨极地馆,20230313,234,68,166,231.0,210.4,221.7
438,哈尔滨极地馆,20230314,155,0,155,234.0,200.2,209.0
439,哈尔滨极地馆,20230315,242,72,170,155.0,204.0,210.0
440,哈尔滨极地馆,20230316,227,64,163,242.0,217.8,209.7
441,哈尔滨极地馆,20230317,256,66,190,227.0,222.8,213.2
442,哈尔滨极地馆,20230318,270,64,206,256.0,230.0,220.2
443,哈尔滨极地馆,20230319,249,72,177,270.0,248.8,224.5
444,哈尔滨极地馆,20230320,239,68,171,249.0,248.2,226.1
445,哈尔滨极地馆,20230321,236,66,170,239.0,250.0,233.9
446,哈尔滨极地馆,20230322,231,64,167,236.0,245.0,233.9
447,哈尔滨极地馆,20230323,246,78,168,231.0,240.2,235.1
448,哈尔滨极地馆,20230324,270,68,202,246.0,244.4,246.6
449,哈尔滨极地馆,20230325,276,64,212,270.0,251.8,250.0
450,哈尔滨极地馆,20230326,237,63,174,276.0,252.0,251.0
451,哈尔滨极地馆,20230327,251,72,179,237.0,256.0,250.5
452,哈尔滨极地馆,20230328,232,72,160,251.0,253.2,246.7
453,哈尔滨极地馆,20230329,250,74,176,232.0,249.2,246.8
454,哈尔滨极地馆,20230330,238,68,170,250.0,241.6,246.7
455,哈尔滨极地馆,20230331,273,78,195,238.0,248.8,250.4
456,哈尔滨极地馆,20230401,192,0,192,273.0,237.0,246.5
457,哈尔滨极地馆,20230402,236,66,170,192.0,237.8,245.5
458,哈尔滨极地馆,20230403,227,64,163,236.0,233.2,241.2
459,哈尔滨极地馆,20230404,276,76,200,227.0,240.8,241.2
460,哈尔滨极地馆,20230405,198,0,198,276.0,225.8,237.3
461,哈尔滨极地馆,20230406,239,66,173,198.0,235.2,236.1
462,哈尔滨极地馆,20230407,246,68,178,239.0,237.2,237.5
463,哈尔滨极地馆,20230408,277,63,214,246.0,247.2,240.2
464,哈尔滨极地馆,20230409,272,74,198,277.0,246.4,243.6
465,哈尔滨极地馆,20230410,243,70,173,272.0,255.4,240.6
466,哈尔滨极地馆,20230411,240,76,164,243.0,255.6,245.4
467,哈尔滨极地馆,20230412,243,85,158,240.0,255.0,246.1
468,哈尔滨极地馆,20230413,291,83,208,243.0,257.8,252.5
469,哈尔滨极地馆,20230414,286,72,214,291.0,260.6,253.5
470,哈尔滨极地馆,20230415,276,64,212,286.0,267.2,261.3
471,哈尔滨极地馆,20230416,297,70,227,276.0,278.6,267.1
472,哈尔滨极地馆,20230417,277,87,190,297.0,285.4,270.2
473,哈尔滨极地馆,20230418,299,82,217,277.0,287.0,272.4
474,哈尔滨极地馆,20230419,285,76,209,299.0,286.8,273.7
475,哈尔滨极地馆,20230420,347,108,239,285.0,301.0,284.1
476,哈尔滨极地馆,20230421,351,85,266,347.0,311.8,295.2
477,哈尔滨极地馆,20230422,339,68,271,351.0,324.2,304.8
478,哈尔滨极地馆,20230423,378,101,277,339.0,340.0,313.5
479,哈尔滨极地馆,20230424,337,82,255,378.0,350.4,318.6
480,哈尔滨极地馆,20230425,362,101,261,337.0,353.4,327.2
481,哈尔滨极地馆,20230426,399,91,308,362.0,363.0,337.4
482,哈尔滨极地馆,20230427,502,121,381,399.0,395.6,359.9
483,哈尔滨极地馆,20230428,614,93,521,502.0,442.8,391.4
484,哈尔滨极地馆,20230429,806,80,726,614.0,536.6,443.5
485,哈尔滨极地馆,20230430,900,82,818,806.0,644.2,498.8
486,哈尔滨极地馆,20230501,640,70,570,900.0,692.4,527.7
487,哈尔滨极地馆,20230502,484,64,420,640.0,688.8,542.2
488,哈尔滨极地馆,20230503,338,64,274,484.0,633.6,538.2
489,哈尔滨极地馆,20230504,223,68,155,338.0,517.0,526.8
490,哈尔滨极地馆,20230505,267,72,195,223.0,390.4,517.3
491,哈尔滨极地馆,20230506,245,85,160,267.0,311.4,501.9
492,哈尔滨极地馆,20230507,243,59,184,245.0,263.2,476.0
493,哈尔滨极地馆,20230508,224,66,158,243.0,240.4,437.0
494,哈尔滨极地馆,20230509,216,64,152,224.0,239.0,378.0
495,哈尔滨极地馆,20230510,227,66,161,216.0,231.0,310.7
496,哈尔滨极地馆,20230511,229,68,161,227.0,227.8,269.6
497,哈尔滨极地馆,20230512,271,82,189,229.0,233.4,248.3
498,哈尔滨极地馆,20230513,238,64,174,271.0,236.2,238.3
499,哈尔滨极地馆,20230514,211,64,147,238.0,235.2,237.1
500,哈尔滨极地馆,20230515,229,64,165,211.0,235.6,233.3
501,哈尔滨极地馆,20230516,211,64,147,229.0,232.0,229.9
502,哈尔滨极地馆,20230517,241,74,167,211.0,226.0,229.7
503,哈尔滨极地馆,20230518,246,80,166,241.0,227.6,231.9
504,哈尔滨极地馆,20230519,223,64,159,246.0,230.0,232.6
505,哈尔滨极地馆,20230520,231,63,168,223.0,230.4,233.0
506,哈尔滨极地馆,20230521,228,63,165,231.0,233.8,232.9
507,哈尔滨极地馆,20230522,225,70,155,228.0,230.6,228.3
508,哈尔滨极地馆,20230523,213,59,154,225.0,224.0,225.8
509,哈尔滨极地馆,20230524,215,74,141,213.0,222.4,226.2
510,哈尔滨极地馆,20230525,241,61,180,215.0,224.4,227.4
511,哈尔滨极地馆,20230526,220,59,161,241.0,222.8,228.3
512,哈尔滨极地馆,20230527,221,63,158,220.0,222.0,226.3
513,哈尔滨极地馆,20230528,214,63,151,221.0,222.2,223.1
514,哈尔滨极地馆,20230529,230,66,164,214.0,225.2,223.8
515,哈尔滨极地馆,20230530,244,70,174,230.0,225.8,225.1
516,哈尔滨极地馆,20230531,253,76,177,244.0,232.4,227.6
517,哈尔滨极地馆,20230601,271,68,203,253.0,242.4,232.2
518,哈尔滨极地馆,20230602,244,66,178,271.0,248.4,235.3
519,哈尔滨极地馆,20230603,183,0,183,244.0,239.0,232.1
520,哈尔滨极地馆,20230604,159,0,159,183.0,222.0,223.9
521,哈尔滨极地馆,20230605,263,76,187,159.0,224.0,228.2
522,哈尔滨极地馆,20230606,243,70,173,263.0,218.4,230.4
523,哈尔滨极地馆,20230607,238,68,170,243.0,217.2,232.8
524,哈尔滨极地馆,20230608,233,68,165,238.0,227.2,233.1
525,哈尔滨极地馆,20230609,219,64,155,233.0,239.2,230.6
526,哈尔滨极地馆,20230610,243,59,184,219.0,235.2,229.6
527,哈尔滨极地馆,20230611,255,66,189,243.0,237.6,228.0
528,哈尔滨极地馆,20230612,236,78,158,255.0,237.2,227.2
529,哈尔滨极地馆,20230613,252,74,178,236.0,241.0,234.1
530,哈尔滨极地馆,20230614,259,70,189,252.0,249.0,244.1
531,哈尔滨极地馆,20230615,231,72,159,259.0,246.6,240.9
532,哈尔滨极地馆,20230616,250,80,170,231.0,245.6,241.6
533,哈尔滨极地馆,20230617,256,64,192,250.0,249.6,243.4
534,哈尔滨极地馆,20230618,263,64,199,256.0,251.8,246.4
535,哈尔滨极地馆,20230619,278,80,198,263.0,255.6,252.3
536,哈尔滨极地馆,20230620,307,78,229,278.0,270.8,258.7
537,哈尔滨极地馆,20230621,310,76,234,307.0,282.8,264.2
538,哈尔滨极地馆,20230622,325,70,255,310.0,296.6,273.1
539,哈尔滨极地馆,20230623,297,66,231,325.0,303.4,277.6
540,哈尔滨极地馆,20230624,271,63,208,297.0,302.0,278.8
541,哈尔滨极地馆,20230625,298,80,218,271.0,300.2,285.5
542,哈尔滨极地馆,20230626,263,76,187,298.0,290.8,286.8
543,哈尔滨极地馆,20230627,275,82,193,263.0,280.8,288.7
544,哈尔滨极地馆,20230628,289,70,219,275.0,279.2,291.3
545,哈尔滨极地馆,20230629,292,74,218,289.0,283.4,292.7
546,哈尔滨极地馆,20230630,301,82,219,292.0,284.0,292.1
547,哈尔滨极地馆,20230701,290,72,218,301.0,289.4,290.1
548,哈尔滨极地馆,20230702,267,59,208,290.0,287.8,284.3
549,哈尔滨极地馆,20230703,294,80,214,267.0,288.8,284.0
550,哈尔滨极地馆,20230704,286,80,206,294.0,287.6,285.5
551,哈尔滨极地馆,20230705,355,89,266,286.0,298.4,291.2
552,哈尔滨极地馆,20230706,300,72,228,355.0,300.4,294.9
553,哈尔滨极地馆,20230707,327,74,253,300.0,312.4,300.1
554,哈尔滨极地馆,20230708,340,72,268,327.0,321.6,305.2
555,哈尔滨极地馆,20230709,319,64,255,340.0,328.2,307.9
556,哈尔滨极地馆,20230710,354,95,259,319.0,328.0,313.2
557,哈尔滨极地馆,20230711,372,85,287,354.0,342.4,321.4
558,哈尔滨极地馆,20230712,335,83,252,372.0,344.0,328.2
559,哈尔滨极地馆,20230713,362,70,292,335.0,348.4,335.0
560,哈尔滨极地馆,20230714,370,70,300,362.0,358.6,343.4
561,哈尔滨极地馆,20230715,394,66,328,370.0,366.6,347.3
562,哈尔滨极地馆,20230716,351,66,285,394.0,362.4,352.4
563,哈尔滨极地馆,20230717,383,80,303,351.0,372.0,358.0
564,哈尔滨极地馆,20230718,427,108,319,383.0,385.0,366.7
565,哈尔滨极地馆,20230719,373,74,299,427.0,385.6,372.1
566,哈尔滨极地馆,20230720,373,85,288,373.0,381.4,374.0
567,哈尔滨极地馆,20230721,401,78,323,373.0,391.4,376.9
568,哈尔滨极地馆,20230722,412,66,346,401.0,397.2,384.6
569,哈尔滨极地馆,20230723,417,66,351,412.0,395.2,390.1
570,哈尔滨极地馆,20230724,447,82,365,417.0,410.0,397.8
571,哈尔滨极地馆,20230725,449,80,369,447.0,425.2,403.3
572,哈尔滨极地馆,20230726,472,82,390,449.0,439.4,415.4
573,哈尔滨极地馆,20230727,436,80,356,472.0,444.2,420.7
574,哈尔滨极地馆,20230728,445,76,369,436.0,449.8,422.5
575,哈尔滨极地馆,20230729,488,66,422,445.0,458.0,434.0
576,哈尔滨极地馆,20230730,513,66,447,488.0,470.8,448.0
577,哈尔滨极地馆,20230731,515,89,426,513.0,479.4,459.4
578,哈尔滨极地馆,20230801,507,85,422,515.0,493.6,468.9
579,哈尔滨极地馆,20230802,439,74,365,507.0,492.4,471.1
580,哈尔滨极地馆,20230803,435,97,338,439.0,481.8,469.9
581,哈尔滨极地馆,20230804,389,74,315,435.0,457.0,463.9
582,哈尔滨极地馆,20230805,387,63,324,389.0,431.4,455.4
583,哈尔滨极地馆,20230806,378,66,312,387.0,405.6,449.6
584,哈尔滨极地馆,20230807,412,74,338,378.0,400.2,446.3
585,哈尔滨极地馆,20230808,355,82,273,412.0,384.2,433.0
586,哈尔滨极地馆,20230809,364,72,292,355.0,379.2,418.1
587,哈尔滨极地馆,20230810,326,72,254,364.0,367.0,399.2
588,哈尔滨极地馆,20230811,351,78,273,326.0,361.6,383.6
589,哈尔滨极地馆,20230812,354,66,288,351.0,350.0,375.1
590,哈尔滨极地馆,20230813,353,59,294,354.0,349.6,366.9
591,哈尔滨极地馆,20230814,380,78,302,353.0,352.8,366.0
592,哈尔滨极地馆,20230815,402,76,326,380.0,368.0,367.5
593,哈尔滨极地馆,20230816,386,74,312,402.0,375.0,368.3
594,哈尔滨极地馆,20230817,386,72,314,386.0,381.4,365.7
595,哈尔滨极地馆,20230818,401,85,316,386.0,391.0,370.3
596,哈尔滨极地馆,20230819,362,68,294,401.0,387.4,370.1
597,哈尔滨极地馆,20230820,330,59,271,362.0,373.0,370.5
598,哈尔滨极地馆,20230821,331,74,257,330.0,362.0,368.5
599,哈尔滨极地馆,20230822,290,70,220,331.0,342.8,362.1
600,哈尔滨极地馆,20230823,287,63,224,290.0,320.0,355.5
601,哈尔滨极地馆,20230824,300,66,234,287.0,307.6,347.5
602,哈尔滨极地馆,20230825,279,64,215,300.0,297.4,335.2
603,哈尔滨极地馆,20230826,293,59,234,279.0,289.8,325.9
604,哈尔滨极地馆,20230827,197,0,197,293.0,271.2,307.0
605,哈尔滨极地馆,20230828,243,59,184,197.0,262.4,291.2
606,哈尔滨极地馆,20230829,295,78,217,243.0,261.4,284.5
607,哈尔滨极地馆,20230830,237,63,174,295.0,253.0,275.2
608,哈尔滨极地馆,20230831,214,59,155,237.0,237.2,263.5
609,哈尔滨极地馆,20230901,232,72,160,214.0,244.2,257.7
610,哈尔滨极地馆,20230902,258,61,197,232.0,247.2,254.8
611,哈尔滨极地馆,20230903,224,61,163,258.0,233.0,247.2
612,哈尔滨极地馆,20230904,222,68,154,224.0,230.0,241.5
613,哈尔滨极地馆,20230905,199,64,135,222.0,227.0,232.1
614,哈尔滨极地馆,20230906,213,66,147,199.0,223.2,233.7
615,哈尔滨极地馆,20230907,219,70,149,213.0,215.4,231.3
616,哈尔滨极地馆,20230908,223,61,162,219.0,215.2,224.1
617,哈尔滨极地馆,20230909,243,59,184,223.0,219.4,224.7
618,哈尔滨极地馆,20230910,236,70,166,243.0,226.8,226.9
619,哈尔滨极地馆,20230911,207,66,141,236.0,225.6,224.4
620,哈尔滨极地馆,20230912,238,68,170,207.0,229.4,222.4
621,哈尔滨极地馆,20230913,219,64,155,238.0,228.6,221.9
622,哈尔滨极地馆,20230914,241,82,159,219.0,228.2,223.8
623,哈尔滨极地馆,20230915,249,76,173,241.0,230.8,228.8
624,哈尔滨极地馆,20230916,226,63,163,249.0,234.6,230.1
625,哈尔滨极地馆,20230917,243,59,184,226.0,235.6,232.5
626,哈尔滨极地馆,20230918,227,66,161,243.0,237.2,232.9
627,哈尔滨极地馆,20230919,216,82,134,227.0,232.2,230.2
628,哈尔滨极地馆,20230920,238,70,168,216.0,230.0,230.4
629,哈尔滨极地馆,20230921,184,78,106,238.0,221.6,228.1
630,哈尔滨极地馆,20230922,198,68,130,184.0,212.6,224.1
631,哈尔滨极地馆,20230923,217,59,158,198.0,210.6,223.9
632,哈尔滨极地馆,20230924,227,63,164,217.0,212.8,222.5
633,哈尔滨极地馆,20230925,229,72,157,227.0,211.0,220.5
634,哈尔滨极地馆,20230926,240,72,168,229.0,222.2,221.9
635,哈尔滨极地馆,20230927,265,68,197,240.0,235.6,224.1
636,哈尔滨极地馆,20230928,272,74,198,265.0,246.6,228.6
637,哈尔滨极地馆,20230929,371,61,310,272.0,275.4,244.1
638,哈尔滨极地馆,20230930,438,59,379,371.0,317.2,264.1
639,哈尔滨极地馆,20231001,397,63,334,438.0,348.6,285.4
640,哈尔滨极地馆,20231002,331,0,331,397.0,361.8,298.7
641,哈尔滨极地馆,20231003,359,59,300,331.0,379.2,312.9
642,哈尔滨极地馆,20231004,331,72,259,359.0,371.2,323.3
643,哈尔滨极地馆,20231005,206,0,206,331.0,324.8,321.0
644,哈尔滨极地馆,20231006,254,61,193,206.0,296.2,322.4
645,哈尔滨极地馆,20231007,189,68,121,254.0,267.8,314.8
646,哈尔滨极地馆,20231008,176,66,110,189.0,231.2,305.2
647,哈尔滨极地馆,20231009,185,66,119,176.0,202.0,286.6
648,哈尔滨极地馆,20231010,199,78,121,185.0,200.6,262.7
649,哈尔滨极地馆,20231011,179,64,115,199.0,185.6,240.9
650,哈尔滨极地馆,20231012,193,68,125,179.0,186.4,227.1
651,哈尔滨极地馆,20231013,185,72,113,193.0,188.2,209.7
652,哈尔滨极地馆,20231014,197,63,134,185.0,190.6,196.3
653,哈尔滨极地馆,20231015,207,63,144,197.0,192.2,196.4
654,哈尔滨极地馆,20231016,171,63,108,207.0,190.6,188.1
655,哈尔滨极地馆,20231017,199,93,106,171.0,191.8,189.1
656,哈尔滨极地馆,20231018,173,68,105,199.0,189.4,188.8
657,哈尔滨极地馆,20231019,201,80,121,173.0,190.2,190.4
658,哈尔滨极地馆,20231020,176,70,106,201.0,184.0,188.1
659,哈尔滨极地馆,20231021,181,63,118,176.0,186.0,188.3
660,哈尔滨极地馆,20231022,164,64,100,181.0,179.0,185.4
661,哈尔滨极地馆,20231023,183,78,105,164.0,181.0,185.2
662,哈尔滨极地馆,20231024,180,72,108,183.0,176.8,183.5
663,哈尔滨极地馆,20231025,181,66,115,180.0,177.8,180.9
664,哈尔滨极地馆,20231026,170,68,102,181.0,175.6,180.8
665,哈尔滨极地馆,20231027,184,82,102,170.0,179.6,179.3
666,哈尔滨极地馆,20231028,161,66,95,184.0,175.2,178.1
667,哈尔滨极地馆,20231029,164,64,100,161.0,172.0,174.4
668,哈尔滨极地馆,20231030,161,72,89,164.0,168.0,172.9
669,哈尔滨极地馆,20231031,162,70,92,161.0,166.4,171.0
670,哈尔滨极地馆,20231101,182,74,108,162.0,166.0,172.8
671,哈尔滨极地馆,20231102,157,68,89,182.0,165.2,170.2
672,哈尔滨极地馆,20231103,195,76,119,157.0,171.4,171.7
673,哈尔滨极地馆,20231104,178,70,108,195.0,174.8,171.4
674,哈尔滨极地馆,20231105,143,61,82,178.0,171.0,168.7
675,哈尔滨极地馆,20231106,187,91,96,143.0,172.0,169.0
676,哈尔滨极地馆,20231107,169,64,105,187.0,174.4,169.8
677,哈尔滨极地馆,20231108,168,82,86,169.0,169.0,170.2
678,哈尔滨极地馆,20231109,175,83,92,168.0,168.4,171.6
679,哈尔滨极地馆,20231110,180,78,102,175.0,175.8,173.4
680,哈尔滨极地馆,20231111,182,76,106,180.0,174.8,173.4
681,哈尔滨极地馆,20231112,161,68,93,182.0,173.2,173.8
682,哈尔滨极地馆,20231113,199,80,119,161.0,179.4,174.2
683,哈尔滨极地馆,20231114,190,78,112,199.0,182.4,175.4
684,哈尔滨极地馆,20231115,183,87,96,190.0,183.0,179.4
685,哈尔滨极地馆,20231116,172,68,104,183.0,181.0,177.9
686,哈尔滨极地馆,20231117,175,76,99,172.0,183.8,178.5
687,哈尔滨极地馆,20231118,167,63,104,175.0,177.4,178.4
688,哈尔滨极地馆,20231119,187,66,121,167.0,176.8,179.6
689,哈尔滨极地馆,20231120,165,68,97,187.0,173.2,178.1
690,哈尔滨极地馆,20231121,198,89,109,165.0,178.4,179.7
691,哈尔滨极地馆,20231122,185,76,109,198.0,180.4,182.1
692,哈尔滨极地馆,20231123,219,97,122,185.0,190.8,184.1
693,哈尔滨极地馆,20231124,216,68,148,219.0,196.6,186.7
694,哈尔滨极地馆,20231125,196,70,126,216.0,202.8,188.0
695,哈尔滨极地馆,20231126,218,74,144,196.0,206.8,192.6
696,哈尔滨极地馆,20231127,191,74,117,218.0,208.0,194.2
697,哈尔滨极地馆,20231128,205,87,118,191.0,205.2,198.0
698,哈尔滨极地馆,20231129,182,80,102,205.0,198.4,197.5
699,哈尔滨极地馆,20231130,205,83,122,182.0,200.2,201.5
700,哈尔滨极地馆,20231201,191,74,117,205.0,194.8,200.8
701,哈尔滨极地馆,20231202,195,63,132,191.0,195.6,201.8
702,哈尔滨极地馆,20231203,191,70,121,195.0,192.8,199.0
703,哈尔滨极地馆,20231204,193,80,113,191.0,195.0,196.7
704,哈尔滨极地馆,20231205,225,78,147,193.0,199.0,199.6
705,哈尔滨极地馆,20231206,195,82,113,225.0,199.8,197.3
706,哈尔滨极地馆,20231207,213,95,118,195.0,203.4,199.5
707,哈尔滨极地馆,20231208,185,85,100,213.0,202.2,197.5
708,哈尔滨极地馆,20231209,194,68,126,185.0,202.4,198.7
709,哈尔滨极地馆,20231210,187,64,123,194.0,194.8,196.9
710,哈尔滨极地馆,20231211,201,91,110,187.0,196.0,197.9
711,哈尔滨极地馆,20231212,167,80,87,201.0,186.8,195.1
712,哈尔滨极地馆,20231213,191,82,109,167.0,188.0,195.1
713,哈尔滨极地馆,20231214,190,72,118,191.0,187.2,194.8
714,哈尔滨极地馆,20231215,226,78,148,190.0,195.0,194.9
715,哈尔滨极地馆,20231216,208,72,136,226.0,196.4,196.2
716,哈尔滨极地馆,20231217,237,80,157,208.0,210.4,198.6
717,哈尔滨极地馆,20231218,280,118,162,237.0,228.2,208.1
718,哈尔滨极地馆,20231219,212,78,134,280.0,232.6,209.9
719,哈尔滨极地馆,20231220,214,78,136,212.0,230.2,212.6
720,哈尔滨极地馆,20231221,231,83,148,214.0,234.8,215.6
721,哈尔滨极地馆,20231222,215,72,143,231.0,230.4,220.4
722,哈尔滨极地馆,20231223,200,66,134,215.0,214.4,221.3
723,哈尔滨极地馆,20231224,191,63,128,200.0,210.2,221.4
724,哈尔滨极地馆,20231225,221,89,132,191.0,211.6,220.9
725,哈尔滨极地馆,20231226,248,78,170,221.0,215.0,224.9
726,哈尔滨极地馆,20231227,217,72,145,248.0,215.4,222.9
727,哈尔滨极地馆,20231228,231,83,148,217.0,221.6,218.0
728,哈尔滨极地馆,20231229,227,91,136,231.0,228.8,219.5
729,哈尔滨极地馆,20231230,238,64,174,227.0,232.2,221.9
730,哈尔滨极地馆,20231231,219,64,155,238.0,226.4,220.7
731,哈尔滨极地馆,20240101,214,70,144,219.0,225.8,220.6
732,哈尔滨极地馆,20240102,229,99,130,214.0,225.4,223.5
733,哈尔滨极地馆,20240103,309,116,193,229.0,241.8,235.3
734,哈尔滨极地馆,20240104,312,129,183,309.0,256.6,244.4
735,哈尔滨极地馆,20240105,287,101,186,312.0,270.2,248.3
736,哈尔滨极地馆,20240106,336,97,239,287.0,294.6,260.2
737,哈尔滨极地馆,20240107,291,83,208,336.0,307.0,266.2
738,哈尔滨极地馆,20240108,306,127,179,291.0,306.4,274.1
739,哈尔滨极地馆,20240109,275,101,174,306.0,299.0,277.8
740,哈尔滨极地馆,20240110,274,120,154,275.0,296.4,283.3
741,哈尔滨极地馆,20240111,251,97,154,274.0,279.4,287.0
742,哈尔滨极地馆,20240112,271,95,176,251.0,275.4,291.2
743,哈尔滨极地馆,20240113,231,70,161,271.0,260.4,283.4
744,哈尔滨极地馆,20240114,257,70,187,231.0,256.8,277.9
745,哈尔滨极地馆,20240115,242,85,157,257.0,250.4,273.4
746,哈尔滨极地馆,20240116,232,83,149,242.0,246.6,263.0
747,哈尔滨极地馆,20240117,267,97,170,232.0,245.8,260.6
748,哈尔滨极地馆,20240118,238,70,168,267.0,247.2,253.8
749,哈尔滨极地馆,20240119,240,89,151,238.0,243.8,250.3
750,哈尔滨极地馆,20240120,244,85,159,240.0,244.2,247.3
751,哈尔滨极地馆,20240121,250,70,180,244.0,247.8,247.2
752,哈尔滨极地馆,20240122,244,95,149,250.0,243.2,244.5
753,哈尔滨极地馆,20240123,258,91,167,244.0,247.2,247.2
754,哈尔滨极地馆,20240124,231,76,155,258.0,245.4,244.6
755,哈尔滨极地馆,20240125,259,85,174,231.0,248.4,246.3
756,哈尔滨极地馆,20240126,240,85,155,259.0,246.4,247.1
757,哈尔滨极地馆,20240127,229,74,155,240.0,243.4,243.3
758,哈尔滨极地馆,20240128,232,68,164,229.0,238.2,242.7
759,哈尔滨极地馆,20240129,232,70,162,232.0,238.4,241.9
760,哈尔滨极地馆,20240130,260,87,173,232.0,238.6,243.5
761,哈尔滨极地馆,20240131,237,72,165,260.0,238.0,242.2
762,哈尔滨极地馆,20240201,232,78,154,237.0,238.6,241.0
763,哈尔滨极地馆,20240202,206,70,136,232.0,233.4,235.8
764,哈尔滨极地馆,20240203,240,66,174,206.0,235.0,236.7
765,哈尔滨极地馆,20240204,250,82,168,240.0,233.0,235.8
766,哈尔滨极地馆,20240205,236,74,162,250.0,232.8,235.4
767,哈尔滨极地馆,20240206,215,63,152,236.0,229.4,234.0
768,哈尔滨极地馆,20240207,202,80,122,215.0,228.6,231.0
769,哈尔滨极地馆,20240208,198,64,134,202.0,220.2,227.6
770,哈尔滨极地馆,20240209,189,70,119,198.0,208.0,220.5
771,哈尔滨极地馆,20240210,164,0,164,189.0,193.6,213.2
772,哈尔滨极地馆,20240211,263,63,200,164.0,203.2,216.3
773,哈尔滨极地馆,20240212,265,61,204,263.0,215.8,222.2
774,哈尔滨极地馆,20240213,307,76,231,265.0,237.6,228.9
775,哈尔滨极地馆,20240214,308,61,247,307.0,261.4,234.7
776,哈尔滨极地馆,20240215,290,59,231,308.0,286.6,240.1
777,哈尔滨极地馆,20240216,266,64,202,290.0,287.2,245.2
778,哈尔滨极地馆,20240217,269,61,208,266.0,288.0,251.9
779,哈尔滨极地馆,20240218,241,70,171,269.0,274.8,256.2
780,哈尔滨极地馆,20240219,211,59,152,241.0,255.4,258.4
781,哈尔滨极地馆,20240220,229,68,161,211.0,243.2,264.9
782,哈尔滨极地馆,20240221,207,68,139,229.0,231.4,259.3
783,哈尔滨极地馆,20240222,191,66,125,207.0,215.8,251.9
784,哈尔滨极地馆,20240223,176,61,115,191.0,202.8,238.8
785,哈尔滨极地馆,20240224,178,61,117,176.0,196.2,225.8
786,哈尔滨极地馆,20240225,181,59,122,178.0,186.6,214.9
787,哈尔滨极地馆,20240226,171,63,108,181.0,179.4,205.4
788,哈尔滨极地馆,20240227,186,76,110,171.0,178.4,197.1
789,哈尔滨极地馆,20240228,197,63,134,186.0,182.6,192.7
790,哈尔滨极地馆,20240229,167,59,108,197.0,180.4,188.3
791,哈尔滨极地馆,20240301,184,76,108,167.0,181.0,183.8
792,哈尔滨极地馆,20240302,118,0,118,184.0,170.4,174.9
793,哈尔滨极地馆,20240303,102,0,102,118.0,153.6,166.0
794,哈尔滨极地馆,20240304,159,64,95,102.0,146.0,164.3
795,哈尔滨极地馆,20240305,158,66,92,159.0,144.2,162.3
796,哈尔滨极地馆,20240306,145,63,82,158.0,136.4,158.7
797,哈尔滨极地馆,20240307,162,63,99,145.0,145.2,157.8
798,哈尔滨极地馆,20240308,157,66,91,162.0,156.2,154.9
799,哈尔滨极地馆,20240309,169,64,105,157.0,158.2,152.1
800,哈尔滨极地馆,20240310,93,0,93,169.0,145.2,144.7
801,哈尔滨极地馆,20240311,172,68,104,93.0,150.6,143.5
802,哈尔滨极地馆,20240312,165,61,104,172.0,151.2,148.2
803,哈尔滨极地馆,20240313,160,63,97,165.0,151.8,154.0
804,哈尔滨极地馆,20240314,179,70,109,160.0,153.8,156.0
805,哈尔滨极地馆,20240315,207,66,141,179.0,176.6,160.9
806,哈尔滨极地馆,20240316,178,61,117,207.0,177.8,164.2
807,哈尔滨极地馆,20240317,115,0,115,178.0,167.8,159.5
808,哈尔滨极地馆,20240318,172,70,102,115.0,170.2,161.0
809,哈尔滨极地馆,20240319,96,0,96,172.0,153.6,153.7
810,哈尔滨极地馆,20240320,100,0,100,96.0,132.2,154.4
811,哈尔滨极地馆,20240321,176,61,115,100.0,131.8,154.8
812,哈尔滨极地馆,20240322,195,78,117,176.0,147.8,157.8
813,哈尔滨极地馆,20240323,169,61,108,195.0,147.2,158.7
814,哈尔滨极地馆,20240324,183,64,119,169.0,164.6,159.1
815,哈尔滨极地馆,20240325,151,64,87,183.0,174.8,153.5
816,哈尔滨极地馆,20240326,169,63,106,151.0,173.4,152.6
817,哈尔滨极地馆,20240327,172,66,106,169.0,168.8,158.3
818,哈尔滨极地馆,20240328,167,68,99,172.0,168.4,157.8
819,哈尔滨极地馆,20240329,172,68,104,167.0,166.2,165.4
820,哈尔滨极地馆,20240330,176,61,115,172.0,171.2,173.0
821,哈尔滨极地馆,20240331,208,63,145,176.0,179.0,176.2
822,哈尔滨极地馆,20240401,187,68,119,208.0,182.0,175.4
823,哈尔滨极地馆,20240402,191,70,121,187.0,186.8,177.6
824,哈尔滨极地馆,20240403,277,82,195,191.0,207.8,187.0
825,哈尔滨极地馆,20240404,282,68,214,277.0,229.0,200.1
826,哈尔滨极地馆,20240405,250,61,189,282.0,237.4,208.2
827,哈尔滨极地馆,20240406,179,61,118,250.0,235.8,208.9
828,哈尔滨极地馆,20240407,179,64,115,179.0,233.4,210.1
829,哈尔滨极地馆,20240408,159,72,87,179.0,209.8,208.8
830,哈尔滨极地馆,20240409,189,63,126,159.0,191.2,210.1
831,哈尔滨极地馆,20240410,172,63,109,189.0,175.6,206.5
832,哈尔滨极地馆,20240411,178,70,108,172.0,175.4,205.6
833,哈尔滨极地馆,20240412,184,78,106,178.0,176.4,204.9
834,哈尔滨极地馆,20240413,154,57,97,184.0,175.4,192.6
835,哈尔滨极地馆,20240414,191,59,132,154.0,175.8,183.5
836,哈尔滨极地馆,20240415,187,66,121,191.0,178.8,177.2
837,哈尔滨极地馆,20240416,184,76,108,187.0,180.0,177.7
838,哈尔滨极地馆,20240417,211,64,147,184.0,185.4,180.9
839,哈尔滨极地馆,20240418,184,74,110,211.0,191.4,183.4
840,哈尔滨极地馆,20240419,198,70,128,184.0,192.8,184.3
841,哈尔滨极地馆,20240420,189,59,130,198.0,193.2,186.0
842,哈尔滨极地馆,20240421,198,64,134,189.0,196.0,188.0
843,哈尔滨极地馆,20240422,200,70,130,198.0,193.8,189.6
844,哈尔滨极地馆,20240423,205,74,131,200.0,198.0,194.7
845,哈尔滨极地馆,20240424,194,72,122,205.0,197.2,195.0
846,哈尔滨极地馆,20240425,217,68,149,194.0,202.8,198.0
847,哈尔滨极地馆,20240426,228,80,148,217.0,208.8,202.4
848,哈尔滨极地馆,20240427,216,64,152,228.0,212.0,202.9
849,哈尔滨极地馆,20240428,257,91,166,216.0,222.4,210.2
850,哈尔滨极地馆,20240429,254,72,182,257.0,234.4,215.8
851,哈尔滨极地馆,20240430,330,78,252,254.0,257.0,229.9
1,东北虎林园,20220101,145,63,82,330.0,240.4,224.6
2,东北虎林园,20220102,160,63,97,145.0,229.2,220.6
3,东北虎林园,20220103,168,63,105,160.0,211.4,216.9
4,东北虎林园,20220104,175,76,99,168.0,195.6,215.0
5,东北虎林园,20220105,161,68,93,175.0,161.8,209.4
6,东北虎林园,20220106,167,74,93,161.0,166.2,203.3
7,东北虎林园,20220107,152,66,86,167.0,164.6,196.9
8,东北虎林园,20220108,143,61,82,152.0,159.6,185.5
9,东北虎林园,20220109,148,61,87,143.0,154.2,174.9
10,东北虎林园,20220110,154,72,82,148.0,152.8,157.3
11,东北虎林园,20220111,155,64,91,154.0,150.4,158.3
12,东北虎林园,20220112,161,70,91,155.0,152.2,158.4
13,东北虎林园,20220113,170,78,92,161.0,157.6,158.6
14,东北虎林园,20220114,175,82,93,170.0,163.0,158.6
15,东北虎林园,20220115,164,68,96,175.0,165.0,158.9
16,东北虎林园,20220116,186,80,106,164.0,171.2,160.8
17,东北虎林园,20220117,174,68,106,186.0,173.8,163.0
18,东北虎林园,20220118,155,72,83,174.0,170.8,164.2
19,东北虎林园,20220119,170,70,100,155.0,169.8,166.4
20,东北虎林园,20220120,172,68,104,170.0,171.4,168.2
21,东北虎林园,20220121,161,74,87,172.0,166.4,168.8
22,东北虎林园,20220122,172,64,108,161.0,166.0,169.9
23,东北虎林园,20220123,164,68,96,172.0,167.8,169.3
24,东北虎林园,20220124,193,85,108,164.0,172.4,171.1
25,东北虎林园,20220125,158,66,92,193.0,169.6,170.5
26,东北虎林园,20220126,170,70,100,158.0,171.4,168.9
27,东北虎林园,20220127,169,70,99,170.0,170.8,168.4
28,东北虎林园,20220128,161,72,89,169.0,170.2,169.0
29,东北虎林园,20220129,178,59,119,161.0,167.2,169.8
30,东北虎林园,20220130,178,68,110,178.0,171.2,170.4
31,东北虎林园,20220131,240,63,177,178.0,185.2,178.3
32,东北虎林园,20220201,250,72,178,240.0,201.4,186.1
33,东北虎林园,20220202,231,68,163,250.0,215.4,192.8
34,东北虎林园,20220203,233,66,167,231.0,226.4,196.8
35,东北虎林园,20220204,192,66,126,233.0,229.2,200.2
36,东北虎林园,20220205,194,68,126,192.0,220.0,202.6
37,东北虎林园,20220206,134,0,134,194.0,196.8,199.1
38,东北虎林园,20220207,170,66,104,134.0,184.6,200.0
39,东北虎林园,20220208,176,72,104,170.0,173.2,199.8
40,东北虎林园,20220209,187,64,123,176.0,172.2,200.7
41,东北虎林园,20220210,183,78,105,187.0,170.0,195.0
42,东北虎林园,20220211,159,63,96,183.0,175.0,185.9
43,东北虎林园,20220212,175,63,112,159.0,176.0,180.3
44,东北虎林园,20220213,169,63,106,175.0,174.6,173.9
45,东北虎林园,20220214,161,61,100,169.0,169.4,170.8
46,东北虎林园,20220215,157,68,89,161.0,164.2,167.1
47,东北虎林园,20220216,169,76,93,157.0,166.2,170.6
48,东北虎林园,20220217,175,80,95,169.0,166.2,171.1
49,东北虎林园,20220218,219,85,134,175.0,176.2,175.4
50,东北虎林园,20220219,204,68,136,219.0,184.8,177.1
51,东北虎林园,20220220,156,61,95,204.0,184.6,174.4
52,东北虎林园,20220221,182,78,104,156.0,187.2,176.7
53,东北虎林园,20220222,192,87,105,182.0,190.6,178.4
54,东北虎林园,20220223,161,66,95,192.0,179.0,177.6
55,东北虎林园,20220224,171,66,105,161.0,172.4,178.6
56,东北虎林园,20220225,160,74,86,171.0,173.2,178.9
57,东北虎林园,20220226,157,68,89,160.0,168.2,177.7
58,东北虎林园,20220227,147,61,86,157.0,159.2,174.9
59,东北虎林园,20220228,154,72,82,147.0,157.8,168.4
60,东北虎林园,20220301,150,68,82,154.0,153.6,163.0
61,东北虎林园,20220302,153,70,83,150.0,152.2,162.7
62,东北虎林园,20220303,172,68,104,153.0,155.2,161.7
63,东北虎林园,20220304,187,64,123,172.0,163.2,161.2
64,东北虎林园,20220305,154,68,86,187.0,163.2,160.5
65,东北虎林园,20220306,191,72,119,154.0,171.4,162.5
66,东北虎林园,20220307,198,66,132,191.0,180.4,166.3
67,东北虎林园,20220308,206,68,138,198.0,187.2,171.2
68,东北虎林园,20220309,158,63,95,206.0,181.4,172.3
69,东北虎林园,20220310,142,64,78,158.0,179.0,171.1
70,东北虎林园,20220311,173,63,110,142.0,175.4,173.4
71,东北虎林园,20220312,139,63,76,173.0,163.6,172.0
72,东北虎林园,20220313,142,64,78,139.0,150.8,169.0
73,东北虎林园,20220314,142,64,78,142.0,147.6,164.5
74,东北虎林园,20220315,141,59,82,142.0,147.4,163.2
75,东北虎林园,20220316,145,59,86,141.0,141.8,158.6
76,东北虎林园,20220317,133,63,70,145.0,140.6,152.1
77,东北虎林园,20220318,74,0,74,133.0,127.0,138.9
78,东北虎林园,20220319,137,63,74,74.0,126.0,136.8
79,东北虎林园,20220320,82,0,82,137.0,114.2,130.8
80,东北虎林园,20220321,137,59,78,82.0,112.6,127.2
81,东北虎林园,20220322,161,70,91,137.0,118.2,129.4
82,东北虎林园,20220323,145,63,82,161.0,132.4,129.7
83,东北虎林园,20220324,141,74,67,145.0,133.2,129.6
84,东北虎林园,20220325,143,70,73,141.0,145.4,129.8
85,东北虎林园,20220326,71,0,71,143.0,132.2,122.4
86,东北虎林园,20220327,135,64,71,71.0,127.0,122.6
87,东北虎林园,20220328,145,63,82,135.0,127.0,129.7
88,东北虎林园,20220329,135,59,76,145.0,125.8,129.5
89,东北虎林园,20220330,91,0,91,135.0,115.4,130.4
90,东北虎林园,20220331,161,61,100,91.0,133.4,132.8
91,东北虎林园,20220401,142,63,79,161.0,134.8,130.9
92,东北虎林园,20220402,146,59,87,142.0,135.0,131.0
93,东北虎林园,20220403,87,0,87,146.0,125.4,125.6
94,东北虎林园,20220404,132,59,73,87.0,133.6,124.5
95,东北虎林园,20220405,143,61,82,132.0,130.0,131.7
96,东北虎林园,20220406,133,66,67,143.0,128.2,131.5
97,东北虎林园,20220407,134,63,71,133.0,125.8,130.4
98,东北虎林园,20220408,137,68,69,134.0,135.8,130.6
99,东北虎林园,20220409,89,0,89,137.0,127.2,130.4
100,东北虎林园,20220410,143,63,80,89.0,127.2,128.6
101,东北虎林园,20220411,142,66,76,143.0,129.0,128.6
102,东北虎林园,20220412,146,72,74,142.0,131.4,128.6
103,东北虎林园,20220413,141,63,78,146.0,132.2,134.0
104,东北虎林园,20220414,145,66,79,141.0,143.4,135.3
105,东北虎林园,20220415,134,63,71,145.0,141.6,134.4
106,东北虎林园,20220416,79,0,79,134.0,129.0,129.0
107,东北虎林园,20220417,89,0,89,79.0,117.6,124.5
108,东北虎林园,20220418,132,59,73,89.0,115.8,124.0
109,东北虎林园,20220419,156,61,95,132.0,118.0,130.7
110,东北虎林园,20220420,158,63,95,156.0,122.8,132.2
111,东北虎林园,20220421,143,61,82,158.0,135.6,132.3
112,东北虎林园,20220422,159,63,96,143.0,149.6,133.6
113,东北虎林园,20220423,163,59,104,159.0,155.8,135.8
114,东北虎林园,20220424,84,0,84,163.0,141.4,129.7
115,东北虎林园,20220425,131,61,70,84.0,136.0,129.4
116,东北虎林园,20220426,76,0,76,131.0,122.6,129.1
117,东北虎林园,20220427,145,63,82,76.0,119.8,134.7
118,东北虎林园,20220428,145,61,84,145.0,116.2,136.0
119,东北虎林园,20220429,78,0,78,145.0,115.0,128.2
120,东北虎林园,20220430,146,59,87,78.0,118.0,127.0
121,东北虎林园,20220501,143,64,79,146.0,131.4,127.0
122,东北虎林园,20220502,87,0,87,143.0,119.8,119.8
123,东北虎林园,20220503,148,59,89,87.0,120.4,118.3
124,东北虎林园,20220504,150,64,86,148.0,134.8,124.9
125,东北虎林园,20220505,144,64,80,150.0,134.4,126.2
126,东北虎林园,20220506,76,0,76,144.0,121.0,126.2
127,东北虎林园,20220507,137,64,73,76.0,131.0,125.4
128,东北虎林园,20220508,99,0,99,137.0,121.2,120.8
129,东北虎林园,20220509,158,72,86,99.0,122.8,128.8
130,东北虎林园,20220510,144,64,80,158.0,122.8,128.6
131,东北虎林园,20220511,146,68,78,144.0,136.8,128.9
132,东北虎林园,20220512,154,70,84,146.0,140.2,135.6
133,东北虎林园,20220513,173,68,105,154.0,155.0,138.1
134,东北虎林园,20220514,167,61,106,173.0,156.8,139.8
135,东北虎林园,20220515,86,0,86,167.0,145.2,134.0
136,东北虎林园,20220516,146,63,83,86.0,145.2,141.0
137,东北虎林园,20220517,87,0,87,146.0,131.8,136.0
138,东北虎林园,20220518,157,64,93,87.0,128.6,141.8
139,东北虎林园,20220519,143,63,80,157.0,123.8,140.3
140,东北虎林园,20220520,165,70,95,143.0,139.6,142.4
141,东北虎林园,20220521,157,64,93,165.0,141.8,143.5
142,东北虎林园,20220522,158,63,95,157.0,156.0,143.9
143,东北虎林园,20220523,168,64,104,158.0,158.2,143.4
144,东北虎林园,20220524,154,63,91,168.0,160.4,142.1
145,东北虎林园,20220525,151,64,87,154.0,157.6,148.6
146,东北虎林园,20220526,154,61,93,151.0,157.0,149.4
147,东北虎林园,20220527,140,64,76,154.0,153.4,154.7
148,东北虎林园,20220528,92,0,92,140.0,138.2,148.2
149,东北虎林园,20220529,156,61,95,92.0,138.6,149.5
150,东北虎林园,20220530,163,61,102,156.0,141.0,149.3
151,东北虎林园,20220531,181,64,117,163.0,146.4,151.7
152,东北虎林园,20220601,190,59,131,181.0,156.4,154.9
153,东北虎林园,20220602,192,66,126,190.0,176.4,157.3
154,东北虎林园,20220603,186,0,186,192.0,182.4,160.5
155,东北虎林园,20220604,218,63,155,186.0,193.4,167.2
156,东北虎林园,20220605,169,64,105,218.0,191.0,168.7
157,东北虎林园,20220606,180,63,117,169.0,189.0,172.7
158,东北虎林园,20220607,170,68,102,180.0,184.6,180.5
159,东北虎林园,20220608,164,68,96,170.0,180.2,181.3
160,东北虎林园,20220609,167,63,104,164.0,170.0,181.7
161,东北虎林园,20220610,168,66,102,167.0,169.8,180.4
162,东北虎林园,20220611,173,61,112,168.0,168.4,178.7
163,东北虎林园,20220612,168,68,100,173.0,168.0,176.3
164,东北虎林园,20220613,170,61,109,168.0,169.2,174.7
165,东北虎林园,20220614,170,64,106,170.0,169.8,169.9
166,东北虎林园,20220615,162,63,99,170.0,168.6,169.2
167,东北虎林园,20220616,169,61,108,162.0,167.8,168.1
168,东北虎林园,20220617,176,63,113,169.0,169.4,168.7
169,东北虎林园,20220618,244,64,180,176.0,184.2,176.7
170,东北虎林园,20220619,195,61,134,244.0,189.2,179.5
171,东北虎林园,20220620,186,63,123,195.0,194.0,181.3
172,东北虎林园,20220621,170,66,104,186.0,194.2,181.0
173,东北虎林园,20220622,175,66,109,170.0,194.0,181.7
174,东北虎林园,20220623,178,68,110,175.0,180.8,182.5
175,东北虎林园,20220624,187,74,113,178.0,179.2,184.2
176,东北虎林园,20220625,186,61,125,187.0,179.2,186.6
177,东北虎林园,20220626,185,59,126,186.0,182.2,188.2
178,东北虎林园,20220627,185,63,122,185.0,184.2,189.1
179,东北虎林园,20220628,203,82,121,185.0,189.2,185.0
180,东北虎林园,20220629,185,70,115,203.0,188.8,184.0
181,东北虎林园,20220630,199,80,119,185.0,191.4,185.3
182,东北虎林园,20220701,181,63,118,199.0,190.6,186.4
183,东北虎林园,20220702,191,66,125,181.0,191.8,188.0
184,东北虎林园,20220703,190,59,131,191.0,189.2,189.2
185,东北虎林园,20220704,197,63,134,190.0,191.6,190.2
186,东北虎林园,20220705,194,64,130,197.0,190.6,191.0
187,东北虎林园,20220706,205,70,135,194.0,195.4,193.0
188,东北虎林园,20220707,197,76,121,205.0,196.6,194.2
189,东北虎林园,20220708,220,76,144,197.0,202.6,195.9
190,东北虎林园,20220709,240,61,179,220.0,211.2,201.4
191,东北虎林园,20220710,202,61,141,240.0,212.8,201.7
192,东北虎林园,20220711,215,74,141,202.0,214.8,205.1
193,东北虎林园,20220712,212,61,151,215.0,217.8,207.2
194,东北虎林园,20220713,195,74,121,212.0,212.8,207.7
195,东北虎林园,20220714,191,70,121,195.0,203.0,207.1
196,东北虎林园,20220715,221,66,155,191.0,206.8,209.8
197,东北虎林园,20220716,232,70,162,221.0,210.2,212.5
198,东北虎林园,20220717,264,68,196,232.0,220.6,219.2
199,东北虎林园,20220718,210,66,144,264.0,223.6,218.2
200,东北虎林园,20220719,208,64,144,210.0,227.0,215.0
201,东北虎林园,20220720,246,66,180,208.0,232.0,219.4
202,东北虎林园,20220721,208,76,132,246.0,227.2,218.7
203,东北虎林园,20220722,209,74,135,208.0,216.2,218.4
204,东北虎林园,20220723,242,63,179,209.0,222.6,223.1
205,东北虎林园,20220724,216,59,157,242.0,224.2,225.6
206,东北虎林园,20220725,229,70,159,216.0,220.8,226.4
207,东北虎林园,20220726,227,70,157,229.0,224.6,225.9
208,东北虎林园,20220727,244,78,166,227.0,231.6,223.9
209,东北虎林园,20220728,246,76,170,244.0,232.4,227.5
210,东北虎林园,20220729,290,78,212,246.0,247.2,235.7
211,东北虎林园,20220730,322,72,250,290.0,265.8,243.3
212,东北虎林园,20220731,281,72,209,322.0,276.6,250.6
213,东北虎林园,20220801,267,74,193,281.0,281.2,256.4
214,东北虎林园,20220802,236,66,170,267.0,279.2,255.8
215,东北虎林园,20220803,237,72,165,236.0,268.6,257.9
216,东北虎林园,20220804,265,66,199,237.0,257.2,261.5
217,东北虎林园,20220805,301,76,225,265.0,261.2,268.9
218,东北虎林园,20220806,287,68,219,301.0,265.2,273.2
219,东北虎林园,20220807,278,59,219,287.0,273.6,276.4
220,东北虎林园,20220808,282,80,202,278.0,282.6,275.6
221,东北虎林园,20220809,255,68,187,282.0,280.6,268.9
222,东北虎林园,20220810,249,64,185,255.0,270.2,265.7
223,东北虎林园,20220811,249,83,166,249.0,262.6,263.9
224,东北虎林园,20220812,231,66,165,249.0,253.2,263.4
225,东北虎林园,20220813,263,64,199,231.0,249.4,266.0
226,东北虎林园,20220814,254,68,186,263.0,249.2,264.9
227,东北虎林园,20220815,240,70,170,254.0,247.4,258.8
228,东北虎林园,20220816,253,80,173,240.0,248.2,255.4
229,东北虎林园,20220817,273,87,186,253.0,256.6,254.9
230,东北虎林园,20220818,249,72,177,273.0,253.8,251.6
231,东北虎林园,20220819,211,68,143,249.0,245.2,247.2
232,东北虎林园,20220820,284,76,208,211.0,254.0,250.7
233,东北虎林园,20220821,238,64,174,284.0,251.0,249.6
234,东北虎林园,20220822,186,63,123,238.0,233.6,245.1
235,东北虎林园,20220823,211,66,145,186.0,226.0,239.9
236,东北虎林园,20220824,218,61,157,211.0,227.4,236.3
237,东北虎林园,20220825,230,70,160,218.0,216.6,235.3
238,东北虎林园,20220826,234,76,158,230.0,215.8,233.4
239,东北虎林园,20220827,229,61,168,234.0,224.4,229.0
240,东北虎林园,20220828,206,61,145,229.0,223.4,224.7
241,东北虎林园,20220829,179,70,109,206.0,215.6,221.5
242,东北虎林园,20220830,186,68,118,179.0,206.8,211.7
243,东北虎林园,20220831,172,72,100,186.0,194.4,205.1
244,东北虎林园,20220901,156,63,93,172.0,179.8,202.1
245,东北虎林园,20220902,152,70,82,156.0,169.0,196.2
246,东北虎林园,20220903,159,63,96,152.0,165.0,190.3
247,东北虎林园,20220904,146,59,87,159.0,157.0,181.9
248,东北虎林园,20220905,163,63,100,146.0,155.2,174.8
249,东北虎林园,20220906,148,61,87,163.0,153.6,166.7
250,东北虎林园,20220907,153,66,87,148.0,153.8,161.4
251,东北虎林园,20220908,158,61,97,153.0,153.6,159.3
252,东北虎林园,20220909,186,61,125,158.0,161.6,159.3
253,东北虎林园,20220910,192,70,122,186.0,167.4,161.3
254,东北虎林园,20220911,197,59,138,192.0,177.2,165.4
255,东北虎林园,20220912,194,64,130,197.0,185.4,169.6
256,东北虎林园,20220913,182,59,123,194.0,190.2,171.9
257,东北虎林园,20220914,167,61,106,182.0,186.4,174.0
258,东北虎林园,20220915,147,61,86,167.0,177.4,172.4
259,东北虎林园,20220916,168,64,104,147.0,171.6,174.4
260,东北虎林园,20220917,184,59,125,168.0,169.6,177.5
261,东北虎林园,20220918,176,64,112,184.0,168.4,179.3
262,东北虎林园,20220919,143,59,84,176.0,163.6,175.0
263,东北虎林园,20220920,141,59,82,143.0,162.4,169.9
264,东北虎林园,20220921,165,66,99,141.0,161.8,166.7
265,东北虎林园,20220922,162,70,92,165.0,157.4,163.5
266,东北虎林园,20220923,150,66,84,162.0,152.2,160.3
267,东北虎林园,20220924,99,0,99,150.0,143.4,153.5
268,东北虎林园,20220925,100,0,100,99.0,135.2,148.8
269,东北虎林园,20220926,155,64,91,100.0,133.2,147.5
270,东北虎林园,20220927,144,61,83,155.0,129.6,143.5
271,东北虎林园,20220928,143,59,84,144.0,128.2,140.2
272,东北虎林园,20220929,147,61,86,143.0,137.8,140.6
273,东北虎林园,20220930,174,68,106,147.0,152.6,143.9
274,东北虎林园,20221001,182,61,121,174.0,158.0,145.6
275,东北虎林园,20221002,151,0,151,182.0,159.4,144.5
276,东北虎林园,20221003,191,72,119,151.0,169.0,148.6
277,东北虎林园,20221004,138,0,138,191.0,167.2,152.5
278,东北虎林园,20221005,126,0,126,138.0,157.6,155.1
279,东北虎林园,20221006,108,0,108,126.0,142.8,150.4
280,东北虎林园,20221007,106,0,106,108.0,133.8,146.6
281,东北虎林园,20221008,139,70,69,106.0,123.4,146.2
282,东北虎林园,20221009,145,72,73,139.0,124.8,146.0
283,东北虎林园,20221010,150,59,91,145.0,129.6,143.6
284,东北虎林园,20221011,145,59,86,150.0,137.0,139.9
285,东北虎林园,20221012,163,72,91,145.0,148.4,141.1
286,东北虎林园,20221013,162,70,92,163.0,153.0,138.2
287,东北虎林园,20221014,139,59,80,162.0,151.8,138.3
288,东北虎林园,20221015,91,0,91,139.0,140.0,134.8
289,东北虎林园,20221016,87,0,87,91.0,128.4,132.7
290,东北虎林园,20221017,143,70,73,87.0,124.4,136.4
291,东北虎林园,20221018,163,66,97,143.0,124.6,138.8
292,东北虎林园,20221019,160,74,86,163.0,128.8,140.3
293,东北虎林园,20221020,158,66,92,160.0,142.2,141.1
294,东北虎林园,20221021,89,0,89,158.0,142.6,135.5
295,东北虎林园,20221022,159,59,100,89.0,145.8,135.1
296,东北虎林园,20221023,163,59,104,159.0,145.8,135.2
297,东北虎林园,20221024,91,0,91,163.0,132.0,130.4
298,东北虎林园,20221025,167,70,97,91.0,133.8,138.0
299,东北虎林园,20221026,148,61,87,167.0,145.6,144.1
300,东北虎林园,20221027,163,76,87,148.0,146.4,146.1
301,东北虎林园,20221028,150,59,91,163.0,143.8,144.8
302,东北虎林园,20221029,102,0,102,150.0,146.0,139.0
303,东北虎林园,20221030,82,0,82,102.0,129.0,131.4
304,东北虎林园,20221031,129,63,66,82.0,125.2,135.4
305,东北虎林园,20221101,147,61,86,129.0,122.0,134.2
306,东北虎林园,20221102,145,66,79,147.0,121.0,132.4
307,东北虎林园,20221103,131,61,70,145.0,126.8,136.4
308,东北虎林园,20221104,154,63,91,131.0,141.2,135.1
309,东北虎林园,20221105,151,59,92,154.0,145.6,135.4
310,东北虎林园,20221106,141,61,80,151.0,144.4,133.2
311,东北虎林园,20221107,141,63,78,141.0,143.6,132.3
312,东北虎林园,20221108,159,64,95,141.0,149.2,138.0
313,东北虎林园,20221109,161,64,97,159.0,150.6,145.9
314,东北虎林园,20221110,155,64,91,161.0,151.4,148.5
315,东北虎林园,20221111,151,72,79,155.0,153.4,148.9
316,东北虎林园,20221112,92,0,92,151.0,143.6,143.6
317,东北虎林园,20221113,151,59,92,92.0,142.0,145.6
318,东北虎林园,20221114,150,64,86,151.0,139.8,145.2
319,东北虎林园,20221115,132,59,73,150.0,135.2,143.3
320,东北虎林园,20221116,148,59,89,132.0,134.6,144.0
321,东北虎林园,20221117,157,64,93,148.0,147.6,145.6
322,东北虎林园,20221118,152,61,91,157.0,147.8,144.9
323,东北虎林园,20221119,163,61,102,152.0,150.4,145.1
324,东北虎林园,20221120,147,63,84,163.0,153.4,144.3
325,东北虎林园,20221121,150,61,89,147.0,153.8,144.2
326,东北虎林园,20221122,146,68,78,150.0,151.6,149.6
327,东北虎林园,20221123,76,0,76,146.0,136.4,142.1
328,东北虎林园,20221124,152,66,86,76.0,134.2,142.3
329,东北虎林园,20221125,148,66,82,152.0,134.4,143.9
330,东北虎林园,20221126,148,68,80,148.0,134.0,143.9
331,东北虎林园,20221127,145,61,84,148.0,133.8,142.7
332,东北虎林园,20221128,140,66,74,145.0,146.6,141.5
333,东北虎林园,20221129,150,63,87,140.0,146.2,140.2
334,东北虎林园,20221130,141,61,80,150.0,144.8,139.6
335,东北虎林园,20221201,161,66,95,141.0,147.4,140.7
336,东北虎林园,20221202,165,63,102,161.0,151.4,142.6
337,东北虎林园,20221203,80,0,80,165.0,139.4,143.0
338,东北虎林园,20221204,133,59,74,80.0,136.0,141.1
339,东北虎林园,20221205,147,61,86,133.0,137.2,141.0
340,东北虎林园,20221206,156,72,84,147.0,136.2,141.8
341,东北虎林园,20221207,150,64,86,156.0,133.2,142.3
342,东北虎林园,20221208,109,0,109,150.0,139.0,139.2
343,东北虎林园,20221209,158,66,92,109.0,144.0,140.0
344,东北虎林园,20221210,141,63,78,158.0,142.8,140.0
345,东北虎林园,20221211,155,63,92,141.0,142.6,139.4
346,东北虎林园,20221212,78,0,78,155.0,128.2,130.7
347,东北虎林园,20221213,145,61,84,78.0,135.4,137.2
348,东北虎林园,20221214,126,61,65,145.0,129.0,136.5
349,东北虎林园,20221215,150,59,91,126.0,130.8,136.8
350,东北虎林园,20221216,154,59,95,150.0,130.6,136.6
351,东北虎林园,20221217,97,0,97,154.0,134.4,131.3
352,东北虎林园,20221218,159,66,93,97.0,137.2,136.3
353,东北虎林园,20221219,174,64,110,159.0,146.8,137.9
354,东北虎林园,20221220,148,68,80,174.0,146.4,138.6
355,东北虎林园,20221221,149,66,83,148.0,145.4,138.0
356,东北虎林园,20221222,148,68,80,149.0,155.6,145.0
357,东北虎林园,20221223,141,61,80,148.0,152.0,144.6
358,东北虎林园,20221224,149,63,86,141.0,147.0,146.9
359,东北虎林园,20221225,151,59,92,149.0,147.6,147.0
360,东北虎林园,20221226,139,63,76,151.0,145.6,145.5
361,东北虎林园,20221227,149,63,86,139.0,145.8,150.7
362,东北虎林园,20221228,87,0,87,149.0,135.0,143.5
363,东北虎林园,20221229,152,66,86,87.0,135.6,141.3
364,东北虎林园,20221230,154,68,86,152.0,136.2,141.9
365,东北虎林园,20221231,140,61,79,154.0,136.4,141.0
366,东北虎林园,20230101,104,0,104,140.0,127.4,136.6
367,东北虎林园,20230102,157,61,96,104.0,141.4,138.2
368,东北虎林园,20230103,157,61,96,157.0,142.4,139.0
369,东北虎林园,20230104,177,80,97,157.0,147.0,141.6
370,东北虎林园,20230105,167,70,97,177.0,152.4,144.4
371,东北虎林园,20230106,194,82,112,167.0,170.4,148.9
372,东北虎林园,20230107,347,78,269,194.0,208.4,174.9
373,东北虎林园,20230108,297,76,221,347.0,236.4,189.4
374,东北虎林园,20230109,232,70,162,297.0,247.4,197.2
375,东北虎林园,20230110,233,78,155,232.0,260.6,206.5
376,东北虎林园,20230111,225,68,157,233.0,266.8,218.6
377,东北虎林园,20230112,192,61,131,225.0,235.8,222.1
378,东北虎林园,20230113,214,78,136,192.0,219.2,227.8
379,东北虎林园,20230114,227,72,155,214.0,218.2,232.8
380,东北虎林园,20230115,238,68,170,227.0,219.2,239.9
381,东北虎林园,20230116,208,72,136,238.0,215.8,241.3
382,东北虎林园,20230117,181,64,117,208.0,213.6,224.7
383,东北虎林园,20230118,199,64,135,181.0,210.6,214.9
384,东北虎林园,20230119,196,64,132,199.0,204.4,211.3
385,东北虎林园,20230120,189,66,123,196.0,194.6,206.9
386,东北虎林园,20230121,92,0,92,189.0,171.4,193.6
387,东北虎林园,20230122,183,61,122,92.0,171.8,192.7
388,东北虎林园,20230123,245,63,182,183.0,181.0,195.8
389,东北虎林园,20230124,199,61,138,245.0,181.6,193.0
390,东北虎林园,20230125,225,63,162,199.0,188.8,191.7
391,东北虎林园,20230126,248,66,182,225.0,220.0,195.7
392,东北虎林园,20230127,210,61,149,248.0,225.4,198.6
393,东北虎林园,20230128,228,70,158,210.0,222.0,201.5
394,东北虎林园,20230129,174,0,174,228.0,217.0,199.3
395,东北虎林园,20230130,208,63,145,174.0,213.6,201.2
396,东北虎林园,20230131,230,70,160,208.0,210.0,215.0
397,东北虎林园,20230201,224,64,160,230.0,212.8,219.1
398,东北虎林园,20230202,210,66,144,224.0,209.2,215.6
399,东北虎林园,20230203,199,63,136,210.0,214.2,215.6
400,东北虎林园,20230204,203,59,144,199.0,213.2,213.4
401,东北虎林园,20230205,184,61,123,203.0,204.0,207.0
402,东北虎林园,20230206,215,83,132,184.0,202.2,207.5
403,东北虎林园,20230207,169,59,110,215.0,194.0,201.6
404,东北虎林园,20230208,217,76,141,169.0,197.6,205.9
405,东北虎林园,20230209,200,68,132,217.0,197.0,205.1
406,东北虎林园,20230210,185,63,122,200.0,197.2,200.6
407,东北虎林园,20230211,148,0,148,185.0,183.8,193.0
408,东北虎林园,20230212,210,59,151,148.0,192.0,193.0
409,东北虎林园,20230213,171,66,105,210.0,182.8,190.2
410,东北虎林园,20230214,192,74,118,171.0,181.2,189.1
411,东北虎林园,20230215,195,74,121,192.0,183.2,190.2
412,东北虎林园,20230216,211,72,139,195.0,195.8,189.8
413,东北虎林园,20230217,187,64,123,211.0,191.2,191.6
414,东北虎林园,20230218,206,70,136,187.0,198.2,190.5
415,东北虎林园,20230219,189,59,130,206.0,197.6,189.4
416,东北虎林园,20230220,172,63,109,189.0,193.0,188.1
417,东北虎林园,20230221,194,76,118,172.0,189.6,192.7
418,东北虎林园,20230222,176,63,113,194.0,187.4,189.3
419,东北虎林园,20230223,172,72,100,176.0,180.6,189.4
420,东北虎林园,20230224,197,66,131,172.0,182.2,189.9
421,东北虎林园,20230225,174,59,115,197.0,182.6,187.8
422,东北虎林园,20230226,207,66,141,174.0,185.2,187.4
423,东北虎林园,20230227,171,76,95,207.0,184.2,185.8
424,东北虎林园,20230228,189,63,126,171.0,187.6,184.1
425,东北虎林园,20230301,191,63,128,189.0,186.4,184.3
426,东北虎林园,20230302,193,68,125,191.0,190.2,186.4
427,东北虎林园,20230303,201,78,123,193.0,189.0,187.1
428,东北虎林园,20230304,265,64,201,201.0,207.8,196.0
429,东北虎林园,20230305,230,64,166,265.0,216.0,201.8
430,东北虎林园,20230306,223,72,151,230.0,222.4,204.4
431,东北虎林园,20230307,251,74,177,223.0,234.0,212.1
432,东北虎林园,20230308,265,70,195,251.0,246.8,217.9
433,东北虎林园,20230309,215,66,149,265.0,236.8,222.3
434,东北虎林园,20230310,314,72,242,215.0,253.6,234.8
435,东北虎林园,20230311,594,82,512,314.0,327.8,275.1
436,东北虎林园,20230312,500,78,422,594.0,377.6,305.8
437,东北虎林园,20230313,394,85,309,500.0,403.4,325.1
438,东北虎林园,20230314,316,68,248,394.0,423.6,330.2
439,东北虎林园,20230315,332,80,252,316.0,427.2,340.4
440,东北虎林园,20230316,291,72,219,332.0,366.6,347.2
441,东北虎林园,20230317,283,72,211,291.0,323.2,350.4
442,东北虎林园,20230318,324,64,260,283.0,309.2,356.3
443,东北虎林园,20230319,336,72,264,324.0,313.2,368.4
444,东北虎林园,20230320,258,68,190,336.0,298.4,362.8
445,东北虎林园,20230321,270,85,185,258.0,294.2,330.4
446,东北虎林园,20230322,266,87,179,270.0,290.8,307.0
447,东北虎林园,20230323,250,72,178,266.0,276.0,292.6
448,东北虎林园,20230324,269,72,197,250.0,262.6,287.9
449,东北虎林园,20230325,286,61,225,269.0,268.2,283.3
450,东北虎林园,20230326,274,66,208,286.0,269.0,281.6
451,东北虎林园,20230327,273,74,199,274.0,270.4,280.6
452,东北虎林园,20230328,238,72,166,273.0,268.0,272.0
453,东北虎林园,20230329,240,63,177,238.0,262.2,262.4
454,东北虎林园,20230330,269,70,199,240.0,258.8,263.5
455,东北虎林园,20230331,267,78,189,269.0,257.4,263.2
456,东北虎林园,20230401,269,61,208,267.0,256.6,263.5
457,东北虎林园,20230402,310,64,246,269.0,271.0,269.5
458,东北虎林园,20230403,259,70,189,310.0,274.8,268.5
459,东北虎林园,20230404,279,64,215,259.0,276.8,267.8
460,东北虎林园,20230405,298,70,228,279.0,283.0,270.2
461,东北虎林园,20230406,253,76,177,298.0,279.8,268.2
462,东北虎林园,20230407,264,80,184,253.0,270.6,270.8
463,东北虎林园,20230408,251,61,190,264.0,269.0,271.9
464,东北虎林园,20230409,265,72,193,251.0,266.2,271.5
465,东北虎林园,20230410,202,72,130,265.0,247.0,265.0
466,东北虎林园,20230411,230,76,154,202.0,242.4,261.1
467,东北虎林园,20230412,204,72,132,230.0,230.4,250.5
468,东北虎林园,20230413,221,66,155,204.0,224.4,246.7
469,东北虎林园,20230414,242,68,174,221.0,219.8,243.0
470,东北虎林园,20230415,259,66,193,242.0,231.2,239.1
471,东北虎林园,20230416,174,0,174,259.0,220.0,231.2
472,东北虎林园,20230417,246,72,174,174.0,228.4,229.4
473,东北虎林园,20230418,236,70,166,246.0,231.4,227.9
474,东北虎林园,20230419,247,82,165,236.0,232.4,226.1
475,东北虎林园,20230420,247,85,162,247.0,230.0,230.6
476,东北虎林园,20230421,277,85,192,247.0,250.6,235.3
477,东北虎林园,20230422,252,74,178,277.0,251.8,240.1
478,东北虎林园,20230423,222,70,152,252.0,249.0,240.2
479,东北虎林园,20230424,279,80,199,222.0,255.4,243.9
480,东北虎林园,20230425,259,78,181,279.0,257.8,243.9
481,东北虎林园,20230426,283,80,203,259.0,259.0,254.8
482,东北虎林园,20230427,283,66,217,283.0,265.2,258.5
483,东北虎林园,20230428,362,82,280,283.0,293.2,271.1
484,东北虎林园,20230429,459,68,391,362.0,329.2,292.3
485,东北虎林园,20230430,627,74,553,459.0,402.8,330.3
486,东北虎林园,20230501,831,66,765,627.0,512.4,385.7
487,东北虎林园,20230502,550,63,487,831.0,565.8,415.5
488,东北虎林园,20230503,351,83,268,550.0,563.6,428.4
489,东北虎林园,20230504,260,80,180,351.0,523.8,426.5
490,东北虎林园,20230505,222,70,152,260.0,442.8,422.8
491,东北虎林园,20230506,249,72,177,222.0,326.4,419.4
492,东北虎林园,20230507,249,59,190,249.0,266.2,416.0
493,东北虎林园,20230508,191,72,119,249.0,234.2,398.9
494,东北虎林园,20230509,223,66,157,191.0,226.8,375.3
495,东北虎林园,20230510,221,70,151,223.0,226.6,334.7
496,东北虎林园,20230511,215,74,141,221.0,219.8,273.1
497,东北虎林园,20230512,192,70,122,215.0,208.4,237.3
498,东北虎林园,20230513,231,61,170,192.0,216.4,225.3
499,东北虎林园,20230514,240,59,181,231.0,219.8,223.3
500,东北虎林园,20230515,206,78,128,240.0,216.8,221.7
501,东北虎林园,20230516,197,74,123,206.0,213.2,216.5
502,东北虎林园,20230517,211,68,143,197.0,217.0,212.7
503,东北虎林园,20230518,204,70,134,211.0,211.6,214.0
504,东北虎林园,20230519,198,64,134,204.0,203.2,211.5
505,东北虎林园,20230520,204,61,143,198.0,202.8,209.8
506,东北虎林园,20230521,211,59,152,204.0,205.6,209.4
507,东北虎林园,20230522,210,66,144,211.0,205.4,211.2
508,东北虎林园,20230523,213,59,154,210.0,207.2,209.4
509,东北虎林园,20230524,222,78,144,213.0,212.0,207.6
510,东北虎林园,20230525,211,80,131,222.0,213.4,208.1
511,东北虎林园,20230526,187,70,117,211.0,208.6,207.1
512,东北虎林园,20230527,214,63,151,187.0,209.4,207.4
513,东北虎林园,20230528,151,0,151,214.0,197.0,202.1
514,东北虎林园,20230529,217,66,151,151.0,196.0,204.0
515,东北虎林园,20230530,200,74,126,217.0,193.8,203.6
516,东北虎林园,20230531,215,72,143,200.0,199.4,204.0
517,东北虎林园,20230601,202,64,138,215.0,197.0,203.2
518,东北虎林园,20230602,216,91,125,202.0,210.0,203.5
519,东北虎林园,20230603,214,63,151,216.0,209.4,202.7
520,东北虎林园,20230604,218,59,159,214.0,213.0,203.4
521,东北虎林园,20230605,188,78,110,218.0,207.6,203.5
522,东北虎林园,20230606,211,66,145,188.0,209.4,203.2
523,东北虎林园,20230607,207,66,141,211.0,207.6,208.8
524,东北虎林园,20230608,222,78,144,207.0,209.2,209.3
525,东北虎林园,20230609,219,70,149,222.0,209.4,211.2
526,东北虎林园,20230610,238,74,164,219.0,219.4,213.5
527,东北虎林园,20230611,212,61,151,238.0,219.6,214.5
528,东北虎林园,20230612,238,72,166,212.0,225.8,216.7
529,东北虎林园,20230613,251,89,162,238.0,231.6,220.4
530,东北虎林园,20230614,222,78,144,251.0,232.2,220.8
531,东北虎林园,20230615,228,70,158,222.0,230.2,224.8
532,东北虎林园,20230616,204,72,132,228.0,228.6,224.1
533,东北虎林园,20230617,205,64,141,204.0,222.0,223.9
534,东北虎林园,20230618,223,61,162,205.0,216.4,224.0
535,东北虎林园,20230619,200,64,136,223.0,212.0,222.1
536,东北虎林园,20230620,222,78,144,200.0,210.8,220.5
537,东北虎林园,20230621,254,80,174,222.0,220.8,224.7
538,东北虎林园,20230622,280,74,206,254.0,235.8,228.9
539,东北虎林园,20230623,251,66,185,280.0,241.4,228.9
540,东北虎林园,20230624,225,61,164,251.0,246.4,229.2
541,东北虎林园,20230625,228,76,152,225.0,247.6,229.2
542,东北虎林园,20230626,227,82,145,228.0,242.2,231.5
543,东北虎林园,20230627,243,76,167,227.0,234.8,235.3
544,东北虎林园,20230628,223,74,149,243.0,229.2,235.3
545,东北虎林园,20230629,232,80,152,223.0,230.6,238.5
546,东北虎林园,20230630,242,66,176,232.0,233.4,240.5
547,东北虎林园,20230701,236,70,166,242.0,235.2,238.7
548,东北虎林园,20230702,233,63,170,236.0,233.2,234.0
549,东北虎林园,20230703,231,70,161,233.0,234.8,232.0
550,东北虎林园,20230704,258,85,173,231.0,240.0,235.3
551,东北虎林园,20230705,229,85,144,258.0,237.4,235.4
552,东北虎林园,20230706,253,83,170,229.0,240.8,238.0
553,东北虎林园,20230707,267,78,189,253.0,247.6,240.4
554,东北虎林园,20230708,283,74,209,267.0,258.0,246.4
555,东北虎林园,20230709,274,66,208,283.0,261.2,250.6
556,东北虎林园,20230710,288,76,212,274.0,273.0,255.2
557,东北虎林园,20230711,278,66,212,288.0,278.0,259.4
558,东北虎林园,20230712,281,76,205,278.0,280.8,264.2
559,东北虎林园,20230713,289,74,215,281.0,282.0,270.0
560,东北虎林园,20230714,251,72,179,289.0,277.4,269.3
561,东北虎林园,20230715,261,76,185,251.0,272.0,272.5
562,东北虎林园,20230716,296,74,222,261.0,275.6,276.8
563,东北虎林园,20230717,311,87,224,296.0,281.6,281.2
564,东北虎林园,20230718,310,82,228,311.0,285.8,283.9
565,东北虎林园,20230719,300,83,217,310.0,295.6,286.5
566,东北虎林园,20230720,278,78,200,300.0,299.0,285.5
567,东北虎林园,20230721,342,97,245,278.0,308.2,291.9
568,东北虎林园,20230722,343,72,271,342.0,314.6,298.1
569,东北虎林园,20230723,345,68,277,343.0,321.6,303.7
570,东北虎林园,20230724,325,91,234,345.0,326.6,311.1
571,东北虎林园,20230725,358,83,275,325.0,342.6,320.8
572,东北虎林园,20230726,383,85,298,358.0,350.8,329.5
573,东北虎林园,20230727,363,83,280,383.0,354.8,334.7
574,东北虎林园,20230728,337,80,257,363.0,353.2,337.4
575,东北虎林园,20230729,418,72,346,337.0,371.8,349.2
576,东北虎林园,20230730,424,72,352,418.0,385.0,363.8
577,东北虎林园,20230731,382,82,300,424.0,384.8,367.8
578,东北虎林园,20230801,366,74,292,382.0,385.4,370.1
579,东北虎林园,20230802,306,97,209,366.0,379.2,366.2
580,东北虎林园,20230803,352,78,274,306.0,366.0,368.9
581,东北虎林园,20230804,360,72,288,352.0,353.2,369.1
582,东北虎林园,20230805,373,70,303,360.0,351.4,368.1
583,东北虎林园,20230806,400,80,320,373.0,358.2,371.8
584,东北虎林园,20230807,385,93,292,400.0,374.0,376.6
585,东北虎林园,20230808,334,82,252,385.0,370.4,368.2
586,东北虎林园,20230809,331,72,259,334.0,364.6,358.9
587,东北虎林园,20230810,306,72,234,331.0,351.2,351.3
588,东北虎林园,20230811,280,66,214,306.0,327.2,342.7
589,东北虎林园,20230812,315,80,235,280.0,313.2,343.6
590,东北虎林园,20230813,297,72,225,315.0,305.8,338.1
591,东北虎林园,20230814,331,76,255,297.0,305.8,335.2
592,东北虎林园,20230815,308,74,234,331.0,306.2,328.7
593,东北虎林园,20230816,343,97,246,308.0,318.8,323.0
594,东北虎林园,20230817,285,76,209,343.0,312.8,313.0
595,东北虎林园,20230818,299,85,214,285.0,313.2,309.5
596,东北虎林园,20230819,349,74,275,299.0,316.8,311.3
597,东北虎林园,20230820,271,70,201,349.0,309.4,307.8
598,东北虎林园,20230821,289,97,192,271.0,298.6,308.7
599,东北虎林园,20230822,256,66,190,289.0,292.8,302.8
600,东北虎林园,20230823,267,74,193,256.0,286.4,299.8
601,东北虎林园,20230824,273,72,201,267.0,271.2,294.0
602,东北虎林园,20230825,285,70,215,273.0,274.0,291.7
603,东北虎林园,20230826,278,70,208,285.0,271.8,285.2
604,东北虎林园,20230827,284,76,208,278.0,277.4,285.1
605,东北虎林园,20230828,245,74,171,284.0,273.0,279.7
606,东北虎林园,20230829,245,80,165,245.0,267.4,269.3
607,东北虎林园,20230830,250,68,182,245.0,260.4,267.2
608,东北虎林园,20230831,266,74,192,250.0,258.0,264.9
609,东北虎林园,20230901,241,64,177,266.0,249.4,263.4
610,东北虎林园,20230902,227,72,155,241.0,245.8,259.4
611,东北虎林园,20230903,224,61,163,227.0,241.6,254.5
612,东北虎林园,20230904,223,82,141,224.0,236.2,248.3
613,东北虎林园,20230905,215,80,135,223.0,226.0,242.0
614,东北虎林园,20230906,201,78,123,215.0,218.0,233.7
615,东北虎林园,20230907,199,74,125,201.0,212.4,229.1
616,东北虎林园,20230908,232,83,149,199.0,214.0,227.8
617,东北虎林园,20230909,213,59,154,232.0,212.0,224.1
618,东北虎林园,20230910,219,70,149,213.0,212.8,219.4
619,东北虎林园,20230911,207,85,122,219.0,214.0,216.0
620,东北虎林园,20230912,226,91,135,207.0,219.4,215.9
621,东北虎林园,20230913,238,83,155,226.0,220.6,217.3
622,东北虎林园,20230914,225,74,151,238.0,223.0,217.5
623,东北虎林园,20230915,226,83,143,225.0,224.4,218.6
624,东北虎林园,20230916,236,66,170,226.0,230.2,222.1
625,东北虎林园,20230917,247,66,181,236.0,234.4,226.9
626,东北虎林园,20230918,219,78,141,247.0,230.6,225.6
627,东北虎林园,20230919,199,91,108,219.0,225.4,224.2
628,东北虎林园,20230920,214,80,134,199.0,223.0,223.7
629,东北虎林园,20230921,227,89,138,214.0,221.2,225.7
630,东北虎林园,20230922,229,80,149,227.0,217.6,226.0
631,东北虎林园,20230923,203,59,144,229.0,214.4,222.5
632,东北虎林园,20230924,217,63,154,203.0,218.0,221.7
633,东北虎林园,20230925,223,82,141,217.0,219.8,221.4
634,东北虎林园,20230926,202,72,130,223.0,214.8,218.0
635,东北虎林园,20230927,218,80,138,202.0,212.6,215.1
636,东北虎林园,20230928,268,89,179,218.0,225.6,220.0
637,东北虎林园,20230929,284,63,221,268.0,239.0,228.5
638,东北虎林园,20230930,368,76,292,284.0,268.0,243.9
639,东北虎林园,20231001,436,63,373,368.0,314.8,264.8
640,东北虎林园,20231002,423,64,359,436.0,355.8,284.2
641,东北虎林园,20231003,398,68,330,423.0,381.8,303.7
642,东北虎林园,20231004,371,68,303,398.0,399.2,319.1
643,东北虎林园,20231005,293,59,234,371.0,384.2,326.1
644,东北虎林园,20231006,271,82,189,293.0,351.2,333.0
645,东北虎林园,20231007,193,74,119,271.0,305.2,330.5
646,东北虎林园,20231008,211,76,135,193.0,267.8,324.8
647,东北虎林园,20231009,201,80,121,211.0,233.8,316.5
648,东北虎林园,20231010,205,83,122,201.0,216.2,300.2
649,东北虎林园,20231011,200,82,118,205.0,202.0,276.6
650,东北虎林园,20231012,217,83,134,200.0,206.8,256.0
651,东北虎林园,20231013,206,72,134,217.0,205.8,236.8
652,东北虎林园,20231014,214,66,148,206.0,208.4,221.1
653,东北虎林园,20231015,211,68,143,214.0,209.6,212.9
654,东北虎林园,20231016,180,70,110,211.0,205.6,203.8
655,东北虎林园,20231017,191,82,109,180.0,200.4,203.6
656,东北虎林园,20231018,191,78,113,191.0,197.4,201.6
657,东北虎林园,20231019,176,74,102,191.0,189.8,199.1
658,东北虎林园,20231020,189,85,104,176.0,185.4,197.5
659,东北虎林园,20231021,172,59,113,189.0,183.8,194.7
660,东北虎林园,20231022,206,70,136,172.0,186.8,193.6
661,东北虎林园,20231023,191,87,104,206.0,186.8,192.1
662,东北虎林园,20231024,173,82,91,191.0,186.2,188.0
663,东北虎林园,20231025,184,72,112,173.0,185.2,185.3
664,东北虎林园,20231026,171,80,91,184.0,185.0,184.4
665,东北虎林园,20231027,194,95,99,171.0,182.6,184.7
666,东北虎林园,20231028,189,61,128,194.0,182.2,184.5
667,东北虎林园,20231029,181,63,118,189.0,183.8,185.0
668,东北虎林园,20231030,188,76,112,181.0,184.6,184.9
669,东北虎林园,20231031,159,63,96,188.0,182.2,183.6
670,东北虎林园,20231101,178,66,112,159.0,179.0,180.8
671,东北虎林园,20231102,157,74,83,178.0,172.6,177.4
672,东北虎林园,20231103,182,87,95,157.0,172.8,178.3
673,东北虎林园,20231104,185,64,121,182.0,172.2,178.4
674,东北虎林园,20231105,155,59,96,185.0,171.4,176.8
675,东北虎林园,20231106,182,78,104,155.0,172.2,175.6
676,东北虎林园,20231107,187,82,105,182.0,178.2,175.4
677,东北虎林园,20231108,205,83,122,187.0,182.8,177.8
678,东北虎林园,20231109,234,93,141,205.0,192.6,182.4
679,东北虎林园,20231110,237,89,148,234.0,209.0,190.2
680,东北虎林园,20231111,205,80,125,237.0,213.6,192.9
681,东北虎林园,20231112,227,78,149,205.0,221.6,199.9
682,东北虎林园,20231113,205,93,112,227.0,221.6,202.2
683,东北虎林园,20231114,205,80,125,205.0,215.8,204.2
684,东北虎林园,20231115,212,91,121,205.0,210.8,209.9
685,东北虎林园,20231116,209,83,126,212.0,211.6,212.6
686,东北虎林园,20231117,209,87,122,209.0,208.0,214.8
687,东北虎林园,20231118,187,64,123,209.0,204.4,213.0
688,东北虎林园,20231119,229,70,159,187.0,209.2,212.5
689,东北虎林园,20231120,203,78,125,229.0,207.4,209.1
690,东北虎林园,20231121,234,99,135,203.0,212.4,212.0
691,东北虎林园,20231122,197,89,108,234.0,210.0,209.0
692,东北虎林园,20231123,240,102,138,197.0,220.6,212.5
693,东北虎林园,20231124,216,99,117,240.0,218.0,213.6
694,东北虎林园,20231125,205,82,123,216.0,218.4,212.9
695,东北虎林园,20231126,191,78,113,205.0,209.8,211.1
696,东北虎林园,20231127,216,85,131,191.0,213.6,211.8
697,东北虎林园,20231128,276,118,158,216.0,220.8,220.7
698,东北虎林园,20231129,222,87,135,276.0,222.0,220.0
699,东北虎林园,20231130,219,72,147,222.0,224.8,221.6
700,东北虎林园,20231201,217,85,132,219.0,230.0,219.9
701,东北虎林园,20231202,211,66,145,217.0,229.0,221.3
702,东北虎林园,20231203,225,74,151,211.0,218.8,219.8
703,东北虎林园,20231204,220,89,131,225.0,218.4,220.2
704,东北虎林园,20231205,242,85,157,220.0,223.0,223.9
705,东北虎林园,20231206,229,93,136,242.0,225.4,227.7
706,东北虎林园,20231207,254,99,155,229.0,234.0,231.5
707,东北虎林园,20231208,246,85,161,254.0,238.2,228.5
708,东北虎林园,20231209,217,68,149,246.0,237.6,228.0
709,东北虎林园,20231210,225,70,155,217.0,234.2,228.6
710,东北虎林园,20231211,246,108,138,225.0,237.6,231.5
711,东北虎林园,20231212,193,85,108,246.0,225.4,229.7
712,东北虎林园,20231213,225,82,143,193.0,221.2,229.7
713,东北虎林园,20231214,272,99,173,225.0,232.2,234.9
714,东北虎林园,20231215,223,87,136,272.0,231.8,233.0
715,东北虎林园,20231216,231,87,144,223.0,228.8,233.2
716,东北虎林园,20231217,221,76,145,231.0,234.4,229.9
717,东北虎林园,20231218,262,108,154,221.0,241.8,231.5
718,东北虎林园,20231219,261,87,174,262.0,239.6,235.9
719,东北虎林园,20231220,233,82,151,261.0,241.6,236.7
720,东北虎林园,20231221,278,95,183,233.0,251.0,239.9
721,东北虎林园,20231222,221,63,158,278.0,251.0,242.7
722,东北虎林园,20231223,252,93,159,221.0,249.0,245.4
723,东北虎林园,20231224,267,89,178,252.0,250.2,244.9
724,东北虎林园,20231225,288,93,195,267.0,261.2,251.4
725,东北虎林园,20231226,282,87,195,288.0,262.0,256.5
726,东北虎林园,20231227,275,78,197,282.0,272.8,261.9
727,东北虎林园,20231228,291,106,185,275.0,280.6,264.8
728,东北虎林园,20231229,350,102,248,291.0,297.2,273.7
729,东北虎林园,20231230,347,83,264,350.0,309.0,285.1
730,东北虎林园,20231231,304,68,236,347.0,313.4,287.7
731,东北虎林园,20240101,282,64,218,304.0,314.8,293.8
732,东北虎林园,20240102,327,108,219,282.0,322.0,301.3
733,东北虎林园,20240103,406,140,266,327.0,333.2,315.2
734,东北虎林园,20240104,485,186,299,406.0,360.8,334.9
735,东北虎林园,20240105,478,165,313,485.0,395.6,354.5
736,东北虎林园,20240106,435,91,344,478.0,426.2,370.5
737,东北虎林园,20240107,428,121,307,435.0,446.4,384.2
738,东北虎林园,20240108,444,148,296,428.0,454.0,393.6
739,东北虎林园,20240109,375,127,248,444.0,432.0,396.4
740,东北虎林园,20240110,391,131,260,375.0,414.6,405.1
741,东北虎林园,20240111,352,125,227,391.0,398.0,412.1
742,东北虎林园,20240112,387,133,254,352.0,389.8,418.1
743,东北虎林园,20240113,359,89,270,387.0,372.8,413.4
744,东北虎林园,20240114,336,97,239,359.0,365.0,398.5
745,东北虎林园,20240115,348,101,247,336.0,356.4,385.5
746,东北虎林园,20240116,318,104,214,348.0,349.6,373.8
747,东北虎林园,20240117,337,101,236,318.0,339.6,364.7
748,东北虎林园,20240118,325,106,219,337.0,332.8,352.8
749,东北虎林园,20240119,336,89,247,325.0,332.8,348.9
750,东北虎林园,20240120,349,82,267,336.0,333.0,344.7
751,东北虎林园,20240121,349,74,275,349.0,339.2,344.4
752,东北虎林园,20240122,327,93,234,349.0,337.2,338.4
753,东北虎林园,20240123,356,101,255,327.0,343.4,338.1
754,东北虎林园,20240124,340,95,245,356.0,344.2,338.5
755,东北虎林园,20240125,376,116,260,340.0,349.6,341.3
756,东北虎林园,20240126,347,93,254,376.0,349.2,344.2
757,东北虎林园,20240127,364,70,294,347.0,356.6,346.9
758,东北虎林园,20240128,332,63,269,364.0,351.8,347.6
759,东北虎林园,20240129,390,102,288,332.0,361.8,353.0
760,东北虎林园,20240130,364,93,271,390.0,359.4,354.5
761,东北虎林园,20240131,330,91,239,364.0,356.0,352.6
762,东北虎林园,20240201,315,72,243,330.0,346.2,351.4
763,东北虎林园,20240202,330,89,241,315.0,345.8,348.8
764,东北虎林园,20240203,318,76,242,330.0,331.4,346.6
765,东北虎林园,20240204,332,93,239,318.0,325.0,342.2
766,东北虎林园,20240205,313,89,224,332.0,321.6,338.8
767,东北虎林园,20240206,354,80,274,313.0,329.4,337.8
768,东北虎林园,20240207,317,85,232,354.0,326.8,336.3
769,东北虎林园,20240208,284,78,206,317.0,320.0,325.7
770,东北虎林园,20240209,227,59,168,284.0,299.0,312.0
771,东北虎林园,20240210,280,59,221,227.0,292.4,307.0
772,东北虎林园,20240211,393,63,330,280.0,300.2,314.8
773,东北虎林园,20240212,530,64,466,393.0,342.8,334.8
774,东北虎林园,20240213,667,61,606,530.0,419.4,369.7
775,东北虎林园,20240214,692,72,620,667.0,512.4,405.7
776,东北虎林园,20240215,539,74,465,692.0,564.2,428.3
777,东北虎林园,20240216,479,74,405,539.0,581.4,440.8
778,东北虎林园,20240217,479,68,411,479.0,571.2,457.0
779,东北虎林园,20240218,372,87,285,479.0,512.2,465.8
780,东北虎林园,20240219,336,70,266,372.0,441.0,476.7
781,东北虎林园,20240220,321,68,253,336.0,397.4,480.8
782,东北虎林园,20240221,232,66,166,321.0,348.0,464.7
783,东北虎林园,20240222,272,85,187,232.0,306.6,438.9
784,东北虎林园,20240223,255,76,179,272.0,283.2,397.7
785,东北虎林园,20240224,239,59,180,255.0,263.8,352.4
786,东北虎林园,20240225,250,72,178,239.0,249.6,323.5
787,东北虎林园,20240226,238,70,168,250.0,250.8,299.4
788,东北虎林园,20240227,230,89,141,238.0,242.4,274.5
789,东北虎林园,20240228,204,76,128,230.0,232.2,257.7
790,东北虎林园,20240229,198,72,126,204.0,224.0,243.9
791,东北虎林园,20240301,189,61,128,198.0,211.8,230.7
792,东北虎林园,20240302,191,63,128,189.0,202.4,226.6
793,东北虎林园,20240303,217,66,151,191.0,199.8,221.1
794,东北虎林园,20240304,210,72,138,217.0,201.0,216.6
795,东北虎林园,20240305,180,78,102,210.0,197.4,210.7
796,东北虎林园,20240306,198,72,126,180.0,199.2,205.5
797,东北虎林园,20240307,222,70,152,198.0,205.4,203.9
798,东北虎林园,20240308,233,82,151,222.0,208.6,204.2
799,东北虎林园,20240309,205,74,131,233.0,207.6,204.3
800,东北虎林园,20240310,196,70,126,205.0,210.8,204.1
801,东北虎林园,20240311,184,76,108,196.0,208.0,203.6
802,东北虎林园,20240312,183,66,117,184.0,200.2,202.8
803,东北虎林园,20240313,189,72,117,183.0,191.4,200.0
804,东北虎林园,20240314,208,83,125,189.0,192.0,199.8
805,东北虎林园,20240315,162,66,96,208.0,185.2,198.0
806,东北虎林园,20240316,187,70,117,162.0,185.8,196.9
807,东北虎林园,20240317,186,61,125,187.0,186.4,193.3
808,东北虎林园,20240318,171,85,86,186.0,182.8,187.1
809,东北虎林园,20240319,189,72,117,171.0,179.0,185.5
810,东北虎林园,20240320,193,74,119,189.0,185.2,185.2
811,东北虎林园,20240321,168,72,96,193.0,181.4,183.6
812,东北虎林园,20240322,172,66,106,168.0,178.6,182.5
813,东北虎林园,20240323,208,64,144,172.0,186.0,184.4
814,东北虎林园,20240324,141,0,141,208.0,176.4,177.7
815,东北虎林园,20240325,186,68,118,141.0,175.0,180.1
816,东北虎林园,20240326,176,74,102,186.0,176.6,179.0
817,东北虎林园,20240327,182,72,110,176.0,178.6,178.6
818,东北虎林园,20240328,204,85,119,182.0,177.8,181.9
819,东北虎林园,20240329,201,80,121,204.0,189.8,183.1
820,东北虎林园,20240330,176,68,108,201.0,187.8,181.4
821,东北虎林园,20240331,206,63,143,176.0,193.8,185.2
822,东北虎林园,20240401,202,72,130,206.0,197.8,188.2
823,东北虎林园,20240402,206,74,132,202.0,198.2,188.0
824,东北虎林园,20240403,245,68,177,206.0,207.0,198.4
825,东北虎林园,20240404,288,66,222,245.0,229.4,208.6
826,东北虎林园,20240405,322,66,256,288.0,252.6,223.2
827,东北虎林园,20240406,237,74,163,322.0,259.6,228.7
828,东北虎林园,20240407,223,78,145,237.0,263.0,230.6
829,东北虎林园,20240408,202,85,117,223.0,254.4,230.7
830,东北虎林园,20240409,189,74,115,202.0,234.6,232.0
831,东北虎林园,20240410,189,74,115,189.0,208.0,230.3
832,东北虎林园,20240411,192,66,126,189.0,199.0,229.3
833,东北虎林园,20240412,217,82,135,192.0,197.8,230.4
834,东北虎林园,20240413,207,64,143,217.0,198.8,226.6
835,东北虎林园,20240414,231,76,155,207.0,207.2,220.9
836,东北虎林园,20240415,211,68,143,231.0,211.6,209.8
837,东北虎林园,20240416,216,72,144,211.0,216.4,207.7
838,东北虎林园,20240417,215,70,145,216.0,216.0,206.9
839,东北虎林园,20240418,198,68,130,215.0,214.2,206.5
840,东北虎林园,20240419,203,68,135,198.0,208.6,207.9
841,东北虎林园,20240420,214,63,151,203.0,209.2,210.4
842,东北虎林园,20240421,228,63,165,214.0,211.6,214.0
843,东北虎林园,20240422,224,70,154,228.0,213.4,214.7
844,东北虎林园,20240423,212,68,144,224.0,216.2,215.2
845,东北虎林园,20240424,259,97,162,212.0,227.4,218.0
846,东北虎林园,20240425,229,72,157,259.0,230.4,219.8
847,东北虎林园,20240426,213,72,141,229.0,227.4,219.5
848,东北虎林园,20240427,242,63,179,213.0,231.0,222.2
849,东北虎林园,20240428,230,68,162,242.0,234.6,225.4
850,东北虎林园,20240429,250,87,163,230.0,232.8,230.1
851,东北虎林园,20240430,330,99,231,250.0,253.0,241.7
1,哈尔滨伏尔加庄园,20220101,71,0,71,330.0,224.6,226.0
2,哈尔滨伏尔加庄园,20220102,84,0,84,71.0,193.0,212.0
3,哈尔滨伏尔加庄园,20220103,128,61,67,84.0,172.6,203.6
4,哈尔滨伏尔加庄园,20220104,124,59,65,128.0,147.4,190.1
5,哈尔滨伏尔加庄园,20220105,59,59,0,124.0,93.2,173.1
6,哈尔滨伏尔加庄园,20220106,74,0,74,59.0,93.8,159.2
7,哈尔滨伏尔加庄园,20220107,150,66,84,74.0,107.0,150.0
8,哈尔滨伏尔加庄园,20220108,82,0,82,150.0,97.8,135.2
9,哈尔滨伏尔加庄园,20220109,137,59,78,82.0,100.4,123.9
10,哈尔滨伏尔加庄园,20220110,69,0,69,137.0,102.4,97.8
11,哈尔滨伏尔加庄园,20220111,126,61,65,69.0,112.8,103.3
12,哈尔滨伏尔加庄园,20220112,130,61,69,126.0,108.8,107.9
13,哈尔滨伏尔加庄园,20220113,66,0,66,130.0,105.6,101.7
14,哈尔滨伏尔加庄园,20220114,124,59,65,66.0,103.0,101.7
15,哈尔滨伏尔加庄园,20220115,122,59,63,124.0,113.6,108.0
16,哈尔滨伏尔加庄园,20220116,133,64,69,122.0,115.0,113.9
17,哈尔滨伏尔加庄园,20220117,132,59,73,133.0,115.4,112.1
18,哈尔滨伏尔加庄园,20220118,120,59,61,132.0,126.2,115.9
19,哈尔滨伏尔加庄园,20220119,129,64,65,120.0,127.2,115.1
20,哈尔滨伏尔加庄园,20220120,128,63,65,129.0,128.4,121.0
21,哈尔滨伏尔加庄园,20220121,0,0,0,128.0,101.8,108.4
22,哈尔滨伏尔加庄园,20220122,61,0,61,0.0,87.6,101.5
23,哈尔滨伏尔加庄园,20220123,65,0,65,61.0,76.6,101.4
24,哈尔滨伏尔加庄园,20220124,0,0,0,65.0,50.8,89.0
25,哈尔滨伏尔加庄园,20220125,65,0,65,0.0,38.2,83.3
26,哈尔滨伏尔加庄园,20220126,122,59,63,65.0,62.6,82.2
27,哈尔滨伏尔加庄园,20220127,0,0,0,122.0,50.4,69.0
28,哈尔滨伏尔加庄园,20220128,137,59,78,0.0,64.8,70.7
29,哈尔滨伏尔加庄园,20220129,128,59,69,137.0,90.4,70.6
30,哈尔滨伏尔加庄园,20220130,0,0,0,128.0,77.4,57.8
31,哈尔滨伏尔加庄园,20220131,63,0,63,0.0,65.6,64.1
32,哈尔滨伏尔加庄园,20220201,76,0,76,63.0,80.8,65.6
33,哈尔滨伏尔加庄园,20220202,73,0,73,76.0,68.0,66.4
34,哈尔滨伏尔加庄园,20220203,70,0,70,73.0,56.4,73.4
35,哈尔滨伏尔加庄园,20220204,135,59,76,70.0,83.4,80.4
36,哈尔滨伏尔加庄园,20220205,73,0,73,135.0,85.4,75.5
37,哈尔滨伏尔加庄园,20220206,125,59,66,73.0,95.2,88.0
38,哈尔滨伏尔加庄园,20220207,126,59,67,125.0,105.8,86.9
39,哈尔滨伏尔加庄园,20220208,125,59,66,126.0,116.8,86.6
40,哈尔滨伏尔加庄园,20220209,67,0,67,125.0,103.2,93.3
41,哈尔滨伏尔加庄园,20220210,71,0,71,67.0,102.8,94.1
42,哈尔滨伏尔加庄园,20220211,124,59,65,71.0,102.6,98.9
43,哈尔滨伏尔加庄园,20220212,71,0,71,124.0,91.6,98.7
44,哈尔滨伏尔加庄园,20220213,70,0,70,71.0,80.6,98.7
45,哈尔滨伏尔加庄园,20220214,69,0,69,70.0,81.0,92.1
46,哈尔滨伏尔加庄园,20220215,65,0,65,69.0,79.8,91.3
47,哈尔滨伏尔加庄园,20220216,73,0,73,65.0,69.6,86.1
48,哈尔滨伏尔加庄园,20220217,76,0,76,73.0,70.6,81.1
49,哈尔滨伏尔加庄园,20220218,65,0,65,76.0,69.6,75.1
50,哈尔滨伏尔加庄园,20220219,84,0,84,65.0,72.6,76.8
51,哈尔滨伏尔加庄园,20220220,135,59,76,84.0,86.6,83.2
52,哈尔滨伏尔加庄园,20220221,79,0,79,135.0,87.8,78.7
53,哈尔滨伏尔加庄园,20220222,65,0,65,79.0,85.6,78.1
54,哈尔滨伏尔加庄园,20220223,128,59,69,65.0,98.2,83.9
55,哈尔滨伏尔加庄园,20220224,82,0,82,128.0,97.8,85.2
56,哈尔滨伏尔加庄园,20220225,76,0,76,82.0,86.0,86.3
57,哈尔滨伏尔加庄园,20220226,69,0,69,76.0,84.0,85.9
58,哈尔滨伏尔加庄园,20220227,78,0,78,69.0,86.6,86.1
59,哈尔滨伏尔加庄园,20220228,66,0,66,78.0,74.2,86.2
60,哈尔滨伏尔加庄园,20220301,129,64,65,66.0,83.6,90.7
61,哈尔滨伏尔加庄园,20220302,129,59,70,129.0,94.2,90.1
62,哈尔滨伏尔加庄园,20220303,66,0,66,129.0,93.6,88.8
63,哈尔滨伏尔加庄园,20220304,128,59,69,66.0,103.6,95.1
64,哈尔滨伏尔加庄园,20220305,65,0,65,128.0,103.4,88.8
65,哈尔滨伏尔加庄园,20220306,130,59,71,65.0,103.6,93.6
66,哈尔滨伏尔加庄园,20220307,128,59,69,130.0,103.4,98.8
67,哈尔滨伏尔加庄园,20220308,69,0,69,128.0,104.0,98.8
68,哈尔滨伏尔加庄园,20220309,128,59,69,69.0,104.0,103.8
69,哈尔滨伏尔加庄园,20220310,66,0,66,128.0,104.2,103.8
70,哈尔滨伏尔加庄园,20220311,61,0,61,66.0,90.4,97.0
71,哈尔滨伏尔加庄园,20220312,70,0,70,61.0,78.8,91.1
72,哈尔滨伏尔加庄园,20220313,130,59,71,70.0,91.0,97.5
73,哈尔滨伏尔加庄园,20220314,70,0,70,130.0,79.4,91.7
74,哈尔滨伏尔加庄园,20220315,65,0,65,70.0,79.2,91.7
75,哈尔滨伏尔加庄园,20220316,128,59,69,65.0,92.6,91.5
76,哈尔滨伏尔加庄园,20220317,63,0,63,128.0,91.2,85.0
77,哈尔滨伏尔加庄园,20220318,0,0,0,63.0,65.2,78.1
78,哈尔滨伏尔加庄园,20220319,63,0,63,0.0,63.8,71.6
79,哈尔滨伏尔加庄园,20220320,67,0,67,63.0,64.2,71.7
80,哈尔滨伏尔加庄园,20220321,124,59,65,67.0,63.4,78.0
81,哈尔滨伏尔加庄园,20220322,61,0,61,124.0,63.0,77.1
82,哈尔滨伏尔加庄园,20220323,65,0,65,61.0,76.0,70.6
83,哈尔滨伏尔加庄园,20220324,125,59,66,65.0,88.4,76.1
84,哈尔滨伏尔加庄园,20220325,70,0,70,125.0,89.0,76.6
85,哈尔滨伏尔加庄园,20220326,126,59,67,70.0,89.4,76.4
86,哈尔滨伏尔加庄园,20220327,63,0,63,126.0,89.8,76.4
87,哈尔滨伏尔加庄园,20220328,65,0,65,63.0,89.8,82.9
88,哈尔滨伏尔加庄园,20220329,124,59,65,65.0,89.6,89.0
89,哈尔滨伏尔加庄园,20220330,63,0,63,124.0,88.2,88.6
90,哈尔滨伏尔加庄园,20220331,67,0,67,63.0,76.4,82.9
91,哈尔滨伏尔加庄园,20220401,66,0,66,67.0,77.0,83.4
92,哈尔滨伏尔加庄园,20220402,61,0,61,66.0,76.2,83.0
93,哈尔滨伏尔加庄园,20220403,65,0,65,61.0,64.4,77.0
94,哈尔滨伏尔加庄园,20220404,66,0,66,65.0,65.0,76.6
95,哈尔滨伏尔加庄园,20220405,122,59,63,66.0,76.0,76.2
96,哈尔滨伏尔加庄园,20220406,65,0,65,122.0,75.8,76.4
97,哈尔滨伏尔加庄园,20220407,74,0,74,65.0,78.4,77.3
98,哈尔滨伏尔加庄园,20220408,59,59,0,74.0,77.2,70.8
99,哈尔滨伏尔加庄园,20220409,67,0,67,59.0,77.4,71.2
100,哈尔滨伏尔加庄园,20220410,131,61,70,67.0,79.2,77.6
101,哈尔滨伏尔加庄园,20220411,129,59,70,131.0,92.0,83.9
102,哈尔滨伏尔加庄园,20220412,63,0,63,129.0,89.8,84.1
103,哈尔滨伏尔加庄园,20220413,65,0,65,63.0,91.0,84.1
104,哈尔滨伏尔加庄园,20220414,122,59,63,65.0,102.0,89.7
105,哈尔滨伏尔加庄园,20220415,63,0,63,122.0,88.4,83.8
106,哈尔滨伏尔加庄园,20220416,63,0,63,63.0,75.2,83.6
107,哈尔滨伏尔加庄园,20220417,124,59,65,63.0,87.4,88.6
108,哈尔滨伏尔加庄园,20220418,61,0,61,124.0,86.6,88.8
109,哈尔滨伏尔加庄园,20220419,66,0,66,61.0,75.4,88.7
110,哈尔滨伏尔加庄园,20220420,0,0,0,66.0,62.8,75.6
111,哈尔滨伏尔加庄园,20220421,66,0,66,0.0,63.4,69.3
112,哈尔滨伏尔加庄园,20220422,126,63,63,66.0,63.8,75.6
113,哈尔滨伏尔加庄园,20220423,126,63,63,126.0,76.8,81.7
114,哈尔滨伏尔加庄园,20220424,0,0,0,126.0,63.6,69.5
115,哈尔滨伏尔加庄园,20220425,131,61,70,0.0,89.8,76.3
116,哈尔滨伏尔加庄园,20220426,67,0,67,131.0,90.0,76.7
117,哈尔滨伏尔加庄园,20220427,65,0,65,67.0,77.8,70.8
118,哈尔滨伏尔加庄园,20220428,63,0,63,65.0,65.2,71.0
119,哈尔滨伏尔加庄园,20220429,124,61,63,63.0,90.0,76.8
120,哈尔滨伏尔加庄园,20220430,63,0,63,124.0,76.4,83.1
121,哈尔滨伏尔加庄园,20220501,70,0,70,63.0,77.0,83.5
122,哈尔滨伏尔加庄园,20220502,135,59,76,70.0,91.0,84.4
123,哈尔滨伏尔加庄园,20220503,61,0,61,135.0,90.6,77.9
124,哈尔滨伏尔加庄园,20220504,65,0,65,61.0,78.8,84.4
125,哈尔滨伏尔加庄园,20220505,63,63,0,65.0,78.8,77.6
126,哈尔滨伏尔加庄园,20220506,59,59,0,63.0,76.6,76.8
127,哈尔滨伏尔加庄园,20220507,76,0,76,59.0,64.8,77.9
128,哈尔滨伏尔加庄园,20220508,63,0,63,76.0,65.2,77.9
129,哈尔滨伏尔加庄园,20220509,71,0,71,63.0,66.4,72.6
130,哈尔滨伏尔加庄园,20220510,71,0,71,71.0,68.0,73.4
131,哈尔滨伏尔加庄园,20220511,141,59,82,71.0,84.4,80.5
132,哈尔滨伏尔加庄园,20220512,61,0,61,141.0,81.4,73.1
133,哈尔滨伏尔加庄园,20220513,147,63,84,61.0,98.2,81.7
134,哈尔滨伏尔加庄园,20220514,70,0,70,147.0,98.0,82.2
135,哈尔滨伏尔加庄园,20220515,78,0,78,70.0,99.4,83.7
136,哈尔滨伏尔加庄园,20220516,69,0,69,78.0,85.0,84.7
137,哈尔滨伏尔加庄园,20220517,74,0,74,69.0,87.6,84.5
138,哈尔滨伏尔加庄园,20220518,71,0,71,74.0,72.4,85.3
139,哈尔滨伏尔加庄园,20220519,130,61,69,71.0,84.4,91.2
140,哈尔滨伏尔加庄园,20220520,80,0,80,130.0,84.8,92.1
141,哈尔滨伏尔加庄园,20220521,73,0,73,80.0,85.6,85.3
142,哈尔滨伏尔加庄园,20220522,67,0,67,73.0,84.2,85.9
143,哈尔滨伏尔加庄园,20220523,66,0,66,67.0,83.2,77.8
144,哈尔滨伏尔加庄园,20220524,71,0,71,66.0,71.4,77.9
145,哈尔滨伏尔加庄园,20220525,65,0,65,71.0,68.4,76.6
146,哈尔滨伏尔加庄园,20220526,125,59,66,65.0,78.8,82.2
147,哈尔滨伏尔加庄园,20220527,66,0,66,125.0,78.6,81.4
148,哈尔滨伏尔加庄园,20220528,73,0,73,66.0,80.0,81.6
149,哈尔滨伏尔加庄园,20220529,130,61,69,73.0,91.8,81.6
150,哈尔滨伏尔加庄园,20220530,70,0,70,130.0,92.8,80.6
151,哈尔滨伏尔加庄园,20220531,70,0,70,70.0,81.8,80.3
152,哈尔滨伏尔加庄园,20220601,126,59,67,70.0,93.8,86.2
153,哈尔滨伏尔加庄园,20220602,91,0,91,126.0,97.4,88.7
154,哈尔滨伏尔加庄园,20220603,82,0,82,91.0,87.8,89.8
155,哈尔滨伏尔加庄园,20220604,89,0,89,82.0,91.6,92.2
156,哈尔滨伏尔加庄园,20220605,69,0,69,89.0,91.4,86.6
157,哈尔滨伏尔加庄园,20220606,150,61,89,69.0,96.2,95.0
158,哈尔滨伏尔加庄园,20220607,95,0,95,150.0,97.0,97.2
159,哈尔滨伏尔加庄园,20220608,148,59,89,95.0,110.2,99.0
160,哈尔滨伏尔加庄园,20220609,144,70,74,148.0,121.2,106.4
161,哈尔滨伏尔加庄园,20220610,93,0,93,144.0,126.0,108.7
162,哈尔滨伏尔加庄园,20220611,78,0,78,93.0,111.6,103.9
163,哈尔滨伏尔加庄园,20220612,97,0,97,78.0,112.0,104.5
164,哈尔滨伏尔加庄园,20220613,146,64,82,97.0,111.6,110.9
165,哈尔滨伏尔加庄园,20220614,69,0,69,146.0,96.6,108.9
166,哈尔滨伏尔加庄园,20220615,76,0,76,69.0,93.2,109.6
167,哈尔滨伏尔加庄园,20220616,135,59,76,76.0,104.6,108.1
168,哈尔滨伏尔加庄园,20220617,137,63,74,135.0,112.6,112.3
169,哈尔滨伏尔加庄园,20220618,79,0,79,137.0,99.2,105.4
170,哈尔滨伏尔加庄园,20220619,97,0,97,79.0,104.8,100.7
171,哈尔滨伏尔加庄园,20220620,150,61,89,97.0,119.6,106.4
172,哈尔滨伏尔加庄园,20220621,141,59,82,150.0,120.8,112.7
173,哈尔滨伏尔加庄园,20220622,150,61,89,141.0,123.4,118.0
174,哈尔滨伏尔加庄园,20220623,83,0,83,150.0,124.2,111.7
175,哈尔滨伏尔加庄园,20220624,141,59,82,83.0,133.0,118.9
176,哈尔滨伏尔加庄园,20220625,82,0,82,141.0,119.4,119.5
177,哈尔滨伏尔加庄园,20220626,76,0,76,82.0,106.4,113.6
178,哈尔滨伏尔加庄园,20220627,150,59,91,76.0,106.4,114.9
179,哈尔滨伏尔加庄园,20220628,165,61,104,150.0,122.8,123.5
180,哈尔滨伏尔加庄园,20220629,148,61,87,165.0,124.2,128.6
181,哈尔滨伏尔加庄园,20220630,165,63,102,148.0,140.8,130.1
182,哈尔滨伏尔加庄园,20220701,142,59,83,165.0,154.0,130.2
183,哈尔滨伏尔加庄园,20220702,86,0,86,142.0,141.2,123.8
184,哈尔滨伏尔加庄园,20220703,109,0,109,86.0,130.0,126.4
185,哈尔滨伏尔加庄园,20220704,154,63,91,109.0,131.2,127.7
186,哈尔滨伏尔加庄园,20220705,169,59,110,154.0,132.0,136.4
187,哈尔滨伏尔加庄园,20220706,152,66,86,169.0,134.0,144.0
188,哈尔滨伏尔加庄园,20220707,163,61,102,152.0,149.4,145.3
189,哈尔滨伏尔加庄园,20220708,145,59,86,163.0,156.6,143.3
190,哈尔滨伏尔加庄园,20220709,106,0,106,145.0,147.0,139.1
191,哈尔滨伏尔加庄园,20220710,109,0,109,106.0,135.0,133.5
192,哈尔滨伏尔加庄园,20220711,178,66,112,109.0,140.2,137.1
193,哈尔滨伏尔加庄园,20220712,218,63,155,178.0,151.2,150.3
194,哈尔滨伏尔加庄园,20220713,179,61,118,218.0,158.0,157.3
195,哈尔滨伏尔加庄园,20220714,212,61,151,179.0,179.2,163.1
196,哈尔滨伏尔加庄园,20220715,215,70,145,212.0,200.4,167.7
197,哈尔滨伏尔加庄园,20220716,191,61,130,215.0,203.0,171.6
198,哈尔滨伏尔加庄园,20220717,219,59,160,191.0,203.2,177.2
199,哈尔滨伏尔加庄园,20220718,211,59,152,219.0,209.6,183.8
200,哈尔滨伏尔加庄园,20220719,191,66,125,211.0,205.4,192.3
201,哈尔滨伏尔加庄园,20220720,217,59,158,191.0,205.8,203.1
202,哈尔滨伏尔加庄园,20220721,229,72,157,217.0,213.4,208.2
203,哈尔滨伏尔加庄园,20220722,206,72,134,229.0,210.8,207.0
204,哈尔滨伏尔加庄园,20220723,208,64,144,206.0,210.2,209.9
205,哈尔滨伏尔加庄园,20220724,210,59,151,208.0,214.0,209.7
206,哈尔滨伏尔加庄园,20220725,195,61,134,210.0,209.6,207.7
207,哈尔滨伏尔加庄园,20220726,187,59,128,195.0,201.2,207.3
208,哈尔滨伏尔加庄园,20220727,211,59,152,187.0,202.2,206.5
209,哈尔滨伏尔加庄园,20220728,219,72,147,211.0,204.4,207.3
210,哈尔滨伏尔加庄园,20220729,180,61,119,219.0,198.4,206.2
211,哈尔滨伏尔加庄园,20220730,206,59,147,180.0,200.6,205.1
212,哈尔滨伏尔加庄园,20220731,125,0,125,206.0,188.2,194.7
213,哈尔滨伏尔加庄园,20220801,198,63,135,125.0,185.6,193.9
214,哈尔滨伏尔加庄园,20220802,198,64,134,198.0,181.4,192.9
215,哈尔滨伏尔加庄园,20220803,185,64,121,198.0,182.4,190.4
216,哈尔滨伏尔加庄园,20220804,211,70,141,185.0,183.4,192.0
217,哈尔滨伏尔加庄园,20220805,196,64,132,211.0,197.6,192.9
218,哈尔滨伏尔加庄园,20220806,148,0,148,196.0,187.6,186.6
219,哈尔滨伏尔加庄园,20220807,118,0,118,148.0,171.6,176.5
220,哈尔滨伏尔加庄园,20220808,214,63,151,118.0,177.4,179.9
221,哈尔滨伏尔加庄园,20220809,184,66,118,214.0,172.0,177.7
222,哈尔滨伏尔加庄园,20220810,167,61,106,184.0,166.2,181.9
223,哈尔滨伏尔加庄园,20220811,145,0,145,167.0,165.6,176.6
224,哈尔滨伏尔加庄园,20220812,209,61,148,145.0,183.8,177.7
225,哈尔滨伏尔加庄园,20220813,203,64,139,209.0,181.6,179.5
226,哈尔滨伏尔加庄园,20220814,178,59,119,203.0,180.4,176.2
227,哈尔滨伏尔加庄园,20220815,184,59,125,178.0,183.8,175.0
228,哈尔滨伏尔加庄园,20220816,181,59,122,184.0,191.0,178.3
229,哈尔滨伏尔加庄园,20220817,187,61,126,181.0,186.6,185.2
230,哈尔滨伏尔加庄园,20220818,189,63,126,187.0,183.8,182.7
231,哈尔滨伏尔加庄园,20220819,126,0,126,189.0,173.4,176.9
232,哈尔滨伏尔加庄园,20220820,184,63,121,126.0,173.4,178.6
233,哈尔滨伏尔加庄园,20220821,110,0,110,184.0,159.2,175.1
234,哈尔滨伏尔加庄园,20220822,171,63,108,110.0,156.0,171.3
235,哈尔滨伏尔加庄园,20220823,204,70,134,171.0,159.0,171.4
236,哈尔滨伏尔加庄园,20220824,105,0,105,204.0,154.8,164.1
237,哈尔滨伏尔加庄园,20220825,159,59,100,105.0,149.8,161.6
238,哈尔滨伏尔加庄园,20220826,165,59,106,159.0,160.8,160.0
239,哈尔滨伏尔加庄园,20220827,122,0,122,165.0,151.0,153.5
240,哈尔滨伏尔加庄园,20220828,139,59,80,122.0,138.0,148.5
241,哈尔滨伏尔加庄园,20220829,74,0,74,139.0,131.8,143.3
242,哈尔滨伏尔加庄园,20220830,139,61,78,74.0,127.8,138.8
243,哈尔滨伏尔加庄园,20220831,132,61,71,139.0,121.2,141.0
244,哈尔滨伏尔加庄园,20220901,130,61,69,132.0,122.8,136.9
245,哈尔滨伏尔加庄园,20220902,69,0,69,130.0,108.8,123.4
246,哈尔滨伏尔加庄园,20220903,67,0,67,69.0,107.4,119.6
247,哈尔滨伏尔加庄园,20220904,71,0,71,67.0,93.8,110.8
248,哈尔滨伏尔加庄园,20220905,69,0,69,71.0,81.2,101.2
249,哈尔滨伏尔加庄园,20220906,128,61,67,69.0,80.8,101.8
250,哈尔滨伏尔加庄园,20220907,135,59,76,128.0,94.0,101.4
251,哈尔滨伏尔加庄园,20220908,92,0,92,135.0,99.0,103.2
252,哈尔滨伏尔加庄园,20220909,80,0,80,92.0,100.8,97.3
253,哈尔滨伏尔加庄园,20220910,167,59,108,80.0,120.4,100.8
254,哈尔滨伏尔加庄园,20220911,167,63,104,167.0,128.2,104.5
255,哈尔滨伏尔加庄园,20220912,96,0,96,167.0,120.4,107.2
256,哈尔滨伏尔加庄园,20220913,158,63,95,96.0,133.6,116.3
257,哈尔滨伏尔加庄园,20220914,141,59,82,158.0,145.8,123.3
258,哈尔滨伏尔加庄园,20220915,141,61,80,141.0,140.6,130.5
259,哈尔滨伏尔加庄园,20220916,141,59,82,141.0,135.4,131.8
260,哈尔滨伏尔加庄园,20220917,113,0,113,141.0,138.8,129.6
261,哈尔滨伏尔加庄园,20220918,161,66,95,113.0,139.4,136.5
262,哈尔滨伏尔加庄园,20220919,146,59,87,161.0,140.4,143.1
263,哈尔滨伏尔加庄园,20220920,150,61,89,146.0,142.2,141.4
264,哈尔滨伏尔加庄园,20220921,91,0,91,150.0,132.2,133.8
265,哈尔滨伏尔加庄园,20220922,136,63,73,91.0,136.8,137.8
266,哈尔滨伏尔加庄园,20220923,137,59,78,136.0,132.0,135.7
267,哈尔滨伏尔加庄园,20220924,126,59,67,137.0,128.0,134.2
268,哈尔滨伏尔加庄园,20220925,73,0,73,126.0,112.6,127.4
269,哈尔滨伏尔加庄园,20220926,131,64,67,73.0,120.6,126.4
270,哈尔滨伏尔加庄园,20220927,76,0,76,131.0,108.6,122.7
271,哈尔滨伏尔加庄园,20220928,134,64,70,76.0,108.0,120.0
272,哈尔滨伏尔加庄园,20220929,137,61,76,134.0,110.2,119.1
273,哈尔滨伏尔加庄园,20220930,148,68,80,137.0,125.2,118.9
274,哈尔滨伏尔加庄园,20221001,141,59,82,148.0,127.2,123.9
275,哈尔滨伏尔加庄园,20221002,80,0,80,141.0,128.0,118.3
276,哈尔滨伏尔加庄园,20221003,130,59,71,80.0,127.2,117.6
277,哈尔滨伏尔加庄园,20221004,87,0,87,130.0,117.2,113.7
278,哈尔滨伏尔加庄园,20221005,76,0,76,87.0,102.8,114.0
279,哈尔滨伏尔加庄园,20221006,82,0,82,76.0,91.0,109.1
280,哈尔滨伏尔加庄园,20221007,148,59,89,82.0,104.6,116.3
281,哈尔滨伏尔加庄园,20221008,132,61,71,148.0,105.0,116.1
282,哈尔滨伏尔加庄园,20221009,135,59,76,132.0,114.6,115.9
283,哈尔滨伏尔加庄园,20221010,76,0,76,135.0,114.6,108.7
284,哈尔滨伏尔加庄园,20221011,76,0,76,76.0,113.4,102.2
285,哈尔滨伏尔加庄园,20221012,140,70,70,76.0,111.8,108.2
286,哈尔滨伏尔加庄园,20221013,131,64,67,140.0,111.6,108.3
287,哈尔滨伏尔加庄园,20221014,61,61,0,131.0,96.8,105.7
288,哈尔滨伏尔加庄园,20221015,66,0,66,61.0,94.8,104.7
289,哈尔滨伏尔加庄园,20221016,66,0,66,66.0,92.8,103.1
290,哈尔滨伏尔加庄园,20221017,128,61,67,66.0,90.4,101.1
291,哈尔滨伏尔加庄园,20221018,146,66,80,128.0,93.4,102.5
292,哈尔滨伏尔加庄园,20221019,139,59,80,146.0,109.0,102.9
293,哈尔滨伏尔加庄园,20221020,78,0,78,139.0,111.4,103.1
294,哈尔滨伏尔加庄园,20221021,129,59,70,78.0,124.0,108.4
295,哈尔滨伏尔加庄园,20221022,95,0,95,129.0,117.4,103.9
296,哈尔滨伏尔加庄园,20221023,87,0,87,95.0,105.6,99.5
297,哈尔滨伏尔加庄园,20221024,73,0,73,87.0,92.4,100.7
298,哈尔滨伏尔加庄园,20221025,76,0,76,73.0,92.0,101.7
299,哈尔滨伏尔加庄园,20221026,74,0,74,76.0,81.0,102.5
300,哈尔滨伏尔加庄园,20221027,79,0,79,74.0,77.8,97.6
301,哈尔滨伏尔加庄园,20221028,132,63,69,79.0,86.8,96.2
302,哈尔滨伏尔加庄园,20221029,135,59,76,132.0,99.2,95.8
303,哈尔滨伏尔加庄园,20221030,79,0,79,135.0,99.8,95.9
304,哈尔滨伏尔加庄园,20221031,76,0,76,79.0,100.2,90.6
305,哈尔滨伏尔加庄园,20221101,80,0,80,76.0,100.4,89.1
306,哈尔滨伏尔加庄园,20221102,76,0,76,80.0,89.2,88.0
307,哈尔滨伏尔加庄园,20221103,135,61,74,76.0,89.2,94.2
308,哈尔滨伏尔加庄园,20221104,130,63,67,135.0,99.4,99.6
309,哈尔滨伏尔加庄园,20221105,66,0,66,130.0,97.4,98.8
310,哈尔滨伏尔加庄园,20221106,86,0,86,66.0,98.6,99.5
311,哈尔滨伏尔加庄园,20221107,140,61,79,86.0,111.4,100.3
312,哈尔滨伏尔加庄园,20221108,69,0,69,140.0,98.2,93.7
313,哈尔滨伏尔加庄园,20221109,126,59,67,69.0,97.4,98.4
314,哈尔滨伏尔加庄园,20221110,134,64,70,126.0,111.0,104.2
315,哈尔滨伏尔加庄园,20221111,69,0,69,134.0,107.6,103.1
316,哈尔滨伏尔加庄园,20221112,66,0,66,69.0,92.8,102.1
317,哈尔滨伏尔加庄园,20221113,144,61,83,66.0,107.8,103.0
318,哈尔滨伏尔加庄园,20221114,69,0,69,144.0,96.4,96.9
319,哈尔滨伏尔加庄园,20221115,61,0,61,69.0,81.8,96.4
320,哈尔滨伏尔加庄园,20221116,82,0,82,61.0,84.4,96.0
321,哈尔滨伏尔加庄园,20221117,139,66,73,82.0,99.0,95.9
322,哈尔滨伏尔加庄园,20221118,133,59,74,139.0,96.8,102.3
323,哈尔滨伏尔加庄园,20221119,66,0,66,133.0,96.2,96.3
324,哈尔滨伏尔加庄园,20221120,74,0,74,66.0,98.8,90.3
325,哈尔滨伏尔加庄园,20221121,63,0,63,74.0,95.0,89.7
326,哈尔滨伏尔加庄园,20221122,126,61,65,63.0,92.4,95.7
327,哈尔滨伏尔加庄园,20221123,128,61,67,126.0,91.4,94.1
328,哈尔滨伏尔加庄园,20221124,69,0,69,128.0,92.0,94.1
329,哈尔滨伏尔加庄园,20221125,134,61,73,69.0,104.0,101.4
330,哈尔滨伏尔加庄园,20221126,65,0,65,134.0,104.4,99.7
331,哈尔滨伏尔加庄园,20221127,130,64,66,65.0,105.2,98.8
332,哈尔滨伏尔加庄园,20221128,65,0,65,130.0,92.6,92.0
333,哈尔滨伏尔加庄园,20221129,120,59,61,65.0,102.8,97.4
334,哈尔滨伏尔加庄园,20221130,66,0,66,120.0,89.2,96.6
335,哈尔滨伏尔加庄园,20221201,122,61,61,66.0,100.6,102.5
336,哈尔滨伏尔加庄园,20221202,128,59,69,122.0,100.2,102.7
337,哈尔滨伏尔加庄园,20221203,65,0,65,128.0,100.2,96.4
338,哈尔滨伏尔加庄园,20221204,0,0,0,65.0,76.2,89.5
339,哈尔滨伏尔加庄园,20221205,125,59,66,0.0,88.0,88.6
340,哈尔滨伏尔加庄园,20221206,66,0,66,125.0,76.8,88.7
341,哈尔滨伏尔加庄园,20221207,134,61,73,66.0,78.0,89.1
342,哈尔滨伏尔加庄园,20221208,135,59,76,134.0,92.0,96.1
343,哈尔滨伏尔加庄园,20221209,141,59,82,135.0,120.2,98.2
344,哈尔滨伏尔加庄园,20221210,0,0,0,141.0,95.2,91.6
345,哈尔滨伏尔加庄园,20221211,73,0,73,0.0,96.6,86.7
346,哈尔滨伏尔加庄园,20221212,134,61,73,73.0,96.6,87.3
347,哈尔滨伏尔加庄园,20221213,130,59,71,134.0,95.6,93.8
348,哈尔滨伏尔加庄园,20221214,126,61,65,130.0,92.6,106.4
349,哈尔滨伏尔加庄园,20221215,74,0,74,126.0,107.4,101.3
350,哈尔滨伏尔加庄园,20221216,69,0,69,74.0,106.6,101.6
351,哈尔滨伏尔加庄园,20221217,0,0,0,69.0,79.8,88.2
352,哈尔滨伏尔加庄园,20221218,124,61,63,0.0,78.6,87.1
353,哈尔滨伏尔加庄园,20221219,137,63,74,124.0,80.8,86.7
354,哈尔滨伏尔加庄园,20221220,73,0,73,137.0,80.6,94.0
355,哈尔滨伏尔加庄园,20221221,127,61,66,73.0,92.2,99.4
356,哈尔滨伏尔加庄园,20221222,126,59,67,127.0,117.4,98.6
357,哈尔滨伏尔加庄园,20221223,126,61,65,126.0,117.8,98.2
358,哈尔滨伏尔加庄园,20221224,73,0,73,126.0,105.0,92.9
359,哈尔滨伏尔加庄园,20221225,67,0,67,73.0,103.8,92.2
360,哈尔滨伏尔加庄园,20221226,130,59,71,67.0,104.4,98.3
361,哈尔滨伏尔加庄园,20221227,130,59,71,130.0,105.2,111.3
362,哈尔滨伏尔加庄园,20221228,73,0,73,130.0,94.6,106.2
363,哈尔滨伏尔加庄园,20221229,134,63,71,73.0,106.8,105.9
364,哈尔滨伏尔加庄园,20221230,133,59,74,134.0,120.0,111.9
365,哈尔滨伏尔加庄园,20221231,137,61,76,133.0,121.4,112.9
366,哈尔滨伏尔加庄园,20230101,63,0,63,137.0,108.0,106.6
367,哈尔滨伏尔加庄园,20230102,127,61,66,63.0,118.8,106.7
368,哈尔滨伏尔加庄园,20230103,71,0,71,127.0,106.2,106.5
369,哈尔滨伏尔加庄园,20230104,139,59,80,71.0,107.4,113.7
370,哈尔滨伏尔加庄园,20230105,141,63,78,139.0,108.2,114.8
371,哈尔滨伏尔加庄园,20230106,142,64,78,141.0,124.0,116.0
372,哈尔滨伏尔加庄园,20230107,148,61,87,142.0,128.2,123.5
373,哈尔滨伏尔加庄园,20230108,109,0,109,148.0,135.8,121.0
374,哈尔滨伏尔加庄园,20230109,149,66,83,109.0,137.8,122.6
375,哈尔滨伏尔加庄园,20230110,146,70,76,149.0,138.8,123.5
376,哈尔滨伏尔加庄园,20230111,163,70,93,146.0,143.0,133.5
377,哈尔滨伏尔加庄园,20230112,163,63,100,163.0,146.0,137.1
378,哈尔滨伏尔加庄园,20230113,83,0,83,163.0,140.8,138.3
379,哈尔滨伏尔加庄园,20230114,84,0,84,83.0,127.8,132.8
380,哈尔滨伏尔加庄园,20230115,91,0,91,84.0,116.8,127.8
381,哈尔滨伏尔加庄园,20230116,145,66,79,91.0,113.2,128.1
382,哈尔滨伏尔加庄园,20230117,139,68,71,145.0,108.4,127.2
383,哈尔滨伏尔加庄园,20230118,143,63,80,139.0,120.4,130.6
384,哈尔滨伏尔加庄园,20230119,153,64,89,143.0,134.2,131.0
385,哈尔滨伏尔加庄园,20230120,130,63,67,153.0,142.0,129.4
386,哈尔滨伏尔加庄园,20230121,78,0,78,130.0,128.6,120.9
387,哈尔滨伏尔加庄园,20230122,91,0,91,78.0,119.0,113.7
388,哈尔滨伏尔加庄园,20230123,165,61,104,91.0,123.4,121.9
389,哈尔滨伏尔加庄园,20230124,112,0,112,165.0,115.2,124.7
390,哈尔滨伏尔加庄园,20230125,180,59,121,112.0,125.2,133.6
391,哈尔滨伏尔加庄园,20230126,119,0,119,180.0,133.4,131.0
392,哈尔滨伏尔加庄园,20230127,164,59,105,119.0,148.0,133.5
393,哈尔滨伏尔加庄园,20230128,106,0,106,164.0,136.2,129.8
394,哈尔滨伏尔加庄园,20230129,163,64,99,106.0,146.4,130.8
395,哈尔滨伏尔加庄园,20230130,150,63,87,163.0,140.4,132.8
396,哈尔滨伏尔加庄园,20230131,214,63,151,150.0,159.4,146.4
397,哈尔滨伏尔加庄园,20230201,191,72,119,214.0,164.8,156.4
398,哈尔滨伏尔加庄园,20230202,172,63,109,191.0,178.0,157.1
399,哈尔滨伏尔加庄园,20230203,160,68,92,172.0,177.4,161.9
400,哈尔滨伏尔加庄园,20230204,147,61,86,160.0,176.8,158.6
401,哈尔滨伏尔加庄园,20230205,146,59,87,147.0,163.2,161.3
402,哈尔滨伏尔加庄园,20230206,145,61,84,146.0,154.0,159.4
403,哈尔滨伏尔加庄园,20230207,163,70,93,145.0,152.2,165.1
404,哈尔滨伏尔加庄园,20230208,152,61,91,163.0,150.6,164.0
405,哈尔滨伏尔加庄园,20230209,154,59,95,152.0,152.0,164.4
406,哈尔滨伏尔加庄园,20230210,156,63,93,154.0,154.0,158.6
407,哈尔滨伏尔加庄园,20230211,159,70,89,156.0,156.8,155.4
408,哈尔滨伏尔加庄园,20230212,95,0,95,159.0,143.2,147.7
409,哈尔滨伏尔加庄园,20230213,149,63,86,95.0,142.6,146.6
410,哈尔滨伏尔加庄园,20230214,143,64,79,149.0,140.4,146.2
411,哈尔滨伏尔加庄园,20230215,142,59,83,143.0,137.6,145.8
412,哈尔滨伏尔加庄园,20230216,151,72,79,142.0,136.0,146.4
413,哈尔滨伏尔加庄园,20230217,137,61,76,151.0,144.4,143.8
414,哈尔滨伏尔加庄园,20230218,99,0,99,137.0,134.4,138.5
415,哈尔滨伏尔加庄园,20230219,82,0,82,99.0,122.2,131.3
416,哈尔滨伏尔加庄园,20230220,141,59,82,82.0,122.0,129.8
417,哈尔滨伏尔加庄园,20230221,137,63,74,141.0,119.2,127.6
418,哈尔滨伏尔加庄园,20230222,134,64,70,137.0,118.6,131.5
419,哈尔滨伏尔加庄园,20230223,137,61,76,134.0,126.2,130.3
420,哈尔滨伏尔加庄园,20230224,140,64,76,137.0,137.8,130.0
421,哈尔滨伏尔加庄园,20230225,134,61,73,140.0,136.4,129.2
422,哈尔滨伏尔加庄园,20230226,84,0,84,134.0,125.8,122.5
423,哈尔滨伏尔加庄园,20230227,141,63,78,84.0,127.2,122.9
424,哈尔滨伏尔加庄园,20230228,69,0,69,141.0,113.6,119.9
425,哈尔滨伏尔加庄园,20230301,132,61,71,69.0,112.0,124.9
426,哈尔滨伏尔加庄园,20230302,137,66,71,132.0,112.6,124.5
427,哈尔滨伏尔加庄园,20230303,141,61,80,137.0,124.0,124.9
428,哈尔滨伏尔加庄园,20230304,91,0,91,141.0,114.0,120.6
429,哈尔滨伏尔加庄园,20230305,138,59,79,91.0,127.8,120.7
430,哈尔滨伏尔加庄园,20230306,135,59,76,138.0,128.4,120.2
431,哈尔滨伏尔加庄园,20230307,132,59,73,135.0,127.4,120.0
432,哈尔滨伏尔加庄园,20230308,69,0,69,132.0,113.0,118.5
433,哈尔滨伏尔加庄园,20230309,143,61,82,69.0,123.4,118.7
434,哈尔滨伏尔加庄园,20230310,69,0,69,143.0,109.6,118.7
435,哈尔滨伏尔加庄园,20230311,78,0,78,69.0,98.2,113.3
436,哈尔滨伏尔加庄园,20230312,82,0,82,78.0,88.2,107.8
437,哈尔滨伏尔加庄园,20230313,76,0,76,82.0,89.6,101.3
438,哈尔滨伏尔加庄园,20230314,132,59,73,76.0,87.4,105.4
439,哈尔滨伏尔加庄园,20230315,145,66,79,132.0,102.6,106.1
440,哈尔滨伏尔加庄园,20230316,78,0,78,145.0,102.6,100.4
441,哈尔滨伏尔加庄园,20230317,80,0,80,78.0,102.2,95.2
442,哈尔滨伏尔加庄园,20230318,135,61,74,80.0,114.0,101.8
443,哈尔滨伏尔加庄园,20230319,83,0,83,135.0,104.2,95.8
444,哈尔滨伏尔加庄园,20230320,70,0,70,83.0,89.2,95.9
445,哈尔滨伏尔加庄园,20230321,140,64,76,70.0,101.6,102.1
446,哈尔滨伏尔加庄园,20230322,127,66,61,140.0,111.0,106.6
447,哈尔滨伏尔加庄园,20230323,73,0,73,127.0,98.6,106.3
448,哈尔滨伏尔加庄园,20230324,137,59,78,73.0,109.4,106.8
449,哈尔滨伏尔加庄园,20230325,126,61,65,137.0,120.6,104.9
450,哈尔滨伏尔加庄园,20230326,80,0,80,126.0,108.6,105.1
451,哈尔滨伏尔加庄园,20230327,137,61,76,80.0,110.6,110.8
452,哈尔滨伏尔加庄园,20230328,139,68,71,137.0,123.8,111.2
453,哈尔滨伏尔加庄园,20230329,143,61,82,139.0,125.0,117.2
454,哈尔滨伏尔加庄园,20230330,147,63,84,143.0,129.2,124.9
455,哈尔滨伏尔加庄园,20230331,133,59,74,147.0,139.8,124.2
456,哈尔滨伏尔加庄园,20230401,135,59,76,133.0,139.4,125.0
457,哈尔滨伏尔加庄园,20230402,86,0,86,135.0,128.8,126.3
458,哈尔滨伏尔加庄园,20230403,153,61,92,86.0,130.8,127.9
459,哈尔滨伏尔加庄园,20230404,145,59,86,153.0,130.4,129.8
460,哈尔滨伏尔加庄园,20230405,76,0,76,145.0,119.0,129.4
461,哈尔滨伏尔加庄园,20230406,132,59,73,76.0,118.4,128.9
462,哈尔滨伏尔加庄园,20230407,135,59,76,132.0,128.2,128.5
463,哈尔滨伏尔加庄园,20230408,86,0,86,135.0,114.8,122.8
464,哈尔滨伏尔加庄园,20230409,154,59,95,86.0,116.6,123.5
465,哈尔滨伏尔加庄园,20230410,148,61,87,154.0,131.0,125.0
466,哈尔滨伏尔加庄园,20230411,157,61,96,148.0,136.0,127.2
467,哈尔滨伏尔加庄园,20230412,143,63,80,157.0,137.6,132.9
468,哈尔滨伏尔加庄园,20230413,139,63,76,143.0,148.2,131.5
469,哈尔滨伏尔加庄园,20230414,138,59,79,139.0,145.0,130.8
470,哈尔滨伏尔加庄园,20230415,82,0,82,138.0,131.8,131.4
471,哈尔滨伏尔加庄园,20230416,91,0,91,82.0,118.6,127.3
472,哈尔滨伏尔加庄园,20230417,158,66,92,91.0,121.6,129.6
473,哈尔滨伏尔加庄园,20230418,95,0,95,158.0,112.8,130.5
474,哈尔滨伏尔加庄园,20230419,156,59,97,95.0,116.4,130.7
475,哈尔滨伏尔加庄园,20230420,172,72,100,156.0,134.4,133.1
476,哈尔滨伏尔加庄园,20230421,143,59,84,172.0,144.8,131.7
477,哈尔滨伏尔加庄园,20230422,165,63,102,143.0,146.2,133.9
478,哈尔滨伏尔加庄园,20230423,167,63,104,165.0,160.6,136.7
479,哈尔滨伏尔加庄园,20230424,174,61,113,167.0,164.2,140.3
480,哈尔滨伏尔加庄园,20230425,169,61,108,174.0,163.6,149.0
481,哈尔滨伏尔加庄园,20230426,160,61,99,169.0,167.0,155.9
482,哈尔滨伏尔加庄园,20230427,181,72,109,160.0,170.2,158.2
483,哈尔滨伏尔加庄园,20230428,225,68,157,181.0,181.8,171.2
484,哈尔滨伏尔加庄园,20230429,155,0,155,225.0,178.0,171.1
485,哈尔滨伏尔加庄园,20230430,147,0,147,155.0,173.6,168.6
486,哈尔滨伏尔加庄园,20230501,229,59,170,147.0,187.4,177.2
487,哈尔滨伏尔加庄园,20230502,138,0,138,229.0,178.8,174.5
488,哈尔滨伏尔加庄园,20230503,110,0,110,138.0,155.8,168.8
489,哈尔滨伏尔加庄园,20230504,152,66,86,110.0,155.2,166.6
490,哈尔滨伏尔加庄园,20230505,89,0,89,152.0,143.6,158.6
491,哈尔滨伏尔加庄园,20230506,138,59,79,89.0,125.4,156.4
492,哈尔滨伏尔加庄园,20230507,143,59,84,138.0,126.4,152.6
493,哈尔滨伏尔加庄园,20230508,142,63,79,143.0,132.8,144.3
494,哈尔滨伏尔加庄园,20230509,132,61,71,142.0,128.8,142.0
495,哈尔滨伏尔加庄园,20230510,91,0,91,132.0,129.2,136.4
496,哈尔滨伏尔加庄园,20230511,133,59,74,91.0,128.2,126.8
497,哈尔滨伏尔加庄园,20230512,130,61,69,133.0,125.6,126.0
498,哈尔滨伏尔加庄园,20230513,83,0,83,130.0,113.8,123.3
499,哈尔滨伏尔加庄园,20230514,155,68,87,83.0,118.4,123.6
500,哈尔滨伏尔加庄园,20230515,150,61,89,155.0,130.2,129.7
501,哈尔滨伏尔加庄园,20230516,149,63,86,150.0,133.4,130.8
502,哈尔滨伏尔加庄园,20230517,137,59,78,149.0,134.8,130.2
503,哈尔滨伏尔加庄园,20230518,170,68,102,137.0,152.2,133.0
504,哈尔滨伏尔加庄园,20230519,151,64,87,170.0,151.4,134.9
505,哈尔滨伏尔加庄园,20230520,96,0,96,151.0,140.6,135.4
506,哈尔滨伏尔加庄园,20230521,73,0,73,96.0,125.4,129.4
507,哈尔滨伏尔加庄园,20230522,138,59,79,73.0,125.6,130.2
508,哈尔滨伏尔加庄园,20230523,140,61,79,138.0,119.6,135.9
509,哈尔滨伏尔加庄园,20230524,145,61,84,140.0,118.4,134.9
510,哈尔滨伏尔加庄园,20230525,168,66,102,145.0,132.8,136.7
511,哈尔滨伏尔加庄园,20230526,177,64,113,168.0,153.6,139.5
512,哈尔滨伏尔加庄园,20230527,87,0,87,177.0,143.4,134.5
513,哈尔滨伏尔加庄园,20230528,89,0,89,87.0,133.2,126.4
514,哈尔滨伏尔加庄园,20230529,191,66,125,89.0,142.4,130.4
515,哈尔滨伏尔加庄园,20230530,194,68,126,191.0,147.6,140.2
516,哈尔滨伏尔加庄园,20230531,166,66,100,194.0,145.4,149.5
517,哈尔滨伏尔加庄园,20230601,150,61,89,166.0,158.0,150.7
518,哈尔滨伏尔加庄园,20230602,160,63,97,150.0,172.2,152.7
519,哈尔滨伏尔加庄园,20230603,95,0,95,160.0,153.0,147.7
520,哈尔滨伏尔加庄园,20230604,176,59,117,95.0,149.4,148.5
521,哈尔滨伏尔加庄园,20230605,181,64,117,176.0,152.4,148.9
522,哈尔滨伏尔加庄园,20230606,95,0,95,181.0,141.4,149.7
523,哈尔滨伏尔加庄园,20230607,174,61,113,95.0,144.2,158.2
524,哈尔滨伏尔加庄园,20230608,178,68,110,174.0,160.8,156.9
525,哈尔滨伏尔加庄园,20230609,93,0,93,178.0,144.2,146.8
526,哈尔滨伏尔加庄园,20230610,112,0,112,93.0,130.4,141.4
527,哈尔滨伏尔加庄园,20230611,160,63,97,112.0,143.4,142.4
528,哈尔滨伏尔加庄园,20230612,173,63,110,160.0,143.2,143.7
529,哈尔滨伏尔加庄园,20230613,198,59,139,173.0,147.2,154.0
530,哈尔滨伏尔加庄园,20230614,204,76,128,198.0,169.4,156.8
531,哈尔滨伏尔加庄园,20230615,80,0,80,204.0,163.0,146.7
532,哈尔滨伏尔加庄园,20230616,178,61,117,80.0,166.6,155.0
533,哈尔滨伏尔加庄园,20230617,117,0,117,178.0,155.4,149.3
534,哈尔滨伏尔加庄园,20230618,191,59,132,117.0,154.0,150.6
535,哈尔滨伏尔加庄园,20230619,185,63,122,191.0,150.2,159.8
536,哈尔滨伏尔加庄园,20230620,189,59,130,185.0,172.0,167.5
537,哈尔滨伏尔加庄园,20230621,183,66,117,189.0,173.0,169.8
538,哈尔滨伏尔加庄园,20230622,128,0,128,183.0,175.2,165.3
539,哈尔滨伏尔加庄园,20230623,134,0,134,128.0,163.8,158.9
540,哈尔滨伏尔加庄园,20230624,174,59,115,134.0,161.6,155.9
541,哈尔滨伏尔加庄园,20230625,160,63,97,174.0,155.8,163.9
542,哈尔滨伏尔加庄园,20230626,163,63,100,160.0,151.8,162.4
543,哈尔滨伏尔加庄园,20230627,144,64,80,163.0,155.0,165.1
544,哈尔滨伏尔加庄园,20230628,151,59,92,144.0,158.4,161.1
545,哈尔滨伏尔加庄园,20230629,109,0,109,151.0,145.4,153.5
546,哈尔滨伏尔加庄园,20230630,163,63,100,109.0,146.0,150.9
547,哈尔滨伏尔加庄园,20230701,164,59,105,163.0,146.2,149.0
548,哈尔滨伏尔加庄园,20230702,171,59,112,164.0,151.6,153.3
549,哈尔滨伏尔加庄园,20230703,180,70,110,171.0,157.4,157.9
550,哈尔滨伏尔加庄园,20230704,170,64,106,180.0,169.6,157.5
551,哈尔滨伏尔加庄园,20230705,176,66,110,170.0,172.2,159.1
552,哈尔滨伏尔加庄园,20230706,183,66,117,176.0,176.0,161.1
553,哈尔滨伏尔加庄园,20230707,191,68,123,183.0,180.0,165.8
554,哈尔滨伏尔加庄园,20230708,194,59,135,191.0,182.8,170.1
555,哈尔滨伏尔加庄园,20230709,197,61,136,194.0,188.2,178.9
556,哈尔滨伏尔加庄园,20230710,174,66,108,197.0,187.8,180.0
557,哈尔滨伏尔加庄园,20230711,197,72,125,174.0,190.6,183.3
558,哈尔滨伏尔加庄园,20230712,185,66,119,197.0,189.4,184.7
559,哈尔滨伏尔加庄园,20230713,200,61,139,185.0,190.6,186.7
560,哈尔滨伏尔加庄园,20230714,172,59,113,200.0,185.6,186.9
561,哈尔滨伏尔加庄园,20230715,194,68,126,172.0,189.6,188.7
562,哈尔滨伏尔加庄园,20230716,210,74,136,194.0,192.2,191.4
563,哈尔滨伏尔加庄园,20230717,188,63,125,210.0,192.8,191.1
564,哈尔滨伏尔加庄园,20230718,219,68,151,188.0,196.6,193.6
565,哈尔滨伏尔加庄园,20230719,209,68,141,219.0,204.0,194.8
566,哈尔滨伏尔加庄园,20230720,206,63,143,209.0,206.4,198.0
567,哈尔滨伏尔加庄园,20230721,192,66,126,206.0,202.8,197.5
568,哈尔滨伏尔加庄园,20230722,193,63,130,192.0,203.8,198.3
569,哈尔滨伏尔加庄园,20230723,195,59,136,193.0,199.0,197.8
570,哈尔滨伏尔加庄园,20230724,212,76,136,195.0,199.6,201.8
571,哈尔滨伏尔加庄园,20230725,211,70,141,212.0,200.6,203.5
572,哈尔滨伏尔加庄园,20230726,207,64,143,211.0,203.6,203.2
573,哈尔滨伏尔加庄园,20230727,226,68,158,207.0,210.2,207.0
574,哈尔滨伏尔加庄园,20230728,200,68,132,226.0,211.2,205.1
575,哈尔滨伏尔加庄园,20230729,223,64,159,200.0,213.4,206.5
576,哈尔滨伏尔加庄园,20230730,229,59,170,223.0,217.0,208.8
577,哈尔滨伏尔加庄园,20230731,220,63,157,229.0,219.6,211.6
578,哈尔滨伏尔加庄园,20230801,211,68,143,220.0,216.6,213.4
579,哈尔滨伏尔加庄园,20230802,216,64,152,211.0,219.8,215.5
580,哈尔滨伏尔加庄园,20230803,208,70,138,216.0,216.8,215.1
581,哈尔滨伏尔加庄园,20230804,194,64,130,208.0,209.8,213.4
582,哈尔滨伏尔加庄园,20230805,222,61,161,194.0,210.2,214.9
583,哈尔滨伏尔加庄园,20230806,248,63,185,222.0,217.6,217.1
584,哈尔滨伏尔加庄园,20230807,207,59,148,248.0,215.8,217.8
585,哈尔滨伏尔加庄园,20230808,190,64,126,207.0,212.2,214.5
586,哈尔滨伏尔加庄园,20230809,189,63,126,190.0,211.2,210.5
587,哈尔滨伏尔加庄园,20230810,178,59,119,189.0,202.4,206.3
588,哈尔滨伏尔加庄园,20230811,112,0,112,178.0,175.2,196.4
589,哈尔滨伏尔加庄园,20230812,169,64,105,112.0,167.6,191.7
590,哈尔滨伏尔加庄园,20230813,113,0,113,169.0,152.2,182.2
591,哈尔滨伏尔加庄园,20230814,199,61,138,113.0,154.2,182.7
592,哈尔滨伏尔加庄园,20230815,191,68,123,199.0,156.8,179.6
593,哈尔滨伏尔加庄园,20230816,181,66,115,191.0,170.6,172.9
594,哈尔滨伏尔加庄园,20230817,159,63,96,181.0,168.6,168.1
595,哈尔滨伏尔加庄园,20230818,202,68,134,159.0,186.4,169.3
596,哈尔滨伏尔加庄园,20230819,177,59,118,202.0,182.0,168.1
597,哈尔滨伏尔加庄园,20230820,174,61,113,177.0,178.6,167.7
598,哈尔滨伏尔加庄园,20230821,195,72,123,174.0,181.4,176.0
599,哈尔滨伏尔加庄园,20230822,117,0,117,195.0,173.0,170.8
600,哈尔滨伏尔加庄园,20230823,154,59,95,117.0,163.4,174.9
601,哈尔滨伏尔加庄园,20230824,178,68,110,154.0,163.6,172.8
602,哈尔滨伏尔加庄园,20230825,189,64,125,178.0,166.6,172.6
603,哈尔滨伏尔加庄园,20230826,173,61,112,189.0,162.2,171.8
604,哈尔滨伏尔加庄园,20230827,169,64,105,173.0,172.6,172.8
605,哈尔滨伏尔加庄园,20230828,168,59,109,169.0,175.4,169.4
606,哈尔滨伏尔加庄园,20230829,148,64,84,168.0,169.4,166.5
607,哈尔滨伏尔加庄园,20230830,145,61,84,148.0,160.6,163.6
608,哈尔滨伏尔加庄园,20230831,159,68,91,145.0,157.8,160.0
609,哈尔滨伏尔加庄园,20230901,159,66,93,159.0,155.8,164.2
610,哈尔滨伏尔加庄园,20230902,158,59,99,159.0,153.8,164.6
611,哈尔滨伏尔加庄园,20230903,151,59,92,158.0,154.4,161.9
612,哈尔滨伏尔加庄园,20230904,150,63,87,151.0,155.4,158.0
613,哈尔滨伏尔加庄园,20230905,158,61,97,150.0,155.2,156.5
614,哈尔滨伏尔加庄园,20230906,84,0,84,158.0,140.2,148.0
615,哈尔滨伏尔加庄园,20230907,168,68,100,84.0,142.2,148.0
616,哈尔滨伏尔加庄园,20230908,169,64,105,168.0,145.8,150.1
617,哈尔滨伏尔加庄园,20230909,166,70,96,169.0,149.0,152.2
618,哈尔滨伏尔加庄园,20230910,178,61,117,166.0,153.0,154.1
619,哈尔滨伏尔加庄园,20230911,174,66,108,178.0,171.0,155.6
620,哈尔滨伏尔加庄园,20230912,87,0,87,174.0,154.8,148.5
621,哈尔滨伏尔加庄园,20230913,155,64,91,87.0,152.0,148.9
622,哈尔滨伏尔加庄园,20230914,153,64,89,155.0,149.4,149.2
623,哈尔滨伏尔加庄园,20230915,166,66,100,153.0,147.0,150.0
624,哈尔滨伏尔加庄园,20230916,162,63,99,166.0,144.6,157.8
625,哈尔滨伏尔加庄园,20230917,100,0,100,162.0,147.2,151.0
626,哈尔滨伏尔加庄园,20230918,165,66,99,100.0,149.2,150.6
627,哈尔滨伏尔加庄园,20230919,150,63,87,165.0,148.6,149.0
628,哈尔滨伏尔加庄园,20230920,160,64,96,150.0,147.4,147.2
629,哈尔滨伏尔加庄园,20230921,162,66,96,160.0,147.4,146.0
630,哈尔滨伏尔加庄园,20230922,176,85,91,162.0,162.6,154.9
631,哈尔滨伏尔加庄园,20230923,163,61,102,176.0,162.2,155.7
632,哈尔滨伏尔加庄园,20230924,177,68,109,163.0,167.6,158.1
633,哈尔滨伏尔加庄园,20230925,170,66,104,177.0,169.6,158.5
634,哈尔滨伏尔加庄园,20230926,170,66,104,170.0,171.2,159.3
635,哈尔滨伏尔加庄园,20230927,160,68,92,170.0,168.0,165.3
636,哈尔滨伏尔加庄园,20230928,199,63,136,160.0,175.2,168.7
637,哈尔滨伏尔加庄园,20230929,138,0,138,199.0,167.4,167.5
638,哈尔滨伏尔加庄园,20230930,193,0,193,138.0,172.0,170.8
639,哈尔滨伏尔加庄园,20231001,228,61,167,193.0,183.6,177.4
640,哈尔滨伏尔加庄园,20231002,219,59,160,228.0,195.4,181.7
641,哈尔滨伏尔加庄园,20231003,224,61,163,219.0,200.4,187.8
642,哈尔滨伏尔加庄园,20231004,119,0,119,224.0,196.6,182.0
643,哈尔滨伏尔加庄园,20231005,173,61,112,119.0,192.6,182.3
644,哈尔滨伏尔加庄园,20231006,155,59,96,173.0,178.0,180.8
645,哈尔滨伏尔加庄园,20231007,166,64,102,155.0,167.4,181.4
646,哈尔滨伏尔加庄园,20231008,84,0,84,166.0,139.4,169.9
647,哈尔滨伏尔加庄园,20231009,144,61,83,84.0,144.4,170.5
648,哈尔滨伏尔加庄园,20231010,135,59,76,144.0,136.8,164.7
649,哈尔滨伏尔加庄园,20231011,150,63,87,135.0,135.8,156.9
650,哈尔滨伏尔加庄园,20231012,150,59,91,150.0,132.6,150.0
651,哈尔滨伏尔加庄园,20231013,137,63,74,150.0,143.2,141.3
652,哈尔滨伏尔加庄园,20231014,138,59,79,137.0,142.0,143.2
653,哈尔滨伏尔加庄园,20231015,145,61,84,138.0,144.0,140.4
654,哈尔滨伏尔加庄园,20231016,147,64,83,145.0,143.4,139.6
655,哈尔滨伏尔加庄园,20231017,149,63,86,147.0,143.2,137.9
656,哈尔滨伏尔加庄园,20231018,149,63,86,149.0,145.6,144.4
657,哈尔滨伏尔加庄园,20231019,149,66,83,149.0,147.8,144.9
658,哈尔滨伏尔加庄园,20231020,137,64,73,149.0,146.2,145.1
659,哈尔滨伏尔加庄园,20231021,71,0,71,137.0,131.0,137.2
660,哈尔滨伏尔加庄园,20231022,139,59,80,71.0,129.0,136.1
661,哈尔滨伏尔加庄园,20231023,134,68,66,139.0,126.0,135.8
662,哈尔滨伏尔加庄园,20231024,130,59,71,134.0,122.2,135.0
663,哈尔滨伏尔加庄园,20231025,152,74,78,130.0,125.2,135.7
664,哈尔滨伏尔加庄园,20231026,127,66,61,152.0,136.4,133.7
665,哈尔滨伏尔加庄园,20231027,139,59,80,127.0,136.4,132.7
666,哈尔滨伏尔加庄园,20231028,78,0,78,139.0,125.2,125.6
667,哈尔滨伏尔加庄园,20231029,137,64,73,78.0,126.6,124.4
668,哈尔滨伏尔加庄园,20231030,74,0,74,137.0,111.0,118.1
669,哈尔滨伏尔加庄园,20231031,126,63,63,74.0,110.8,123.6
670,哈尔滨伏尔加庄园,20231101,135,61,74,126.0,110.0,123.2
671,哈尔滨伏尔加庄园,20231102,128,63,65,135.0,120.0,122.6
672,哈尔滨伏尔加庄园,20231103,156,72,84,128.0,123.8,125.2
673,哈尔滨伏尔加庄园,20231104,126,61,65,156.0,134.2,122.6
674,哈尔滨伏尔加庄园,20231105,130,63,67,126.0,135.0,122.9
675,哈尔滨伏尔加庄园,20231106,137,63,74,130.0,135.4,122.7
676,哈尔滨伏尔加庄园,20231107,63,63,0,137.0,122.4,121.2
677,哈尔滨伏尔加庄园,20231108,136,70,66,63.0,118.4,121.1
678,哈尔滨伏尔加庄园,20231109,142,66,76,136.0,121.6,127.9
679,哈尔滨伏尔加庄园,20231110,142,68,74,142.0,124.0,129.5
680,哈尔滨伏尔加庄园,20231111,130,59,71,142.0,122.6,129.0
681,哈尔滨伏尔加庄园,20231112,83,0,83,130.0,126.6,124.5
682,哈尔滨伏尔加庄园,20231113,147,76,71,83.0,128.8,123.6
683,哈尔滨伏尔加庄园,20231114,142,63,79,147.0,128.8,125.2
684,哈尔滨伏尔加庄园,20231115,136,66,70,142.0,127.6,125.8
685,哈尔滨伏尔加庄园,20231116,137,61,76,136.0,129.0,125.8
686,哈尔滨伏尔加庄园,20231117,133,59,74,137.0,139.0,132.8
687,哈尔滨伏尔加庄园,20231118,138,64,74,133.0,137.2,133.0
688,哈尔滨伏尔加庄园,20231119,141,59,82,138.0,137.0,132.9
689,哈尔滨伏尔加庄园,20231120,146,64,82,141.0,139.0,133.3
690,哈尔滨伏尔加庄园,20231121,149,70,79,146.0,141.4,135.2
691,哈尔滨伏尔加庄园,20231122,159,72,87,149.0,146.6,142.8
692,哈尔滨伏尔加庄园,20231123,126,59,67,159.0,144.2,140.7
693,哈尔滨伏尔加庄园,20231124,157,66,91,126.0,147.4,142.2
694,哈尔滨伏尔加庄园,20231125,137,59,78,157.0,145.6,142.3
695,哈尔滨伏尔加庄园,20231126,83,0,83,137.0,132.4,136.9
696,哈尔滨伏尔加庄园,20231127,141,63,78,83.0,128.8,137.7
697,哈尔滨伏尔加庄园,20231128,149,66,83,141.0,133.4,138.8
698,哈尔滨伏尔加庄园,20231129,145,66,79,149.0,131.0,139.2
699,哈尔滨伏尔加庄园,20231130,151,64,87,145.0,133.8,139.7
700,哈尔滨伏尔加庄园,20231201,156,70,86,151.0,148.4,140.4
701,哈尔滨伏尔加庄园,20231202,132,59,73,156.0,146.6,137.7
702,哈尔滨伏尔加庄园,20231203,76,0,76,132.0,132.0,132.7
703,哈尔滨伏尔加庄园,20231204,152,68,84,76.0,133.4,132.2
704,哈尔滨伏尔加庄园,20231205,150,70,80,152.0,133.2,133.5
705,哈尔滨伏尔加庄园,20231206,159,66,93,150.0,133.8,141.1
706,哈尔滨伏尔加庄园,20231207,143,70,73,159.0,136.0,141.3
707,哈尔滨伏尔加庄园,20231208,152,68,84,143.0,151.2,141.6
708,哈尔滨伏尔加庄园,20231209,159,59,100,152.0,152.6,143.0
709,哈尔滨伏尔加庄园,20231210,142,59,83,159.0,151.0,142.1
710,哈尔滨伏尔加庄园,20231211,156,74,82,142.0,150.4,142.1
711,哈尔滨伏尔加庄园,20231212,142,68,74,156.0,150.2,143.1
712,哈尔滨伏尔加庄园,20231213,140,64,76,142.0,147.8,149.5
713,哈尔滨伏尔加庄园,20231214,159,66,93,140.0,147.8,150.2
714,哈尔滨伏尔加庄园,20231215,169,70,99,159.0,153.2,152.1
715,哈尔滨伏尔加庄园,20231216,145,59,86,169.0,151.0,150.7
716,哈尔滨伏尔加庄园,20231217,173,61,112,145.0,157.2,153.7
717,哈尔滨伏尔加庄园,20231218,175,76,99,173.0,164.2,156.0
718,哈尔滨伏尔加庄园,20231219,170,66,104,175.0,166.4,157.1
719,哈尔滨伏尔加庄园,20231220,172,72,100,170.0,167.0,160.1
720,哈尔滨伏尔加庄园,20231221,176,70,106,172.0,173.2,162.1
721,哈尔滨伏尔加庄园,20231222,176,72,104,176.0,173.8,165.5
722,哈尔滨伏尔加庄园,20231223,171,66,105,176.0,173.0,168.6
723,哈尔滨伏尔加庄园,20231224,150,59,91,171.0,169.0,167.7
724,哈尔滨伏尔加庄园,20231225,108,0,108,150.0,156.2,161.6
725,哈尔滨伏尔加庄园,20231226,197,76,121,108.0,160.4,166.8
726,哈尔滨伏尔加庄园,20231227,216,72,144,197.0,168.4,171.1
727,哈尔滨伏尔加庄园,20231228,191,72,119,216.0,172.4,172.7
728,哈尔滨伏尔加庄园,20231229,182,80,102,191.0,178.8,173.9
729,哈尔滨伏尔加庄园,20231230,182,64,118,182.0,193.6,174.9
730,哈尔滨伏尔加庄园,20231231,184,61,123,182.0,191.0,175.7
731,哈尔滨伏尔加庄园,20240101,181,63,118,184.0,184.0,176.2
732,哈尔滨伏尔加庄园,20240102,181,85,96,181.0,182.0,177.2
733,哈尔滨伏尔加庄园,20240103,207,82,125,181.0,187.0,182.9
734,哈尔滨伏尔加庄园,20240104,385,110,275,207.0,227.6,210.6
735,哈尔滨伏尔加庄园,20240105,338,102,236,385.0,258.4,224.7
736,哈尔滨伏尔加庄园,20240106,268,85,183,338.0,275.8,229.9
737,哈尔滨伏尔加庄园,20240107,332,91,241,268.0,306.0,244.0
738,哈尔滨伏尔加庄园,20240108,272,102,170,332.0,319.0,253.0
739,哈尔滨伏尔加庄园,20240109,237,101,136,272.0,289.4,258.5
740,哈尔滨伏尔加庄园,20240110,241,93,148,237.0,270.0,264.2
741,哈尔滨伏尔加庄园,20240111,208,85,123,241.0,258.0,266.9
742,哈尔滨伏尔加庄园,20240112,218,82,136,208.0,235.2,270.6
743,哈尔滨伏尔加庄园,20240113,231,68,163,218.0,227.0,273.0
744,哈尔滨伏尔加庄园,20240114,222,74,148,231.0,224.0,256.7
745,哈尔滨伏尔加庄园,20240115,210,76,134,222.0,217.8,243.9
746,哈尔滨伏尔加庄园,20240116,201,89,112,210.0,216.4,237.2
747,哈尔滨伏尔加庄园,20240117,193,68,125,201.0,211.4,223.3
748,哈尔滨伏尔加庄园,20240118,203,72,131,193.0,205.8,216.4
749,哈尔滨伏尔加庄园,20240119,179,64,115,203.0,197.2,210.6
750,哈尔滨伏尔加庄园,20240120,167,59,108,179.0,188.6,203.2
751,哈尔滨伏尔加庄园,20240121,188,66,122,167.0,186.0,201.2
752,哈尔滨伏尔加庄园,20240122,179,66,113,188.0,183.2,197.3
753,哈尔滨伏尔加庄园,20240123,193,72,121,179.0,181.2,193.5
754,哈尔滨伏尔加庄园,20240124,205,74,131,193.0,186.4,191.8
755,哈尔滨伏尔加庄园,20240125,184,66,118,205.0,189.8,189.2
756,哈尔滨伏尔加庄园,20240126,203,68,135,184.0,192.8,189.4
757,哈尔滨伏尔加庄园,20240127,195,63,132,203.0,196.0,189.6
758,哈尔滨伏尔加庄园,20240128,134,0,134,195.0,184.2,182.7
759,哈尔滨伏尔加庄园,20240129,204,63,141,134.0,184.0,185.2
760,哈尔滨伏尔加庄园,20240130,175,66,109,204.0,182.2,186.0
761,哈尔滨伏尔加庄园,20240131,174,68,106,175.0,176.4,184.6
762,哈尔滨伏尔加庄园,20240201,199,68,131,174.0,177.2,186.6
763,哈尔滨伏尔加庄园,20240202,178,61,117,199.0,186.0,185.1
764,哈尔滨伏尔加庄园,20240203,134,0,134,178.0,172.0,178.0
765,哈尔滨伏尔加庄园,20240204,164,68,96,134.0,169.8,176.0
766,哈尔滨伏尔加庄园,20240205,176,66,110,164.0,170.2,173.3
767,哈尔滨伏尔加庄园,20240206,117,0,117,176.0,153.8,165.5
768,哈尔滨伏尔加庄园,20240207,159,59,100,117.0,150.0,168.0
769,哈尔滨伏尔加庄园,20240208,171,66,105,159.0,157.4,164.7
770,哈尔滨伏尔加庄园,20240209,86,0,86,171.0,141.8,155.8
771,哈尔滨伏尔加庄园,20240210,118,0,118,86.0,130.2,150.2
772,哈尔滨伏尔加庄园,20240211,149,0,149,118.0,136.6,145.2
773,哈尔滨伏尔加庄园,20240212,157,0,157,149.0,136.2,143.1
774,哈尔滨伏尔加庄园,20240213,212,0,212,157.0,144.4,150.9
775,哈尔滨伏尔加庄园,20240214,181,0,181,212.0,163.4,152.6
776,哈尔滨伏尔加庄园,20240215,234,66,168,181.0,186.6,158.4
777,哈尔滨伏尔加庄园,20240216,230,63,167,234.0,202.8,169.7
778,哈尔滨伏尔加庄园,20240217,206,59,147,230.0,212.6,174.4
779,哈尔滨伏尔加庄园,20240218,196,64,132,206.0,209.4,176.9
780,哈尔滨伏尔加庄园,20240219,164,68,96,196.0,206.0,184.7
781,哈尔滨伏尔加庄园,20240220,163,63,100,164.0,191.8,189.2
782,哈尔滨伏尔加庄园,20240221,142,64,78,163.0,174.2,188.5
783,哈尔滨伏尔加庄园,20240222,141,59,82,142.0,161.2,186.9
784,哈尔滨伏尔加庄园,20240223,134,63,71,141.0,148.8,179.1
785,哈尔滨伏尔加庄园,20240224,76,0,76,134.0,131.2,168.6
786,哈尔滨伏尔加庄园,20240225,76,0,76,76.0,113.8,152.8
787,哈尔滨伏尔加庄园,20240226,145,59,86,76.0,114.4,144.3
788,哈尔滨伏尔加庄园,20240227,142,59,83,145.0,114.6,137.9
789,哈尔滨伏尔加庄园,20240228,147,68,79,142.0,117.2,133.0
790,哈尔滨伏尔加庄园,20240229,71,0,71,147.0,116.2,123.7
791,哈尔滨伏尔加庄园,20240301,71,0,71,71.0,115.2,114.5
792,哈尔滨伏尔加庄园,20240302,82,0,82,71.0,102.6,108.5
793,哈尔滨伏尔加庄园,20240303,69,0,69,82.0,88.0,101.3
794,哈尔滨伏尔加庄园,20240304,141,61,80,69.0,86.8,102.0
795,哈尔滨伏尔加庄园,20240305,142,68,74,141.0,101.0,108.6
796,哈尔滨伏尔加庄园,20240306,74,0,74,142.0,101.6,108.4
797,哈尔滨伏尔加庄园,20240307,127,61,66,74.0,110.6,106.6
798,哈尔滨伏尔加庄园,20240308,127,61,66,127.0,122.2,105.1
799,哈尔滨伏尔加庄园,20240309,124,59,65,127.0,118.8,102.8
800,哈尔滨伏尔加庄园,20240310,135,59,76,124.0,117.4,109.2
801,哈尔滨伏尔加庄园,20240311,133,66,67,135.0,129.2,115.4
802,哈尔滨伏尔加庄园,20240312,126,59,67,133.0,129.0,119.8
803,哈尔滨伏尔加庄园,20240313,130,63,67,126.0,129.6,125.9
804,哈尔滨伏尔加庄园,20240314,137,59,78,130.0,132.2,125.5
805,哈尔滨伏尔加庄园,20240315,65,0,65,137.0,118.2,117.8
806,哈尔滨伏尔加庄园,20240316,131,68,63,65.0,117.8,123.5
807,哈尔滨伏尔加庄园,20240317,124,59,65,131.0,117.4,123.2
808,哈尔滨伏尔加庄园,20240318,73,0,73,124.0,106.0,117.8
809,哈尔滨伏尔加庄园,20240319,127,61,66,73.0,104.0,118.1
810,哈尔滨伏尔加庄园,20240320,137,63,74,127.0,118.4,118.3
811,哈尔滨伏尔加庄园,20240321,61,0,61,137.0,104.4,111.1
812,哈尔滨伏尔加庄园,20240322,59,59,0,61.0,91.4,104.4
813,哈尔滨伏尔加庄园,20240323,130,59,71,59.0,102.8,104.4
814,哈尔滨伏尔加庄园,20240324,65,0,65,130.0,90.4,97.2
815,哈尔滨伏尔加庄园,20240325,63,63,0,65.0,75.6,97.0
816,哈尔滨伏尔加庄园,20240326,126,59,67,63.0,88.6,96.5
817,哈尔滨伏尔加庄园,20240327,126,61,65,126.0,102.0,96.7
818,哈尔滨伏尔加庄园,20240328,133,66,67,126.0,102.6,102.7
819,哈尔滨伏尔加庄园,20240329,132,61,71,133.0,116.0,103.2
820,哈尔滨伏尔加庄园,20240330,70,0,70,132.0,117.4,96.5
821,哈尔滨伏尔加庄园,20240331,67,0,67,70.0,105.6,97.1
822,哈尔滨伏尔加庄园,20240401,140,61,79,67.0,108.4,105.2
823,哈尔滨伏尔加庄园,20240402,140,64,76,140.0,109.8,106.2
824,哈尔滨伏尔加庄园,20240403,139,59,80,140.0,111.2,113.6
825,哈尔滨伏尔加庄园,20240404,100,0,100,139.0,117.2,117.3
826,哈尔滨伏尔加庄园,20240405,82,0,82,100.0,120.2,112.9
827,哈尔滨伏尔加庄园,20240406,76,0,76,82.0,107.4,107.9
828,哈尔滨伏尔加庄园,20240407,142,64,78,76.0,107.8,108.8
829,哈尔滨伏尔加庄园,20240408,132,59,73,142.0,106.4,108.8
830,哈尔滨伏尔加庄园,20240409,139,66,73,132.0,114.2,115.7
831,哈尔滨伏尔加庄园,20240410,133,57,76,139.0,124.4,122.3
832,哈尔滨伏尔加庄园,20240411,134,64,70,133.0,136.0,121.7
833,哈尔滨伏尔加庄园,20240412,139,63,76,134.0,135.4,121.6
834,哈尔滨伏尔加庄园,20240413,133,57,76,139.0,135.6,121.0
835,哈尔滨伏尔加庄园,20240414,137,57,80,133.0,135.2,124.7
836,哈尔滨伏尔加庄园,20240415,148,74,74,137.0,138.2,131.3
837,哈尔滨伏尔加庄园,20240416,128,61,67,148.0,137.0,136.5
838,哈尔滨伏尔加庄园,20240417,143,61,82,128.0,137.8,136.6
839,哈尔滨伏尔加庄园,20240418,142,63,79,143.0,139.6,137.6
840,哈尔滨伏尔加庄园,20240419,146,68,78,142.0,141.4,138.3
841,哈尔滨伏尔加庄园,20240420,137,59,78,146.0,139.2,138.7
842,哈尔滨伏尔加庄园,20240421,83,0,83,137.0,130.2,133.6
843,哈尔滨伏尔加庄园,20240422,147,61,86,83.0,131.0,134.4
844,哈尔滨伏尔加庄园,20240423,156,64,92,147.0,133.8,136.7
845,哈尔滨伏尔加庄园,20240424,152,63,89,156.0,135.0,138.2
846,哈尔滨伏尔加庄园,20240425,146,59,87,152.0,136.8,138.0
847,哈尔滨伏尔加庄园,20240426,150,63,87,146.0,150.2,140.2
848,哈尔滨伏尔加庄园,20240427,169,59,110,150.0,154.6,142.8
849,哈尔滨伏尔加庄园,20240428,189,76,113,169.0,161.2,147.5
850,哈尔滨伏尔加庄园,20240429,163,59,104,189.0,163.4,149.2
851,哈尔滨伏尔加庄园,20240430,225,74,151,163.0,179.2,158.0
1,北方森林动物园,20220101,0,0,0,225.0,149.2,149.7
2,北方森林动物园,20220102,0,0,0,0.0,115.4,135.0
3,北方森林动物园,20220103,61,0,61,0.0,89.8,125.5
4,北方森林动物园,20220104,0,0,0,61.0,57.2,110.3
5,北方森林动物园,20220105,0,0,0,0.0,12.2,95.7
6,北方森林动物园,20220106,61,0,61,0.0,24.4,86.8
7,北方森林动物园,20220107,59,59,0,61.0,36.2,75.8
8,北方森林动物园,20220108,0,0,0,59.0,24.0,56.9
9,北方森林动物园,20220109,0,0,0,0.0,24.0,40.6
10,北方森林动物园,20220110,0,0,0,0.0,24.0,18.1
11,北方森林动物园,20220111,0,0,0,0.0,11.8,18.1
12,北方森林动物园,20220112,61,0,61,0.0,12.2,24.2
13,北方森林动物园,20220113,59,59,0,61.0,24.0,24.0
14,北方森林动物园,20220114,0,0,0,59.0,24.0,24.0
15,北方森林动物园,20220115,0,0,0,0.0,24.0,24.0
16,北方森林动物园,20220116,0,0,0,0.0,24.0,17.9
17,北方森林动物园,20220117,0,0,0,0.0,11.8,12.0
18,北方森林动物园,20220118,0,0,0,0.0,0.0,12.0
19,北方森林动物园,20220119,0,0,0,0.0,0.0,12.0
20,北方森林动物园,20220120,59,59,0,0.0,11.8,17.9
21,北方森林动物园,20220121,0,0,0,59.0,11.8,17.9
22,北方森林动物园,20220122,0,0,0,0.0,11.8,11.8
23,北方森林动物园,20220123,0,0,0,0.0,11.8,5.9
24,北方森林动物园,20220124,0,0,0,0.0,11.8,5.9
25,北方森林动物园,20220125,0,0,0,0.0,0.0,5.9
26,北方森林动物园,20220126,0,0,0,0.0,0.0,5.9
27,北方森林动物园,20220127,0,0,0,0.0,0.0,5.9
28,北方森林动物园,20220128,0,0,0,0.0,0.0,5.9
29,北方森林动物园,20220129,0,0,0,0.0,0.0,5.9
30,北方森林动物园,20220130,59,59,0,0.0,11.8,5.9
31,北方森林动物园,20220131,0,0,0,59.0,11.8,5.9
32,北方森林动物园,20220201,0,0,0,0.0,11.8,5.9
33,北方森林动物园,20220202,0,0,0,0.0,11.8,5.9
34,北方森林动物园,20220203,63,0,63,0.0,24.4,12.2
35,北方森林动物园,20220204,59,59,0,63.0,24.4,18.1
36,北方森林动物园,20220205,0,0,0,59.0,24.4,18.1
37,北方森林动物园,20220206,0,0,0,0.0,24.4,18.1
38,北方森林动物园,20220207,0,0,0,0.0,24.4,18.1
39,北方森林动物园,20220208,124,59,65,0.0,36.6,30.5
40,北方森林动物园,20220209,0,0,0,124.0,24.8,24.6
41,北方森林动物园,20220210,59,59,0,0.0,36.6,30.5
42,北方森林动物园,20220211,0,0,0,59.0,36.6,30.5
43,北方森林动物园,20220212,71,0,71,0.0,50.8,37.6
44,北方森林动物园,20220213,69,0,69,71.0,39.8,38.2
45,北方森林动物园,20220214,65,0,65,69.0,52.8,38.8
46,北方森林动物园,20220215,61,0,61,65.0,53.2,44.9
47,北方森林动物园,20220216,126,61,65,61.0,78.4,57.5
48,北方森林动物园,20220217,0,0,0,126.0,64.2,57.5
49,北方森林动物园,20220218,67,0,67,0.0,63.8,51.8
50,北方森林动物园,20220219,65,0,65,67.0,63.8,58.3
51,北方森林动物园,20220220,0,0,0,65.0,51.6,52.4
52,北方森林动物园,20220221,0,0,0,0.0,26.4,52.4
53,北方森林动物园,20220222,126,59,67,0.0,51.6,57.9
54,北方森林动物园,20220223,0,0,0,126.0,38.2,51.0
55,北方森林动物园,20220224,124,61,63,0.0,50.0,56.9
56,北方森林动物园,20220225,69,0,69,124.0,63.8,57.7
57,北方森林动物园,20220226,70,0,70,69.0,77.8,52.1
58,北方森林动物园,20220227,70,0,70,70.0,66.6,59.1
59,北方森林动物园,20220228,65,0,65,70.0,79.6,58.9
60,北方森林动物园,20220301,61,0,61,65.0,67.0,58.5
61,北方森林动物园,20220302,0,0,0,61.0,53.2,58.5
62,北方森林动物园,20220303,0,0,0,0.0,39.2,58.5
63,北方森林动物园,20220304,0,0,0,0.0,25.2,45.9
64,北方森林动物园,20220305,0,0,0,0.0,12.2,45.9
65,北方森林动物园,20220306,0,0,0,0.0,0.0,33.5
66,北方森林动物园,20220307,70,0,70,0.0,14.0,33.6
67,北方森林动物园,20220308,59,59,0,70.0,25.8,32.5
68,北方森林动物园,20220309,141,61,80,59.0,54.0,39.6
69,北方森林动物园,20220310,127,61,66,141.0,79.4,45.8
70,北方森林动物园,20220311,61,0,61,127.0,91.6,45.8
71,北方森林动物园,20220312,65,0,65,61.0,90.6,52.3
72,北方森林动物园,20220313,0,0,0,65.0,78.8,52.3
73,北方森林动物园,20220314,65,0,65,0.0,63.6,58.8
74,北方森林动物园,20220315,59,59,0,65.0,50.0,64.7
75,北方森林动物园,20220316,61,0,61,59.0,50.0,70.8
76,北方森林动物园,20220317,0,0,0,61.0,37.0,63.8
77,北方森林动物园,20220318,61,0,61,0.0,49.2,64.0
78,北方森林动物园,20220319,0,0,0,61.0,36.2,49.9
79,北方森林动物园,20220320,0,0,0,0.0,24.4,37.2
80,北方森林动物园,20220321,67,0,67,0.0,25.6,37.8
81,北方森林动物园,20220322,59,59,0,67.0,37.4,37.2
82,北方森林动物园,20220323,120,59,61,59.0,49.2,49.2
83,北方森林动物园,20220324,0,0,0,120.0,49.2,42.7
84,北方森林动物园,20220325,73,0,73,0.0,63.8,44.1
85,北方森林动物园,20220326,66,0,66,73.0,63.6,44.6
86,北方森林动物园,20220327,61,0,61,66.0,64.0,50.7
87,北方森林动物园,20220328,0,0,0,61.0,40.0,44.6
88,北方森林动物园,20220329,69,0,69,0.0,53.8,51.5
89,北方森林动物园,20220330,0,0,0,69.0,39.2,51.5
90,北方森林动物园,20220331,70,0,70,0.0,40.0,51.8
91,北方森林动物园,20220401,63,0,63,70.0,40.4,52.2
92,北方森林动物园,20220402,63,0,63,63.0,53.0,46.5
93,北方森林动物园,20220403,0,0,0,63.0,39.2,46.5
94,北方森林动物园,20220404,76,0,76,0.0,54.4,46.8
95,北方森林动物园,20220405,0,0,0,76.0,40.4,40.2
96,北方森林动物园,20220406,0,0,0,0.0,27.8,34.1
97,北方森林动物园,20220407,61,0,61,0.0,27.4,40.2
98,北方森林动物园,20220408,0,0,0,61.0,27.4,33.3
99,北方森林动物园,20220409,63,0,63,0.0,24.8,39.6
100,北方森林动物园,20220410,69,0,69,63.0,38.6,39.5
101,北方森林动物园,20220411,127,61,66,69.0,64.0,45.9
102,北方森林动物园,20220412,139,63,76,127.0,79.6,53.5
103,北方森林动物园,20220413,127,61,66,139.0,105.0,66.2
104,北方森林动物园,20220414,124,61,63,127.0,117.2,71.0
105,北方森林动物园,20220415,0,0,0,124.0,103.4,71.0
106,北方森林动物园,20220416,0,0,0,0.0,78.0,71.0
107,北方森林动物园,20220417,66,0,66,0.0,63.4,71.5
108,北方森林动物园,20220418,61,61,0,66.0,50.2,77.6
109,北方森林动物园,20220419,67,0,67,61.0,38.8,78.0
110,北方森林动物园,20220420,122,59,63,67.0,63.2,83.3
111,北方森林动物园,20220421,61,0,61,122.0,75.4,76.7
112,北方森林动物园,20220422,0,0,0,61.0,62.2,62.8
113,北方森林动物园,20220423,63,0,63,0.0,62.6,56.4
114,北方森林动物园,20220424,84,0,84,63.0,66.0,52.4
115,北方森林动物园,20220425,65,0,65,84.0,54.6,58.9
116,北方森林动物园,20220426,70,0,70,65.0,56.4,65.9
117,北方森林动物园,20220427,66,0,66,70.0,69.6,65.9
118,北方森林动物园,20220428,73,0,73,66.0,71.6,67.1
119,北方森林动物园,20220429,76,0,76,73.0,70.0,68.0
120,北方森林动物园,20220430,80,0,80,76.0,73.0,63.8
121,北方森林动物园,20220501,76,0,76,80.0,74.2,65.3
122,北方森林动物园,20220502,132,59,73,76.0,87.4,78.5
123,北方森林动物园,20220503,69,0,69,132.0,86.6,79.1
124,北方森林动物园,20220504,65,0,65,69.0,84.4,77.2
125,北方森林动物园,20220505,82,0,82,65.0,84.8,78.9
126,北方森林动物园,20220506,139,59,80,82.0,97.4,85.8
127,北方森林动物园,20220507,86,0,86,139.0,88.2,87.8
128,北方森林动物园,20220508,78,0,78,86.0,90.0,88.3
129,北方森林动物园,20220509,91,0,91,78.0,95.2,89.8
130,北方森林动物园,20220510,74,0,74,91.0,93.6,89.2
131,北方森林动物园,20220511,86,0,86,74.0,83.0,90.2
132,北方森林动物园,20220512,167,63,104,86.0,99.2,93.7
133,北方森林动物园,20220513,159,59,100,167.0,115.4,102.7
134,北方森林动物园,20220514,187,59,128,159.0,134.6,114.9
135,北方森林动物园,20220515,168,59,109,187.0,153.4,123.5
136,北方森林动物园,20220516,188,70,118,168.0,173.8,128.4
137,北方森林动物园,20220517,165,66,99,188.0,173.4,136.3
138,北方森林动物园,20220518,173,61,112,165.0,176.2,145.8
139,北方森林动物园,20220519,197,61,136,173.0,178.2,156.4
140,北方森林动物园,20220520,188,63,125,197.0,182.2,167.8
141,北方森林动物园,20220521,151,0,151,188.0,174.8,174.3
142,北方森林动物园,20220522,154,0,154,151.0,172.6,173.0
143,北方森林动物园,20220523,167,63,104,154.0,171.4,173.8
144,北方森林动物园,20220524,96,0,96,167.0,151.2,164.7
145,北方森林动物园,20220525,145,59,86,96.0,142.6,162.4
146,北方森林动物园,20220526,147,64,83,145.0,141.8,158.3
147,北方森林动物园,20220527,135,0,135,147.0,138.0,155.3
148,北方森林动物园,20220528,141,0,141,135.0,132.8,152.1
149,北方森林动物园,20220529,105,0,105,141.0,134.6,142.9
150,北方森林动物园,20220530,163,59,104,105.0,138.2,140.4
151,北方森林动物园,20220531,241,63,178,163.0,157.0,149.4
152,北方森林动物园,20220601,247,61,186,241.0,179.4,158.7
153,北方森林动物园,20220602,281,64,217,247.0,207.4,170.1
154,北方森林动物园,20220603,303,0,303,281.0,247.0,190.8
155,北方森林动物园,20220604,286,59,227,303.0,271.6,204.9
156,北方森林动物园,20220605,181,59,122,286.0,259.6,208.3
157,北方森林动物园,20220606,171,63,108,181.0,244.4,211.9
158,北方森林动物园,20220607,154,59,95,171.0,219.0,213.2
159,北方森林动物园,20220608,113,0,113,154.0,181.0,214.0
160,北方森林动物园,20220609,172,64,108,113.0,158.2,214.9
161,北方森林动物园,20220610,171,61,110,172.0,156.2,207.9
162,北方森林动物园,20220611,138,0,138,171.0,149.6,197.0
163,北方森林动物园,20220612,193,61,132,138.0,157.4,188.2
164,北方森林动物园,20220613,71,0,71,193.0,149.0,165.0
165,北方森林动物园,20220614,165,61,104,71.0,147.6,152.9
166,北方森林动物园,20220615,167,59,108,165.0,146.8,151.5
167,北方森林动物园,20220616,150,59,91,167.0,149.2,149.4
168,北方森林动物园,20220617,134,0,134,150.0,137.4,147.4
169,北方森林动物园,20220618,182,59,123,134.0,159.6,154.3
170,北方森林动物园,20220619,138,0,138,182.0,154.2,150.9
171,北方森林动物园,20220620,97,0,97,138.0,140.2,143.5
172,北方森林动物园,20220621,100,0,100,97.0,130.2,139.7
173,北方森林动物园,20220622,147,61,86,100.0,132.8,135.1
174,北方森林动物园,20220623,92,0,92,147.0,114.8,137.2
175,北方森林动物园,20220624,112,0,112,92.0,109.6,131.9
176,北方森林动物园,20220625,99,0,99,112.0,110.0,125.1
177,北方森林动物园,20220626,119,0,119,99.0,113.8,122.0
178,北方森林动物园,20220627,165,63,102,119.0,117.4,125.1
179,北方森林动物园,20220628,178,59,119,165.0,134.6,124.7
180,北方森林动物园,20220629,176,63,113,178.0,147.4,128.5
181,北方森林动物园,20220630,165,61,104,176.0,160.6,135.3
182,北方森林动物园,20220701,177,59,118,165.0,172.2,143.0
183,北方森林动物园,20220702,182,61,121,177.0,175.6,146.5
184,北方森林动物园,20220703,144,0,144,182.0,168.8,151.7
185,北方森林动物园,20220704,169,59,110,144.0,167.4,157.4
186,北方森林动物园,20220705,172,64,108,169.0,168.8,164.7
187,北方森林动物园,20220706,166,61,105,172.0,166.6,169.4
188,北方森林动物园,20220707,177,68,109,166.0,165.6,170.6
189,北方森林动物园,20220708,176,66,110,177.0,172.0,170.4
190,北方森林动物园,20220709,143,0,143,176.0,166.8,167.1
191,北方森林动物园,20220710,176,0,176,143.0,167.6,168.2
192,北方森林动物园,20220711,172,64,108,176.0,168.8,167.7
193,北方森林动物园,20220712,134,0,134,172.0,160.2,162.9
194,北方森林动物园,20220713,177,59,118,134.0,160.4,166.2
195,北方森林动物园,20220714,149,0,149,177.0,161.6,164.2
196,北方森林动物园,20220715,231,66,165,149.0,172.6,170.1
197,北方森林动物园,20220716,149,0,149,231.0,168.0,168.4
198,北方森林动物园,20220717,184,0,184,149.0,178.0,169.1
199,北方森林动物园,20220718,183,61,122,184.0,179.2,169.8
200,北方森林动物园,20220719,213,61,152,183.0,192.0,176.8
201,北方森林动物园,20220720,181,59,122,213.0,182.0,177.3
202,北方森林动物园,20220721,219,59,160,181.0,196.0,182.0
203,北方森林动物园,20220722,224,59,165,219.0,204.0,191.0
204,北方森林动物园,20220723,234,61,173,224.0,214.2,196.7
205,北方森林动物园,20220724,237,63,174,234.0,219.0,205.5
206,北方森林动物园,20220725,233,63,170,237.0,229.4,205.7
207,北方森林动物园,20220726,213,59,154,233.0,228.2,212.1
208,北方森林动物园,20220727,193,61,132,213.0,222.0,213.0
209,北方森林动物园,20220728,213,64,149,193.0,217.8,216.0
210,北方森林动物园,20220729,215,63,152,213.0,213.4,216.2
211,北方森林动物园,20220730,237,61,176,215.0,214.2,221.8
212,北方森林动物园,20220731,235,59,176,237.0,218.6,223.4
213,北方森林动物园,20220801,230,63,167,235.0,226.0,224.0
214,北方森林动物园,20220802,176,0,176,230.0,218.6,218.2
215,北方森林动物园,20220803,205,61,144,176.0,216.6,215.0
216,北方森林动物园,20220804,241,68,173,205.0,217.4,215.8
217,北方森林动物园,20220805,237,63,174,241.0,217.8,218.2
218,北方森林动物园,20220806,251,59,192,237.0,222.0,224.0
219,北方森林动物园,20220807,192,0,192,251.0,225.2,221.9
220,北方森林动物园,20220808,215,63,152,192.0,227.2,221.9
221,北方森林动物园,20220809,202,61,141,215.0,219.4,218.4
222,北方森林动物园,20220810,220,59,161,202.0,216.0,216.9
223,北方森林动物园,20220811,216,59,157,220.0,209.0,215.5
224,北方森林动物园,20220812,216,59,157,216.0,213.8,219.5
225,北方森林动物园,20220813,241,61,180,216.0,219.0,223.1
226,北方森林动物园,20220814,233,59,174,241.0,225.2,222.3
227,北方森林动物园,20220815,135,0,135,233.0,208.2,212.1
228,北方森林动物园,20220816,164,0,164,135.0,197.8,203.4
229,北方森林动物园,20220817,203,64,139,164.0,195.2,204.5
230,北方森林动物园,20220818,134,0,134,203.0,173.8,196.4
231,北方森林动物园,20220819,178,61,117,134.0,162.8,194.0
232,北方森林动物园,20220820,250,61,189,178.0,185.8,197.0
233,北方森林动物园,20220821,136,0,136,250.0,180.2,189.0
234,北方森林动物园,20220822,150,61,89,136.0,169.6,182.4
235,北方森林动物园,20220823,182,61,121,150.0,179.2,176.5
236,北方森林动物园,20220824,175,63,112,182.0,178.6,170.7
237,北方森林动物园,20220825,96,0,96,175.0,147.8,166.8
238,北方森林动物园,20220826,169,63,106,96.0,154.4,167.3
239,北方森林动物园,20220827,121,0,121,169.0,148.6,159.1
240,北方森林动物园,20220828,109,0,109,121.0,134.0,156.6
241,北方森林动物园,20220829,126,61,65,109.0,124.2,151.4
242,北方森林动物园,20220830,70,0,70,126.0,119.0,133.4
243,北方森林动物园,20220831,0,0,0,70.0,85.2,119.8
244,北方森林动物园,20220901,0,0,0,0.0,61.0,104.8
245,北方森林动物园,20220902,65,0,65,0.0,52.2,93.1
246,北方森林动物园,20220903,73,0,73,65.0,41.6,82.9
247,北方森林动物园,20220904,66,0,66,73.0,40.8,79.9
248,北方森林动物园,20220905,61,61,0,66.0,53.0,69.1
249,北方森林动物园,20220906,122,61,61,61.0,77.4,69.2
250,北方森林动物园,20220907,73,0,73,122.0,79.0,65.6
251,北方森林动物园,20220908,138,59,79,73.0,92.0,66.8
252,北方森林动物园,20220909,171,66,105,138.0,113.0,76.9
253,北方森林动物园,20220910,117,0,117,171.0,124.2,88.6
254,北方森林动物园,20220911,222,59,163,117.0,144.2,110.8
255,北方森林动物园,20220912,115,0,115,222.0,152.6,115.8
256,北方森林动物园,20220913,150,59,91,115.0,155.0,123.5
257,北方森林动物园,20220914,139,59,80,150.0,148.6,130.8
258,北方森林动物园,20220915,84,0,84,139.0,142.0,133.1
259,北方森林动物园,20220916,87,0,87,84.0,115.0,129.6
260,北方森林动物园,20220917,96,0,96,87.0,111.2,131.9
261,北方森林动物园,20220918,99,0,99,96.0,101.0,128.0
262,北方森林动物园,20220919,141,59,82,99.0,101.4,125.0
263,北方森林动物园,20220920,67,0,67,141.0,98.0,120.0
264,北方森林动物园,20220921,125,59,66,67.0,105.6,110.3
265,北方森林动物园,20220922,73,0,73,125.0,101.0,106.1
266,北方森林动物园,20220923,128,59,69,73.0,106.8,103.9
267,北方森林动物园,20220924,86,0,86,128.0,95.8,98.6
268,北方森林动物园,20220925,80,0,80,86.0,98.4,98.2
269,北方森林动物园,20220926,74,0,74,80.0,88.2,96.9
270,北方森林动物园,20220927,86,0,86,74.0,90.8,95.9
271,北方森林动物园,20220928,80,0,80,86.0,81.2,94.0
272,北方森林动物园,20220929,152,61,91,80.0,94.4,95.1
273,北方森林动物园,20220930,216,68,148,152.0,121.6,110.0
274,北方森林动物园,20221001,187,0,187,216.0,144.2,116.2
275,北方森林动物园,20221002,179,0,179,187.0,162.8,126.8
276,北方森林动物园,20221003,105,0,105,179.0,167.8,124.5
277,北方森林动物园,20221004,122,0,122,105.0,161.8,128.1
278,北方森林动物园,20221005,97,0,97,122.0,138.0,129.8
279,北方森林动物园,20221006,84,0,84,97.0,117.4,130.8
280,北方森林动物园,20221007,96,0,96,84.0,100.8,131.8
281,北方森林动物园,20221008,76,0,76,96.0,95.0,131.4
282,北方森林动物园,20221009,126,59,67,76.0,95.8,128.8
283,北方森林动物园,20221010,126,59,67,126.0,101.6,119.8
284,北方森林动物园,20221011,61,0,61,126.0,97.0,107.2
285,北方森林动物园,20221012,61,0,61,61.0,90.0,95.4
286,北方森林动物园,20221013,80,0,80,61.0,90.8,92.9
287,北方森林动物园,20221014,69,0,69,80.0,79.4,87.6
288,北方森林动物园,20221015,132,59,73,69.0,80.6,91.1
289,北方森林动物园,20221016,74,0,74,132.0,83.2,90.1
290,北方森林动物园,20221017,67,0,67,74.0,84.4,87.2
291,北方森林动物园,20221018,70,0,70,67.0,82.4,86.6
292,北方森林动物园,20221019,61,0,61,70.0,80.8,80.1
293,北方森林动物园,20221020,0,0,0,61.0,54.4,67.5
294,北方森林动物园,20221021,66,0,66,0.0,52.8,68.0
295,北方森林动物园,20221022,69,0,69,66.0,53.2,68.8
296,北方森林动物园,20221023,65,0,65,69.0,52.2,67.3
297,北方森林动物园,20221024,0,0,0,65.0,40.0,60.4
298,北方森林动物园,20221025,0,0,0,0.0,40.0,47.2
299,北方森林动物园,20221026,69,0,69,0.0,40.6,46.7
300,北方森林动物园,20221027,63,0,63,69.0,39.4,46.3
301,北方森林动物园,20221028,0,0,0,63.0,26.4,39.3
302,北方森林动物园,20221029,71,0,71,0.0,40.6,40.3
303,北方森林动物园,20221030,66,0,66,71.0,53.8,46.9
304,北方森林动物园,20221031,0,0,0,66.0,40.0,40.3
305,北方森林动物园,20221101,66,0,66,0.0,40.6,40.0
306,北方森林动物园,20221102,59,59,0,66.0,52.4,39.4
307,北方森林动物园,20221103,65,0,65,59.0,51.2,45.9
308,北方森林动物园,20221104,63,0,63,65.0,50.6,52.2
309,北方森林动物园,20221105,66,0,66,63.0,63.8,51.9
310,北方森林动物园,20221106,0,0,0,66.0,50.6,45.6
311,北方森林动物园,20221107,0,0,0,0.0,38.8,45.6
312,北方森林动物园,20221108,61,0,61,0.0,38.0,44.6
313,北方森林动物园,20221109,63,0,63,61.0,38.0,44.3
314,北方森林动物园,20221110,63,0,63,63.0,37.4,50.6
315,北方森林动物园,20221111,0,0,0,63.0,37.4,44.0
316,北方森林动物园,20221112,122,59,63,0.0,61.8,50.3
317,北方森林动物园,20221113,71,0,71,122.0,63.8,50.9
318,北方森林动物园,20221114,61,0,61,71.0,63.4,50.7
319,北方森林动物园,20221115,0,0,0,61.0,50.8,44.1
320,北方森林动物园,20221116,0,0,0,0.0,50.8,44.1
321,北方森林动物园,20221117,61,0,61,0.0,38.6,50.2
322,北方森林动物园,20221118,0,0,0,61.0,24.4,44.1
323,北方森林动物园,20221119,69,0,69,0.0,26.0,44.7
324,北方森林动物园,20221120,0,0,0,69.0,26.0,38.4
325,北方森林动物园,20221121,66,0,66,0.0,39.2,45.0
326,北方森林动物园,20221122,61,0,61,66.0,39.2,38.9
327,北方森林动物园,20221123,0,0,0,61.0,39.2,31.8
328,北方森林动物园,20221124,0,0,0,0.0,25.4,25.7
329,北方森林动物园,20221125,0,0,0,0.0,25.4,25.7
330,北方森林动物园,20221126,0,0,0,0.0,12.2,25.7
331,北方森林动物园,20221127,70,0,70,0.0,14.0,26.6
332,北方森林动物园,20221128,0,0,0,70.0,14.0,26.6
333,北方森林动物园,20221129,63,0,63,0.0,26.6,26.0
334,北方森林动物园,20221130,65,0,65,63.0,39.6,32.5
335,北方森林动物园,20221201,0,0,0,65.0,39.6,25.9
336,北方森林动物园,20221202,0,0,0,0.0,25.6,19.8
337,北方森林动物园,20221203,61,0,61,0.0,37.8,25.9
338,北方森林动物园,20221204,0,0,0,61.0,25.2,25.9
339,北方森林动物园,20221205,0,0,0,0.0,12.2,25.9
340,北方森林动物园,20221206,120,59,61,0.0,36.2,37.9
341,北方森林动物园,20221207,0,0,0,120.0,36.2,30.9
342,北方森林动物园,20221208,0,0,0,0.0,24.0,30.9
343,北方森林动物园,20221209,67,0,67,0.0,37.4,31.3
344,北方森林动物园,20221210,65,0,65,67.0,50.4,31.3
345,北方森林动物园,20221211,0,0,0,65.0,26.4,31.3
346,北方森林动物园,20221212,0,0,0,0.0,26.4,31.3
347,北方森林动物园,20221213,66,0,66,0.0,39.6,31.8
348,北方森林动物园,20221214,66,0,66,66.0,39.4,38.4
349,北方森林动物园,20221215,63,0,63,66.0,39.0,44.7
350,北方森林动物园,20221216,61,0,61,63.0,51.2,38.8
351,北方森林动物园,20221217,61,0,61,61.0,63.4,44.9
352,北方森林动物园,20221218,63,0,63,61.0,62.8,51.2
353,北方森林动物园,20221219,0,0,0,63.0,49.6,44.5
354,北方森林动物园,20221220,0,0,0,0.0,37.0,38.0
355,北方森林动物园,20221221,59,59,0,0.0,36.6,43.9
356,北方森林动物园,20221222,0,0,0,59.0,24.4,43.9
357,北方森林动物园,20221223,0,0,0,0.0,11.8,37.3
358,北方森林动物园,20221224,65,0,65,0.0,24.8,37.2
359,北方森林动物园,20221225,61,0,61,65.0,37.0,37.0
360,北方森林动物园,20221226,122,61,61,61.0,49.6,43.1
361,北方森林动物园,20221227,65,0,65,122.0,62.6,43.5
362,北方森林动物园,20221228,67,0,67,65.0,76.0,43.9
363,北方森林动物园,20221229,0,0,0,67.0,63.0,43.9
364,北方森林动物园,20221230,0,0,0,0.0,50.8,43.9
365,北方森林动物园,20221231,0,0,0,0.0,26.4,38.0
366,北方森林动物园,20230101,0,0,0,0.0,13.4,38.0
367,北方森林动物园,20230102,63,0,63,0.0,12.6,44.3
368,北方森林动物园,20230103,122,61,61,63.0,37.0,50.0
369,北方森林动物园,20230104,61,0,61,122.0,49.2,50.0
370,北方森林动物园,20230105,61,0,61,61.0,61.4,43.9
371,北方森林动物园,20230106,0,0,0,61.0,61.4,37.4
372,北方森林动物园,20230107,63,0,63,0.0,61.4,37.0
373,北方森林动物园,20230108,0,0,0,63.0,37.0,37.0
374,北方森林动物园,20230109,0,0,0,0.0,24.8,37.0
375,北方森林动物园,20230110,120,59,61,0.0,36.6,49.0
376,北方森林动物园,20230111,125,59,66,120.0,61.6,61.5
377,北方森林动物园,20230112,61,0,61,125.0,61.2,61.3
378,北方森林动物园,20230113,0,0,0,61.0,61.2,49.1
379,北方森林动物园,20230114,0,0,0,0.0,61.2,43.0
380,北方森林动物园,20230115,0,0,0,0.0,37.2,36.9
381,北方森林动物园,20230116,63,0,63,0.0,24.8,43.2
382,北方森林动物园,20230117,0,0,0,63.0,12.6,36.9
383,北方森林动物园,20230118,0,0,0,0.0,12.6,36.9
384,北方森林动物园,20230119,65,0,65,0.0,25.6,43.4
385,北方森林动物园,20230120,0,0,0,65.0,25.6,31.4
386,北方森林动物园,20230121,0,0,0,0.0,13.0,18.9
387,北方森林动物园,20230122,66,0,66,0.0,26.2,19.4
388,北方森林动物园,20230123,70,0,70,66.0,40.2,26.4
389,北方森林动物园,20230124,69,0,69,70.0,41.0,33.3
390,北方森林动物园,20230125,71,0,71,69.0,55.2,40.4
391,北方森林动物园,20230126,126,59,67,71.0,80.4,46.7
392,北方森林动物园,20230127,0,0,0,126.0,67.2,46.7
393,北方森林动物园,20230128,66,0,66,0.0,66.4,53.3
394,北方森林动物园,20230129,73,0,73,66.0,67.2,54.1
395,北方森林动物园,20230130,67,0,67,73.0,66.4,60.8
396,北方森林动物园,20230131,127,61,66,67.0,66.6,73.5
397,北方森林动物园,20230201,67,0,67,127.0,80.0,73.6
398,北方森林动物园,20230202,124,59,65,67.0,91.6,79.0
399,北方森林动物园,20230203,73,0,73,124.0,91.6,79.4
400,北方森林动物园,20230204,65,0,65,73.0,91.2,78.8
401,北方森林动物园,20230205,124,59,65,65.0,90.6,78.6
402,北方森林动物园,20230206,66,0,66,124.0,90.4,85.2
403,北方森林动物园,20230207,61,61,0,66.0,77.8,84.7
404,北方森林动物园,20230208,65,0,65,61.0,76.2,83.9
405,北方森林动物园,20230209,0,0,0,65.0,63.2,77.2
406,北方森林动物园,20230210,63,0,63,0.0,51.0,70.8
407,北方森林动物园,20230211,122,59,63,63.0,62.2,76.3
408,北方森林动物园,20230212,67,0,67,122.0,63.4,70.6
409,北方森林动物园,20230213,69,0,69,67.0,64.2,70.2
410,北方森林动物园,20230214,0,0,0,69.0,64.2,63.7
411,北方森林动物园,20230215,0,0,0,0.0,51.6,51.3
412,北方森林动物园,20230216,61,0,61,0.0,39.4,50.8
413,北方森林动物园,20230217,59,59,0,61.0,37.8,50.6
414,北方森林动物园,20230218,65,0,65,59.0,37.0,50.6
415,北方森林动物园,20230219,122,59,63,65.0,61.4,62.8
416,北方森林动物园,20230220,0,0,0,122.0,61.4,56.5
417,北方森林动物园,20230221,0,0,0,0.0,49.2,44.3
418,北方森林动物园,20230222,126,59,67,0.0,62.6,50.2
419,北方森林动物园,20230223,67,0,67,126.0,63.0,50.0
420,北方森林动物园,20230224,61,0,61,67.0,50.8,56.1
421,北方森林动物园,20230225,132,59,73,61.0,77.2,69.3
422,北方森林动物园,20230226,69,0,69,132.0,91.0,70.1
423,北方森林动物园,20230227,133,64,69,69.0,92.4,77.5
424,北方森林动物园,20230228,124,63,61,133.0,103.8,83.4
425,北方森林动物园,20230301,66,0,66,124.0,104.8,77.8
426,北方森林动物园,20230302,71,0,71,66.0,92.6,84.9
427,北方森林动物园,20230303,70,0,70,71.0,92.8,91.9
428,北方森林动物园,20230304,122,59,63,70.0,90.6,91.5
429,北方森林动物园,20230305,67,0,67,122.0,79.2,91.5
430,北方森林动物园,20230306,65,0,65,67.0,79.0,91.9
431,北方森林动物园,20230307,71,0,71,65.0,79.0,85.8
432,北方森林动物园,20230308,126,59,67,71.0,90.2,91.5
433,北方森林动物园,20230309,76,0,76,126.0,81.0,85.8
434,北方森林动物园,20230310,132,63,69,76.0,94.0,86.6
435,北方森林动物园,20230311,124,59,65,132.0,105.8,92.4
436,北方森林动物园,20230312,74,0,74,124.0,106.4,92.7
437,北方森林动物园,20230313,78,0,78,74.0,96.8,93.5
438,北方森林动物园,20230314,130,59,71,78.0,107.6,94.3
439,北方森林动物园,20230315,67,0,67,130.0,94.6,94.3
440,北方森林动物园,20230316,135,61,74,67.0,96.8,101.3
441,北方森林动物园,20230317,78,0,78,135.0,97.6,102.0
442,北方森林动物园,20230318,80,0,80,78.0,98.0,97.4
443,北方森林动物园,20230319,138,59,79,80.0,99.6,103.6
444,北方森林动物园,20230320,139,61,78,138.0,114.0,104.3
445,北方森林动物园,20230321,74,0,74,139.0,101.8,99.3
446,北方森林动物园,20230322,148,59,89,74.0,115.8,106.7
447,北方森林动物园,20230323,78,0,78,148.0,115.4,106.7
448,北方森林动物园,20230324,105,0,105,78.0,108.8,104.2
449,北方森林动物园,20230325,82,0,82,105.0,97.4,105.7
450,北方森林动物园,20230326,71,0,71,82.0,96.8,99.3
451,北方森林动物园,20230327,146,59,87,71.0,96.4,106.1
452,北方森林动物园,20230328,86,0,86,146.0,98.0,106.7
453,北方森林动物园,20230329,132,61,71,86.0,103.4,106.1
454,北方森林动物园,20230330,153,61,92,132.0,117.6,107.5
455,北方森林动物园,20230331,154,63,91,153.0,134.2,115.5
456,北方森林动物园,20230401,78,0,78,154.0,120.6,108.5
457,北方森林动物园,20230402,158,59,99,78.0,135.0,116.5
458,北方森林动物园,20230403,145,59,86,158.0,137.6,120.5
459,北方森林动物园,20230404,166,64,102,145.0,140.2,128.9
460,北方森林动物园,20230405,109,0,109,166.0,131.2,132.7
461,北方森林动物园,20230406,148,59,89,109.0,145.2,132.9
462,北方森林动物园,20230407,83,0,83,148.0,130.2,132.6
463,北方森林动物园,20230408,178,63,115,83.0,136.8,137.2
464,北方森林动物园,20230409,97,0,97,178.0,123.0,131.6
465,北方森林动物园,20230410,173,61,112,97.0,135.8,133.5
466,北方森林动物园,20230411,193,74,119,173.0,144.8,145.0
467,北方森林动物园,20230412,189,66,123,193.0,166.0,148.1
468,北方森林动物园,20230413,195,70,125,189.0,169.4,153.1
469,北方森林动物园,20230414,189,70,119,195.0,187.8,155.4
470,北方森林动物园,20230415,214,63,151,189.0,196.0,165.9
471,北方森林动物园,20230416,154,0,154,214.0,188.2,166.5
472,北方森林动物园,20230417,197,61,136,154.0,189.8,177.9
473,北方森林动物园,20230418,198,64,134,197.0,190.4,179.9
474,北方森林动物园,20230419,190,59,131,198.0,190.6,189.2
475,北方森林动物园,20230420,169,61,108,190.0,181.6,188.8
476,北方森林动物园,20230421,214,63,151,169.0,193.6,190.9
477,北方森林动物园,20230422,217,59,158,214.0,197.6,193.7
478,北方森林动物园,20230423,227,76,151,217.0,203.4,196.9
479,北方森林动物园,20230424,229,72,157,227.0,211.2,200.9
480,北方森林动物园,20230425,223,63,160,229.0,222.0,201.8
481,北方森林动物园,20230426,247,68,179,223.0,228.6,211.1
482,北方森林动物园,20230427,323,80,243,247.0,249.8,223.7
483,北方森林动物园,20230428,381,80,301,323.0,280.6,242.0
484,北方森林动物园,20230429,454,61,393,381.0,325.6,268.4
485,北方森林动物园,20230430,669,70,599,454.0,414.8,318.4
486,北方森林动物园,20230501,937,82,855,669.0,552.8,390.7
487,北方森林动物园,20230502,623,59,564,937.0,612.8,431.3
488,北方森林动物园,20230503,353,61,292,623.0,607.2,443.9
489,北方森林动物园,20230504,226,64,162,353.0,561.6,443.6
490,北方森林动物园,20230505,211,66,145,226.0,470.0,442.4
491,北方森林动物园,20230506,209,61,148,211.0,324.4,438.6
492,北方森林动物园,20230507,159,0,159,209.0,231.6,422.2
493,北方森林动物园,20230508,171,59,112,159.0,195.2,401.2
494,北方森林动物园,20230509,167,63,104,171.0,183.4,372.5
495,北方森林动物园,20230510,175,66,109,167.0,176.2,323.1
496,北方森林动物园,20230511,187,59,128,175.0,171.8,248.1
497,北方森林动物园,20230512,110,0,110,187.0,162.0,196.8
498,北方森林动物园,20230513,154,0,154,110.0,158.6,176.9
499,北方森林动物园,20230514,134,0,134,154.0,152.0,167.7
500,北方森林动物园,20230515,187,59,128,134.0,154.4,165.3
501,北方森林动物园,20230516,182,64,118,187.0,153.4,162.6
502,北方森林动物园,20230517,149,0,149,182.0,161.2,161.6
503,北方森林动物园,20230518,180,59,121,149.0,166.4,162.5
504,北方森林动物园,20230519,123,0,123,180.0,164.2,158.1
505,北方森林动物园,20230520,145,0,145,123.0,155.8,155.1
506,北方森林动物园,20230521,143,0,143,145.0,148.0,150.7
507,北方森林动物园,20230522,109,0,109,143.0,140.0,150.6
508,北方森林动物园,20230523,112,0,112,109.0,126.4,146.4
509,北方森林动物园,20230524,227,63,164,112.0,147.2,155.7
510,北方森林动物园,20230525,230,68,162,227.0,164.2,160.0
511,北方森林动物园,20230526,227,61,166,230.0,181.0,164.5
512,北方森林动物园,20230527,232,59,173,227.0,205.6,172.8
513,北方森林动物园,20230528,231,61,170,232.0,229.4,177.9
514,北方森林动物园,20230529,170,0,170,231.0,218.0,182.6
515,北方森林动物园,20230530,234,72,162,170.0,218.8,191.5
516,北方森林动物园,20230531,233,63,170,234.0,220.0,200.5
517,北方森林动物园,20230601,228,61,167,233.0,219.2,212.4
518,北方森林动物园,20230602,194,63,131,228.0,211.8,220.6
519,北方森林动物园,20230603,260,59,201,194.0,229.8,223.9
520,北方森林动物园,20230604,179,0,179,260.0,218.8,218.8
521,北方森林动物园,20230605,179,0,179,179.0,208.0,214.0
522,北方森林动物园,20230606,132,0,132,179.0,188.8,204.0
523,北方森林动物园,20230607,192,61,131,132.0,188.4,200.1
524,北方森林动物园,20230608,154,59,95,192.0,167.2,198.5
525,北方森林动物园,20230609,204,61,143,154.0,172.2,195.5
526,北方森林动物园,20230610,152,0,152,204.0,166.8,187.4
527,北方森林动物园,20230611,155,0,155,152.0,171.4,180.1
528,北方森林动物园,20230612,118,0,118,155.0,156.6,172.5
529,北方森林动物园,20230613,163,61,102,118.0,158.4,162.8
530,北方森林动物园,20230614,108,0,108,163.0,139.2,155.7
531,北方森林动物园,20230615,156,59,97,108.0,140.0,153.4
532,北方森林动物园,20230616,164,59,105,156.0,141.8,156.6
533,北方森林动物园,20230617,157,0,157,164.0,149.6,153.1
534,北方森林动物园,20230618,157,0,157,157.0,148.4,153.4
535,北方森林动物园,20230619,174,59,115,157.0,161.6,150.4
536,北方森林动物园,20230620,105,0,105,174.0,151.4,145.7
537,北方森林动物园,20230621,195,63,132,105.0,157.6,149.7
538,北方森林动物园,20230622,282,63,219,195.0,182.6,166.1
539,北方森林动物园,20230623,214,0,214,282.0,194.0,171.2
540,北方森林动物园,20230624,199,64,135,214.0,199.0,180.3
541,北方森林动物园,20230625,182,61,121,199.0,214.4,182.9
542,北方森林动物园,20230626,152,61,91,182.0,205.8,181.7
543,北方森林动物园,20230627,158,63,95,152.0,181.0,181.8
544,北方森林动物园,20230628,91,0,91,158.0,156.4,175.2
545,北方森林动物园,20230629,92,0,92,91.0,135.0,167.0
546,北方森林动物园,20230630,158,63,95,92.0,130.2,172.3
547,北方森林动物园,20230701,182,59,123,158.0,136.2,171.0
548,北方森林动物园,20230702,197,61,136,182.0,144.0,162.5
549,北方森林动物园,20230703,96,0,96,197.0,145.0,150.7
550,北方森林动物园,20230704,152,61,91,96.0,157.0,146.0
551,北方森林动物园,20230705,159,64,95,152.0,157.2,143.7
552,北方森林动物园,20230706,156,59,97,159.0,152.0,144.1
553,北方森林动物园,20230707,115,0,115,156.0,135.6,139.8
554,北方森林动物园,20230708,181,63,118,115.0,152.6,148.8
555,北方森林动物园,20230709,93,0,93,181.0,140.8,148.9
556,北方森林动物园,20230710,92,0,92,93.0,127.4,142.3
557,北方森林动物园,20230711,113,0,113,92.0,118.8,135.4
558,北方森林动物园,20230712,157,61,96,113.0,127.2,131.4
559,北方森林动物园,20230713,167,59,108,157.0,124.4,138.5
560,北方森林动物园,20230714,104,0,104,167.0,126.6,133.7
561,北方森林动物园,20230715,87,0,87,104.0,125.6,126.5
562,北方森林动物园,20230716,121,0,121,87.0,127.2,123.0
563,北方森林动物园,20230717,166,64,102,121.0,129.0,128.1
564,北方森林动物园,20230718,93,0,93,166.0,114.2,119.3
565,北方森林动物园,20230719,187,64,123,93.0,130.8,128.7
566,北方森林动物园,20230720,191,61,130,187.0,151.6,138.6
567,北方森林动物园,20230721,169,61,108,191.0,161.2,144.2
568,北方森林动物园,20230722,139,0,139,169.0,155.8,142.4
569,北方森林动物园,20230723,115,0,115,139.0,160.2,137.2
570,北方森林动物园,20230724,93,0,93,115.0,141.4,136.1
571,北方森林动物园,20230725,173,63,110,93.0,137.8,144.7
572,北方森林动物园,20230726,197,59,138,173.0,143.4,152.3
573,北方森林动物园,20230727,122,0,122,197.0,140.0,147.9
574,北方森林动物园,20230728,182,59,123,122.0,153.4,156.8
575,北方森林动物园,20230729,220,59,161,182.0,178.8,160.1
576,北方森林动物园,20230730,231,61,170,220.0,190.4,164.1
577,北方森林动物园,20230731,227,61,166,231.0,196.4,169.9
578,北方森林动物园,20230801,190,59,131,227.0,210.0,175.0
579,北方森林动物园,20230802,96,0,96,190.0,192.8,173.1
580,北方森林动物园,20230803,165,63,102,96.0,181.8,180.3
581,北方森林动物园,20230804,160,68,92,165.0,167.6,179.0
582,北方森林动物园,20230805,154,63,91,160.0,153.0,174.7
583,北方森林动物园,20230806,147,0,147,154.0,144.4,177.2
584,北方森林动物园,20230807,122,0,122,147.0,149.6,171.2
585,北方森林动物园,20230808,108,0,108,122.0,138.2,160.0
586,北方森林动物园,20230809,113,0,113,108.0,128.8,148.2
587,北方森林动物园,20230810,159,59,100,113.0,129.8,141.4
588,北方森林动物园,20230811,173,63,110,159.0,135.0,139.7
589,北方森林动物园,20230812,159,59,100,173.0,142.4,146.0
590,北方森林动物园,20230813,106,0,106,159.0,142.0,140.1
591,北方森林动物园,20230814,185,66,119,106.0,156.4,142.6
592,北方森林动物园,20230815,143,0,143,185.0,153.2,141.5
593,北方森林动物园,20230816,148,0,148,143.0,148.2,141.6
594,北方森林动物园,20230817,185,59,126,148.0,153.4,147.9
595,北方森林动物园,20230818,139,0,139,185.0,160.0,151.0
596,北方森林动物园,20230819,220,59,161,139.0,167.0,161.7
597,北方森林动物园,20230820,144,0,144,220.0,167.2,160.2
598,北方森林动物园,20230821,105,0,105,144.0,158.6,153.4
599,北方森林动物园,20230822,189,61,128,105.0,159.4,156.4
600,北方森林动物园,20230823,171,59,112,189.0,165.8,162.9
601,北方森林动物园,20230824,180,63,117,171.0,157.8,162.4
602,北方森林动物园,20230825,168,59,109,180.0,162.6,164.9
603,北方森林动物园,20230826,182,59,123,168.0,178.0,168.3
604,北方森林动物园,20230827,163,0,163,182.0,172.8,166.1
605,北方森林动物园,20230828,160,63,97,163.0,170.6,168.2
606,北方森林动物园,20230829,84,0,84,160.0,151.4,154.6
607,北方森林动物园,20230830,134,61,73,84.0,144.6,153.6
608,北方森林动物园,20230831,99,0,99,134.0,128.0,153.0
609,北方森林动物园,20230901,148,59,89,99.0,125.0,148.9
610,北方森林动物园,20230902,169,59,110,148.0,126.8,148.7
611,北方森林动物园,20230903,108,0,108,169.0,131.6,141.5
612,北方森林动物园,20230904,76,0,76,108.0,120.0,132.3
613,北方森林动物园,20230905,148,70,78,76.0,129.8,128.9
614,北方森林动物园,20230906,139,61,78,148.0,128.0,126.5
615,北方森林动物园,20230907,140,70,70,139.0,122.2,124.5
616,北方森林动物园,20230908,175,63,112,140.0,135.6,133.6
617,北方森林动物园,20230909,208,59,149,175.0,162.0,141.0
618,北方森林动物园,20230910,135,0,135,208.0,159.4,144.6
619,北方森林动物园,20230911,86,0,86,135.0,148.8,138.4
620,北方森林动物园,20230912,80,0,80,86.0,136.8,129.5
621,北方森林动物园,20230913,155,59,96,80.0,132.8,134.2
622,北方森林动物园,20230914,155,63,92,155.0,122.2,142.1
623,北方森林动物园,20230915,165,63,102,155.0,128.2,143.8
624,北方森林动物园,20230916,168,59,109,165.0,144.6,146.7
625,北方森林动物园,20230917,121,0,121,168.0,152.8,144.8
626,北方森林动物园,20230918,78,0,78,121.0,137.4,135.1
627,北方森林动物园,20230919,141,59,82,78.0,134.6,128.4
628,北方森林动物园,20230920,141,59,82,141.0,129.8,129.0
629,北方森林动物园,20230921,154,59,95,141.0,127.0,135.8
630,北方森林动物园,20230922,168,66,102,154.0,136.4,144.6
631,北方森林动物园,20230923,184,72,112,168.0,157.6,147.5
632,北方森林动物园,20230924,89,0,89,184.0,147.2,140.9
633,北方森林动物园,20230925,172,64,108,89.0,153.4,141.6
634,北方森林动物园,20230926,205,66,139,172.0,163.6,145.3
635,北方森林动物园,20230927,199,68,131,205.0,169.8,153.1
636,北方森林动物园,20230928,215,74,141,199.0,176.0,166.8
637,北方森林动物园,20230929,187,0,187,215.0,195.6,171.4
638,北方森林动物园,20230930,311,61,250,187.0,223.4,188.4
639,北方森林动物园,20231001,372,63,309,311.0,256.8,210.2
640,北方森林动物园,20231002,383,64,319,372.0,293.6,231.7
641,北方森林动物园,20231003,221,0,221,383.0,294.8,235.4
642,北方森林动物园,20231004,280,59,221,221.0,313.4,254.5
643,北方森林动物园,20231005,230,59,171,280.0,297.2,260.3
644,北方森林动物园,20231006,191,59,132,230.0,261.0,258.9
645,北方森林动物园,20231007,91,0,91,191.0,202.6,248.1
646,北方森林动物园,20231008,84,0,84,91.0,175.2,235.0
647,北方森林动物园,20231009,74,0,74,84.0,134.0,223.7
648,北方森林动物园,20231010,73,0,73,74.0,102.6,199.9
649,北方森林动物园,20231011,67,0,67,73.0,77.8,169.4
650,北方森林动物园,20231012,125,59,66,67.0,84.6,143.6
651,北方森林动物园,20231013,141,59,82,125.0,96.0,135.6
652,北方森林动物园,20231014,105,0,105,141.0,102.2,118.1
653,北方森林动物园,20231015,86,0,86,105.0,104.8,103.7
654,北方森林动物园,20231016,70,0,70,86.0,105.4,91.6
655,北方森林动物园,20231017,124,61,63,70.0,105.2,94.9
656,北方森林动物园,20231018,132,61,71,124.0,103.4,99.7
657,北方森林动物园,20231019,66,0,66,132.0,95.6,98.9
658,北方森林动物园,20231020,70,0,70,66.0,92.4,98.6
659,北方森林动物园,20231021,78,0,78,70.0,94.0,99.7
660,北方森林动物园,20231022,129,59,70,78.0,95.0,100.1
661,北方森林动物园,20231023,66,0,66,129.0,81.8,92.6
662,北方森林动物园,20231024,76,0,76,66.0,83.8,89.7
663,北方森林动物园,20231025,124,59,65,76.0,94.6,93.5
664,北方森林动物园,20231026,61,0,61,124.0,91.2,92.6
665,北方森林动物园,20231027,66,0,66,61.0,78.6,86.8
666,北方森林动物园,20231028,71,0,71,66.0,79.6,80.7
667,北方森林动物园,20231029,76,0,76,71.0,79.6,81.7
668,北方森林动物园,20231030,61,0,61,76.0,67.0,80.8
669,北方森林动物园,20231031,65,0,65,61.0,67.8,79.5
670,北方森林动物园,20231101,61,0,61,65.0,66.8,72.7
671,北方森林动物园,20231102,0,0,0,61.0,52.6,66.1
672,北方森林动物园,20231103,61,61,0,0.0,49.6,64.6
673,北方森林动物园,20231104,59,59,0,61.0,49.2,58.1
674,北方森林动物园,20231105,0,0,0,59.0,36.2,52.0
675,北方森林动物园,20231106,0,0,0,0.0,24.0,45.4
676,北方森林动物园,20231107,0,0,0,0.0,24.0,38.3
677,北方森林动物园,20231108,0,0,0,0.0,11.8,30.7
678,北方森林动物园,20231109,0,0,0,0.0,0.0,24.6
679,北方森林动物园,20231110,0,0,0,0.0,0.0,18.1
680,北方森林动物园,20231111,0,0,0,0.0,0.0,12.0
681,北方森林动物园,20231112,0,0,0,0.0,0.0,12.0
682,北方森林动物园,20231113,61,61,0,0.0,12.2,12.0
683,北方森林动物园,20231114,0,0,0,61.0,12.2,6.1
684,北方森林动物园,20231115,0,0,0,0.0,12.2,6.1
685,北方森林动物园,20231116,0,0,0,0.0,12.2,6.1
686,北方森林动物园,20231117,59,59,0,0.0,24.0,12.0
687,北方森林动物园,20231118,0,0,0,59.0,11.8,12.0
688,北方森林动物园,20231119,61,0,61,0.0,24.0,18.1
689,北方森林动物园,20231120,126,61,65,61.0,49.2,30.7
690,北方森林动物园,20231121,0,0,0,126.0,49.2,30.7
691,北方森林动物园,20231122,0,0,0,0.0,37.4,30.7
692,北方森林动物园,20231123,0,0,0,0.0,37.4,24.6
693,北方森林动物园,20231124,61,0,61,0.0,37.4,30.7
694,北方森林动物园,20231125,0,0,0,61.0,12.2,30.7
695,北方森林动物园,20231126,0,0,0,0.0,12.2,30.7
696,北方森林动物园,20231127,61,61,0,0.0,24.4,30.9
697,北方森林动物园,20231128,0,0,0,61.0,24.4,30.9
698,北方森林动物园,20231129,63,0,63,0.0,24.8,31.1
699,北方森林动物园,20231130,67,0,67,63.0,38.2,25.2
700,北方森林动物园,20231201,0,0,0,67.0,38.2,25.2
701,北方森林动物园,20231202,61,0,61,0.0,38.2,31.3
702,北方森林动物园,20231203,0,0,0,61.0,38.2,31.3
703,北方森林动物园,20231204,0,0,0,0.0,25.6,25.2
704,北方森林动物园,20231205,0,0,0,0.0,12.2,25.2
705,北方森林动物园,20231206,63,0,63,0.0,24.8,31.5
706,北方森林动物园,20231207,64,64,0,63.0,25.4,31.8
707,北方森林动物园,20231208,61,0,61,64.0,37.6,37.9
708,北方森林动物园,20231209,61,0,61,61.0,49.8,37.7
709,北方森林动物园,20231210,0,0,0,61.0,49.8,31.0
710,北方森林动物园,20231211,59,59,0,0.0,49.0,36.9
711,北方森林动物园,20231212,0,0,0,59.0,36.2,30.8
712,北方森林动物园,20231213,0,0,0,0.0,24.0,30.8
713,北方森林动物园,20231214,0,0,0,0.0,11.8,30.8
714,北方森林动物园,20231215,0,0,0,0.0,11.8,30.8
715,北方森林动物园,20231216,65,0,65,0.0,13.0,31.0
716,北方森林动物园,20231217,0,0,0,65.0,13.0,24.6
717,北方森林动物园,20231218,59,59,0,0.0,24.8,24.4
718,北方森林动物园,20231219,0,0,0,59.0,24.8,18.3
719,北方森林动物园,20231220,0,0,0,0.0,24.8,18.3
720,北方森林动物园,20231221,65,0,65,0.0,24.8,18.9
721,北方森林动物园,20231222,59,59,0,65.0,36.6,24.8
722,北方森林动物园,20231223,61,0,61,59.0,37.0,30.9
723,北方森林动物园,20231224,0,0,0,61.0,37.0,30.9
724,北方森林动物园,20231225,0,0,0,0.0,37.0,30.9
725,北方森林动物园,20231226,0,0,0,0.0,24.0,24.4
726,北方森林动物园,20231227,0,0,0,0.0,12.2,24.4
727,北方森林动物园,20231228,0,0,0,0.0,0.0,18.5
728,北方森林动物园,20231229,0,0,0,0.0,0.0,18.5
729,北方森林动物园,20231230,120,59,61,0.0,24.0,30.5
730,北方森林动物园,20231231,63,0,63,120.0,36.6,30.3
731,北方森林动物园,20240101,0,0,0,63.0,36.6,24.4
732,北方森林动物园,20240102,59,59,0,0.0,48.4,24.2
733,北方森林动物园,20240103,0,0,0,59.0,48.4,24.2
734,北方森林动物园,20240104,63,0,63,0.0,37.0,30.5
735,北方森林动物园,20240105,0,0,0,63.0,24.4,30.5
736,北方森林动物园,20240106,124,59,65,0.0,49.2,42.9
737,北方森林动物园,20240107,67,0,67,124.0,50.8,49.6
738,北方森林动物园,20240108,0,0,0,67.0,50.8,49.6
739,北方森林动物园,20240109,59,59,0,0.0,50.0,43.5
740,北方森林动物园,20240110,66,0,66,59.0,63.2,43.8
741,北方森林动物园,20240111,61,61,0,66.0,50.6,49.9
742,北方森林动物园,20240112,0,0,0,61.0,37.2,44.0
743,北方森林动物园,20240113,0,0,0,0.0,37.2,44.0
744,北方森林动物园,20240114,59,59,0,0.0,37.2,43.6
745,北方森林动物园,20240115,0,0,0,59.0,24.0,43.6
746,北方森林动物园,20240116,61,0,61,0.0,24.0,37.3
747,北方森林动物园,20240117,65,0,65,61.0,37.0,37.1
748,北方森林动物园,20240118,61,0,61,65.0,49.2,43.2
749,北方森林动物园,20240119,0,0,0,61.0,37.4,37.3
750,北方森林动物园,20240120,0,0,0,0.0,37.4,30.7
751,北方森林动物园,20240121,66,0,66,0.0,38.4,31.2
752,北方森林动物园,20240122,120,59,61,66.0,49.4,43.2
753,北方森林动物园,20240123,0,0,0,120.0,37.2,43.2
754,北方森林动物园,20240124,63,63,0,0.0,49.8,43.6
755,北方森林动物园,20240125,0,0,0,63.0,49.8,43.6
756,北方森林动物园,20240126,126,59,67,0.0,61.8,50.1
757,北方森林动物园,20240127,0,0,0,126.0,37.8,43.6
758,北方森林动物园,20240128,0,0,0,0.0,37.8,37.5
759,北方森林动物园,20240129,129,59,70,0.0,51.0,50.4
760,北方森林动物园,20240130,59,59,0,129.0,62.8,56.3
761,北方森林动物园,20240131,59,59,0,59.0,49.4,55.6
762,北方森林动物园,20240201,0,0,0,59.0,49.4,43.6
763,北方森林动物园,20240202,0,0,0,0.0,49.4,43.6
764,北方森林动物园,20240203,0,0,0,0.0,23.6,37.3
765,北方森林动物园,20240204,0,0,0,0.0,11.8,37.3
766,北方森林动物园,20240205,61,61,0,0.0,12.2,30.8
767,北方森林动物园,20240206,59,59,0,61.0,24.0,36.7
768,北方森林动物园,20240207,126,61,65,59.0,49.2,49.3
769,北方森林动物园,20240208,63,0,63,126.0,61.8,42.7
770,北方森林动物园,20240209,0,0,0,63.0,61.8,36.8
771,北方森林动物园,20240210,65,0,65,0.0,62.6,37.4
772,北方森林动物园,20240211,129,59,70,65.0,76.6,50.3
773,北方森林动物园,20240212,61,0,61,129.0,63.6,56.4
774,北方森林动物园,20240213,65,0,65,61.0,64.0,62.9
775,北方森林动物园,20240214,127,64,63,65.0,89.4,75.6
776,北方森林动物园,20240215,83,0,83,127.0,93.0,77.8
777,北方森林动物园,20240216,67,0,67,83.0,80.6,78.6
778,北方森林动物园,20240217,66,0,66,67.0,81.6,72.6
779,北方森林动物园,20240218,67,0,67,66.0,82.0,73.0
780,北方森林动物园,20240219,0,0,0,67.0,56.6,73.0
781,北方森林动物园,20240220,65,0,65,0.0,53.0,73.0
782,北方森林动物园,20240221,63,0,63,65.0,52.2,66.4
783,北方森林动物园,20240222,0,0,0,63.0,39.0,60.3
784,北方森林动物园,20240223,61,0,61,0.0,37.8,59.9
785,北方森林动物园,20240224,65,0,65,61.0,50.8,53.7
786,北方森林动物园,20240225,63,0,63,65.0,50.4,51.7
787,北方森林动物园,20240226,61,0,61,63.0,50.0,51.1
788,北方森林动物园,20240227,61,0,61,61.0,62.2,50.6
789,北方森林动物园,20240228,65,0,65,61.0,63.0,50.4
790,北方森林动物园,20240229,65,0,65,65.0,63.0,56.9
791,北方森林动物园,20240301,0,0,0,65.0,50.4,50.4
792,北方森林动物园,20240302,80,0,80,0.0,54.2,52.1
793,北方森林动物园,20240303,120,59,61,80.0,66.0,64.1
794,北方森林动物园,20240304,61,0,61,120.0,65.2,64.1
795,北方森林动物园,20240305,66,0,66,61.0,65.4,64.2
796,北方森林动物园,20240306,0,0,0,66.0,65.4,57.9
797,北方森林动物园,20240307,66,0,66,0.0,62.6,58.4
798,北方森林动物园,20240308,65,0,65,66.0,51.6,58.8
799,北方森林动物园,20240309,78,0,78,65.0,55.0,60.1
800,北方森林动物园,20240310,132,61,71,78.0,68.2,66.8
801,北方森林动物园,20240311,59,59,0,132.0,80.0,72.7
802,北方森林动物园,20240312,67,0,67,59.0,80.2,71.4
803,北方森林动物园,20240313,65,0,65,67.0,80.2,65.9
804,北方森林动物园,20240314,67,0,67,65.0,78.0,66.5
805,北方森林动物园,20240315,67,0,67,67.0,65.0,66.6
806,北方森林动物园,20240316,67,0,67,67.0,66.6,73.3
807,北方森林动物园,20240317,65,0,65,67.0,66.2,73.2
808,北方森林动物园,20240318,66,0,66,65.0,66.4,73.3
809,北方森林动物园,20240319,74,0,74,66.0,67.8,72.9
810,北方森林动物园,20240320,66,0,66,74.0,67.6,66.3
811,北方森林动物园,20240321,61,0,61,66.0,66.4,66.5
812,北方森林动物园,20240322,63,0,63,61.0,66.0,66.1
813,北方森林动物园,20240323,126,59,67,63.0,78.0,72.2
814,北方森林动物园,20240324,137,59,78,126.0,90.6,79.2
815,北方森林动物园,20240325,156,63,93,137.0,108.6,88.1
816,北方森林动物园,20240326,145,63,82,156.0,125.4,95.9
817,北方森林动物园,20240327,135,68,67,145.0,139.8,102.9
818,北方森林动物园,20240328,133,59,74,135.0,141.2,109.6
819,北方森林动物园,20240329,146,63,83,133.0,143.0,116.8
820,北方森林动物园,20240330,69,0,69,146.0,125.6,117.1
821,北方森林动物园,20240331,71,0,71,69.0,110.8,118.1
822,北方森林动物园,20240401,137,63,74,71.0,111.2,125.5
823,北方森林动物园,20240402,149,63,86,137.0,114.4,127.8
824,北方森林动物园,20240403,200,78,122,149.0,125.2,134.1
825,北方森林动物园,20240404,208,59,149,200.0,153.0,139.3
826,北方森林动物园,20240405,204,61,143,208.0,179.6,145.2
827,北方森林动物园,20240406,108,0,108,204.0,173.8,142.5
828,北方森林动物园,20240407,148,59,89,108.0,173.6,144.0
829,北方森林动物园,20240408,128,59,69,148.0,159.2,142.2
830,北方森林动物园,20240409,137,61,76,128.0,145.0,149.0
831,北方森林动物园,20240410,76,0,76,137.0,119.4,149.5
832,北方森林动物园,20240411,146,66,80,76.0,127.0,150.4
833,北方森林动物园,20240412,79,0,79,146.0,113.2,143.4
834,北方森林动物园,20240413,165,57,108,79.0,120.6,139.9
835,北方森林动物园,20240414,87,0,87,165.0,110.6,127.8
836,北方森林动物园,20240415,135,57,78,87.0,122.4,120.9
837,北方森林动物园,20240416,128,57,71,135.0,118.8,122.9
838,北方森林动物园,20240417,140,57,83,128.0,131.0,122.1
839,北方森林动物园,20240418,160,61,99,140.0,130.0,125.3
840,北方森林动物园,20240419,153,61,92,160.0,143.2,126.9
841,北方森林动物园,20240420,169,59,110,153.0,150.0,136.2
842,北方森林动物园,20240421,121,0,121,169.0,148.6,133.7
843,北方森林动物园,20240422,163,57,106,121.0,153.2,142.1
844,北方森林动物园,20240423,160,63,97,163.0,153.2,141.6
845,北方森林动物园,20240424,108,0,108,160.0,144.2,143.7
846,北方森林动物园,20240425,167,61,106,108.0,143.8,146.9
847,北方森林动物园,20240426,186,68,118,167.0,156.8,152.7
848,北方森林动物园,20240427,163,0,163,186.0,156.8,155.0
849,北方森林动物园,20240428,217,66,151,163.0,168.2,160.7
850,北方森林动物园,20240429,216,61,155,217.0,189.8,167.0
851,北方森林动物园,20240430,353,82,271,216.0,227.0,185.4
1,萧红故居,20220101,61,0,61,353.0,202.0,179.4
2,萧红故居,20220102,128,59,69,61.0,195.0,175.9
3,萧红故居,20220103,67,0,67,128.0,165.0,166.6
4,萧红故居,20220104,125,59,66,67.0,146.8,168.3
5,萧红故居,20220105,65,0,65,125.0,89.2,158.1
6,萧红故居,20220106,59,59,0,65.0,88.8,145.4
7,萧红故居,20220107,67,0,67,59.0,76.6,135.8
8,萧红故居,20220108,79,0,79,67.0,79.0,122.0
9,萧红故居,20220109,65,0,65,79.0,67.0,106.9
10,萧红故居,20220110,0,0,0,65.0,54.0,71.6
11,萧红故居,20220111,124,59,65,0.0,67.0,77.9
12,萧红故居,20220112,65,0,65,124.0,66.6,71.6
13,萧红故居,20220113,134,63,71,65.0,77.6,78.3
14,萧红故居,20220114,130,61,69,134.0,90.6,78.8
15,萧红故居,20220115,66,0,66,130.0,103.8,78.9
16,萧红故居,20220116,66,0,66,66.0,92.2,79.6
17,萧红故居,20220117,63,0,63,66.0,91.8,79.2
18,萧红故居,20220118,137,59,78,63.0,92.4,85.0
19,萧红故居,20220119,124,61,63,137.0,91.2,90.9
20,萧红故居,20220120,66,0,66,124.0,91.2,97.5
21,萧红故居,20220121,128,59,69,66.0,103.6,97.9
22,萧红故居,20220122,67,0,67,128.0,104.4,98.1
23,萧红故居,20220123,79,0,79,67.0,92.8,92.6
24,萧红故居,20220124,70,0,70,79.0,82.0,86.6
25,萧红故居,20220125,0,0,0,70.0,68.8,80.0
26,萧红故居,20220126,65,0,65,0.0,56.2,79.9
27,萧红故居,20220127,129,59,70,65.0,68.6,86.5
28,萧红故居,20220128,80,0,80,129.0,68.8,80.8
29,萧红故居,20220129,70,0,70,80.0,68.8,75.4
30,萧红故居,20220130,73,0,73,70.0,83.4,76.1
31,萧红故居,20220131,67,0,67,73.0,83.8,70.0
32,萧红故居,20220201,67,0,67,67.0,71.4,70.0
33,萧红故居,20220202,79,0,79,67.0,71.2,70.0
34,萧红故居,20220203,139,63,76,79.0,85.0,76.9
35,萧红故居,20220204,74,0,74,139.0,85.2,84.3
36,萧红故居,20220205,73,0,73,74.0,86.4,85.1
37,萧红故居,20220206,74,0,74,73.0,87.8,79.6
38,萧红故居,20220207,0,0,0,74.0,72.0,71.6
39,萧红故居,20220208,129,66,63,0.0,70.0,77.5
40,萧红故居,20220209,125,59,66,129.0,80.2,82.7
41,萧红故居,20220210,144,68,76,125.0,94.4,90.4
42,萧红故居,20220211,67,0,67,144.0,93.0,90.4
43,萧红故居,20220212,67,0,67,67.0,106.4,89.2
44,萧红故居,20220213,63,0,63,67.0,93.2,81.6
45,萧红故居,20220214,74,0,74,63.0,83.0,81.6
46,萧红故居,20220215,65,0,65,74.0,67.2,80.8
47,萧红故居,20220216,140,64,76,65.0,81.8,87.4
48,萧红故居,20220217,78,0,78,140.0,84.0,95.2
49,萧红故居,20220218,80,0,80,78.0,87.4,90.3
50,萧红故居,20220219,143,61,82,80.0,101.2,92.1
51,萧红故居,20220220,82,0,82,143.0,104.6,85.9
52,萧红故居,20220221,166,64,102,82.0,109.8,95.8
53,萧红故居,20220222,92,0,92,166.0,112.6,98.3
54,萧红故居,20220223,194,64,130,92.0,135.4,111.4
55,萧红故居,20220224,100,0,100,194.0,126.8,114.0
56,萧红故居,20220225,95,0,95,100.0,129.4,117.0
57,萧红故居,20220226,164,59,105,95.0,129.0,119.4
58,萧红故居,20220227,176,59,117,164.0,145.8,129.2
59,萧红故居,20220228,144,64,80,176.0,135.8,135.6
60,萧红故居,20220301,141,59,82,144.0,144.0,135.4
61,萧红故居,20220302,156,63,93,141.0,156.2,142.8
62,萧红故居,20220303,105,0,105,156.0,144.4,136.7
63,萧红故居,20220304,76,0,76,105.0,124.4,135.1
64,萧红故居,20220305,99,0,99,76.0,115.4,125.6
65,萧红故居,20220306,145,59,86,99.0,116.2,130.1
66,萧红故居,20220307,155,59,96,145.0,116.0,136.1
67,萧红故居,20220308,89,0,89,155.0,112.8,128.6
68,萧红故居,20220309,137,59,78,89.0,125.0,124.7
69,萧红故居,20220310,139,63,76,137.0,133.0,124.2
70,萧红故居,20220311,73,0,73,139.0,118.6,117.4
71,萧红故居,20220312,89,0,89,73.0,105.4,110.7
72,萧红故居,20220313,80,0,80,89.0,103.6,108.2
73,萧红故居,20220314,137,59,78,80.0,103.6,114.3
74,萧红故居,20220315,141,61,80,137.0,104.0,118.5
75,萧红故居,20220316,82,0,82,141.0,105.8,112.2
76,萧红故居,20220317,78,0,78,82.0,103.6,104.5
77,萧红故居,20220318,130,59,71,78.0,113.6,108.6
78,萧红故居,20220319,135,61,74,130.0,113.2,108.4
79,萧红故居,20220320,78,0,78,135.0,100.6,102.3
80,萧红故居,20220321,130,59,71,78.0,110.2,108.0
81,萧红故居,20220322,137,59,78,130.0,122.0,112.8
82,萧红故居,20220323,63,0,63,137.0,108.6,111.1
83,萧红故居,20220324,74,0,74,63.0,96.4,104.8
84,萧红故居,20220325,65,0,65,74.0,93.8,97.2
85,萧红故居,20220326,79,0,79,65.0,83.6,96.9
86,萧红故居,20220327,74,0,74,79.0,71.0,96.5
87,萧红故居,20220328,139,61,78,74.0,86.2,97.4
88,萧红故居,20220329,146,66,80,139.0,100.6,98.5
89,萧红故居,20220330,71,0,71,146.0,101.8,97.8
90,萧红故居,20220331,70,0,70,71.0,100.0,91.8
91,萧红故居,20220401,67,0,67,70.0,98.6,84.8
92,萧红故居,20220402,124,59,65,67.0,95.6,90.9
93,萧红故居,20220403,122,59,63,124.0,90.8,95.7
94,萧红故居,20220404,66,0,66,122.0,89.8,95.8
95,萧红故居,20220405,139,63,76,66.0,103.6,101.8
96,萧红故居,20220406,130,59,71,139.0,116.2,107.4
97,萧红故居,20220407,0,0,0,130.0,91.4,93.5
98,萧红故居,20220408,71,0,71,0.0,81.2,86.0
99,萧红故居,20220409,76,0,76,71.0,83.2,86.5
100,萧红故居,20220410,69,0,69,76.0,69.2,86.4
101,萧红故居,20220411,71,0,71,69.0,57.4,86.8
102,萧红故居,20220412,128,59,69,71.0,83.0,87.2
103,萧红故居,20220413,71,0,71,128.0,83.0,82.1
104,萧红故居,20220414,135,59,76,71.0,94.8,89.0
105,萧红故居,20220415,69,0,69,135.0,94.8,82.0
106,萧红故居,20220416,69,0,69,69.0,94.4,75.9
107,萧红故居,20220417,71,0,71,69.0,83.0,83.0
108,萧红故居,20220418,66,0,66,71.0,82.0,82.5
109,萧红故居,20220419,129,64,65,66.0,80.8,87.8
110,萧红故居,20220420,78,0,78,129.0,82.6,88.7
111,萧红故居,20220421,135,59,76,78.0,95.8,95.1
112,萧红故居,20220422,122,61,61,135.0,106.0,94.5
113,萧红故居,20220423,124,59,65,122.0,117.6,99.8
114,萧红故居,20220424,63,0,63,124.0,104.4,92.6
115,萧红故居,20220425,126,59,67,63.0,114.0,98.3
116,萧红故居,20220426,131,61,70,126.0,113.2,104.5
117,萧红故居,20220427,70,0,70,131.0,102.8,104.4
118,萧红故居,20220428,126,59,67,70.0,103.2,110.4
119,萧红故居,20220429,137,61,76,126.0,118.0,111.2
120,萧红故居,20220430,86,0,86,137.0,110.0,112.0
121,萧红故居,20220501,139,59,80,86.0,111.6,112.4
122,萧红故居,20220502,132,61,71,139.0,124.0,113.4
123,萧红故居,20220503,65,0,65,132.0,111.8,107.5
124,萧红故居,20220504,141,59,82,65.0,112.6,115.3
125,萧红故居,20220505,80,0,80,141.0,111.4,110.7
126,萧红故居,20220506,69,0,69,80.0,97.4,104.5
127,萧红故居,20220507,67,0,67,69.0,84.4,104.2
128,萧红故居,20220508,70,0,70,67.0,85.4,98.6
129,萧红故居,20220509,66,0,66,70.0,70.4,91.5
130,萧红故居,20220510,74,0,74,66.0,69.2,90.3
131,萧红故居,20220511,129,59,70,74.0,81.2,89.3
132,萧红故居,20220512,133,59,74,129.0,94.4,89.4
133,萧红故居,20220513,71,0,71,133.0,94.6,90.0
134,萧红故居,20220514,131,61,70,71.0,107.6,89.0
135,萧红故居,20220515,73,0,73,131.0,107.4,88.3
136,萧红故居,20220516,132,61,71,73.0,108.0,94.6
137,萧红故居,20220517,135,61,74,132.0,108.4,101.4
138,萧红故居,20220518,139,61,78,135.0,122.0,108.3
139,萧红故居,20220519,152,70,82,139.0,126.2,116.9
140,萧红故居,20220520,129,59,70,152.0,137.4,122.4
141,萧红故居,20220521,144,61,83,129.0,139.8,123.9
142,萧红故居,20220522,142,59,83,144.0,141.2,124.8
143,萧红故居,20220523,76,0,76,142.0,128.6,125.3
144,萧红故居,20220524,71,0,71,76.0,112.4,119.3
145,萧红故居,20220525,83,0,83,71.0,103.2,120.3
146,萧红故居,20220526,139,59,80,83.0,102.2,121.0
147,萧红故居,20220527,137,59,78,139.0,101.2,121.2
148,萧红故居,20220528,87,0,87,137.0,103.4,116.0
149,萧红故居,20220529,82,0,82,87.0,105.6,109.0
150,萧红故居,20220530,146,59,87,82.0,118.2,110.7
151,萧红故居,20220531,86,0,86,146.0,107.6,104.9
152,萧红故居,20220601,100,0,100,86.0,100.2,100.7
153,萧红故居,20220602,69,0,69,100.0,96.6,100.0
154,萧红故居,20220603,87,0,87,69.0,97.6,101.6
155,萧红故居,20220604,143,59,84,87.0,97.0,107.6
156,萧红故居,20220605,76,0,76,143.0,95.0,101.3
157,萧红故居,20220606,144,68,76,76.0,103.8,102.0
158,萧红故居,20220607,149,63,86,144.0,119.8,108.2
159,萧红故居,20220608,86,0,86,149.0,119.6,108.6
160,萧红故居,20220609,142,59,83,86.0,119.4,108.2
161,萧红故居,20220610,82,0,82,142.0,120.6,107.8
162,萧红故居,20220611,78,0,78,82.0,107.4,105.6
163,萧红故居,20220612,128,59,69,78.0,103.2,111.5
164,萧红故居,20220613,142,63,79,128.0,114.4,117.0
165,萧红故居,20220614,137,68,69,142.0,113.4,116.4
166,萧红故居,20220615,155,72,83,137.0,128.0,124.3
167,萧红故居,20220616,154,68,86,155.0,143.2,125.3
168,萧红故居,20220617,137,63,74,154.0,145.0,124.1
169,萧红故居,20220618,144,61,83,137.0,145.4,129.9
170,萧红故居,20220619,153,64,89,144.0,148.6,131.0
171,萧红故居,20220620,76,0,76,153.0,132.8,130.4
172,萧红故居,20220621,144,66,78,76.0,130.8,137.0
173,萧红故居,20220622,150,63,87,144.0,133.4,139.2
174,萧红故居,20220623,163,63,100,150.0,137.2,141.3
175,萧红故居,20220624,158,61,97,163.0,138.2,143.4
176,萧红故居,20220625,82,0,82,158.0,139.4,136.1
177,萧红故居,20220626,84,0,84,82.0,127.4,129.1
178,萧红故居,20220627,176,68,108,84.0,132.6,133.0
179,萧红故居,20220628,149,63,86,176.0,129.8,133.5
180,萧红故居,20220629,96,0,96,149.0,117.4,127.8
181,萧红故居,20220630,169,59,110,96.0,134.8,137.1
182,萧红故居,20220701,145,59,86,169.0,147.0,137.2
183,萧红故居,20220702,89,0,89,145.0,129.6,131.1
184,萧红故居,20220703,97,0,97,89.0,119.2,124.5
185,萧红故居,20220704,142,64,78,97.0,128.4,122.9
186,萧红故居,20220705,143,61,82,142.0,123.2,129.0
187,萧红故居,20220706,147,61,86,143.0,123.6,135.3
188,萧红故居,20220707,80,0,80,147.0,121.8,125.7
189,萧红故居,20220708,161,64,97,80.0,134.6,126.9
190,萧红故居,20220709,87,0,87,161.0,123.6,126.0
191,萧红故居,20220710,84,0,84,87.0,111.8,117.5
192,萧红故居,20220711,152,59,93,84.0,112.8,118.2
193,萧红故居,20220712,121,0,121,152.0,121.0,121.4
194,萧红故居,20220713,164,59,105,121.0,121.6,128.1
195,萧红故居,20220714,143,61,82,164.0,132.8,128.2
196,萧红故居,20220715,171,59,112,143.0,150.2,131.0
197,萧红故居,20220716,117,0,117,171.0,143.2,128.0
198,萧红故居,20220717,118,0,118,117.0,142.6,131.8
199,萧红故居,20220718,163,59,104,118.0,142.4,132.0
200,萧红故居,20220719,154,68,86,163.0,144.6,138.7
201,萧红故居,20220720,158,61,97,154.0,142.0,146.1
202,萧红故居,20220721,87,0,87,158.0,136.0,139.6
203,萧红故居,20220722,109,0,109,87.0,134.2,138.4
204,萧红故居,20220723,139,0,139,109.0,129.4,135.9
205,萧红故居,20220724,119,0,119,139.0,122.4,133.5
206,萧红故居,20220725,182,63,119,119.0,127.2,134.6
207,萧红故居,20220726,106,0,106,182.0,131.0,133.5
208,萧红故居,20220727,163,63,100,106.0,141.8,138.0
209,萧红故居,20220728,170,66,104,163.0,148.0,138.7
210,萧红故居,20220729,172,64,108,170.0,158.6,140.5
211,萧红故居,20220730,172,59,113,172.0,156.6,141.9
212,萧红故居,20220731,193,59,134,172.0,174.0,152.5
213,萧红故居,20220801,163,59,104,193.0,174.0,157.9
214,萧红故居,20220802,141,61,80,163.0,168.2,158.1
215,萧红故居,20220803,104,0,104,141.0,154.6,156.6
216,萧红故居,20220804,174,59,115,104.0,155.0,155.8
217,萧红故居,20220805,121,0,121,174.0,140.6,157.3
218,萧红故居,20220806,185,63,122,121.0,145.0,159.5
219,萧红故居,20220807,169,59,110,185.0,150.6,159.4
220,萧红故居,20220808,174,68,106,169.0,164.6,159.6
221,萧红故居,20220809,167,59,108,174.0,163.2,159.1
222,萧红故居,20220810,160,61,99,167.0,171.0,155.8
223,萧红故居,20220811,155,59,96,160.0,165.0,155.0
224,萧红故居,20220812,151,59,92,155.0,161.4,156.0
225,萧红故居,20220813,173,63,110,151.0,161.2,162.9
226,萧红故居,20220814,92,0,92,173.0,146.2,154.7
227,萧红故居,20220815,155,59,96,92.0,145.2,158.1
228,萧红故居,20220816,158,61,97,155.0,145.8,155.4
229,萧红故居,20220817,147,63,84,158.0,145.0,153.2
230,萧红故居,20220818,163,59,104,147.0,143.0,152.1
231,萧红故居,20220819,154,63,91,163.0,155.4,150.8
232,萧红故居,20220820,92,0,92,154.0,142.8,144.0
233,萧红故居,20220821,177,64,113,92.0,146.6,146.2
234,萧红故居,20220822,84,0,84,177.0,134.0,139.5
235,萧红故居,20220823,146,64,82,84.0,130.6,136.8
236,萧红故居,20220824,161,61,100,146.0,132.0,143.7
237,萧红故居,20220825,155,59,96,161.0,144.6,143.7
238,萧红故居,20220826,141,59,82,155.0,137.4,142.0
239,萧红故居,20220827,92,0,92,141.0,139.0,136.5
240,萧红故居,20220828,69,0,69,92.0,123.6,127.1
241,萧红故居,20220829,80,0,80,69.0,107.4,119.7
242,萧红故居,20220830,74,0,74,80.0,91.2,117.9
243,萧红故居,20220831,66,0,66,74.0,76.2,106.8
244,萧红故居,20220901,59,59,0,66.0,69.6,104.3
245,萧红故居,20220902,128,63,65,59.0,81.4,102.5
246,萧红故居,20220903,65,0,65,128.0,78.4,92.9
247,萧红故居,20220904,65,0,65,65.0,76.6,83.9
248,萧红故居,20220905,70,0,70,65.0,77.4,76.8
249,萧红故居,20220906,130,61,69,70.0,91.6,80.6
250,萧红故居,20220907,131,61,70,130.0,92.2,86.8
251,萧红故居,20220908,74,0,74,131.0,94.0,86.2
252,萧红故居,20220909,143,61,82,74.0,109.6,93.1
253,萧红故居,20220910,70,0,70,143.0,109.6,93.5
254,萧红故居,20220911,78,0,78,70.0,99.2,95.4
255,萧红故居,20220912,83,0,83,78.0,89.6,90.9
256,萧红故居,20220913,70,0,70,83.0,88.8,91.4
257,萧红故居,20220914,76,0,76,70.0,75.4,92.5
258,萧红故居,20220915,84,0,84,76.0,78.2,93.9
259,萧红故居,20220916,69,0,69,84.0,76.4,87.8
260,萧红故居,20220917,69,0,69,69.0,73.6,81.6
261,萧红故居,20220918,70,0,70,69.0,73.6,81.2
262,萧红故居,20220919,78,0,78,70.0,74.0,74.7
263,萧红故居,20220920,67,0,67,78.0,70.6,74.4
264,萧红故居,20220921,65,0,65,67.0,69.8,73.1
265,萧红故居,20220922,70,0,70,65.0,70.0,71.8
266,萧红故居,20220923,140,64,76,70.0,84.0,78.8
267,萧红故居,20220924,69,0,69,140.0,82.2,78.1
268,萧红故居,20220925,69,0,69,69.0,82.6,76.6
269,萧红故居,20220926,61,61,0,69.0,81.8,75.8
270,萧红故居,20220927,63,0,63,61.0,80.4,75.2
271,萧红故居,20220928,66,0,66,63.0,65.6,74.8
272,萧红故居,20220929,69,0,69,66.0,65.6,73.9
273,萧红故居,20220930,83,0,83,69.0,68.4,75.5
274,萧红故居,20221001,80,0,80,83.0,72.2,77.0
275,萧红故居,20221002,95,0,95,80.0,78.6,79.5
276,萧红故居,20221003,70,0,70,95.0,79.4,72.5
277,萧红故居,20221004,80,0,80,70.0,81.6,73.6
278,萧红故居,20221005,89,0,89,80.0,82.8,75.6
279,萧红故居,20221006,133,63,70,89.0,93.4,82.8
280,萧红故居,20221007,142,59,83,133.0,102.8,90.7
281,萧红故居,20221008,79,0,79,142.0,104.6,92.0
282,萧红故居,20221009,66,0,66,79.0,101.8,91.7
283,萧红故居,20221010,126,63,63,66.0,109.2,96.0
284,萧红故居,20221011,70,0,70,126.0,96.6,95.0
285,萧红故居,20221012,63,0,63,70.0,80.8,91.8
286,萧红故居,20221013,63,0,63,63.0,77.6,91.1
287,萧红故居,20221014,0,0,0,63.0,64.4,83.1
288,萧红故居,20221015,143,63,80,0.0,67.8,88.5
289,萧红故居,20221016,67,0,67,143.0,67.2,81.9
290,萧红故居,20221017,122,59,63,67.0,79.0,79.9
291,萧红故居,20221018,71,0,71,122.0,80.6,79.1
292,萧红故居,20221019,80,0,80,71.0,96.6,80.5
293,萧红故居,20221020,141,63,78,80.0,96.2,82.0
294,萧红故居,20221021,76,0,76,141.0,98.0,82.6
295,萧红故居,20221022,83,0,83,76.0,90.2,84.6
296,萧红故居,20221023,141,59,82,83.0,104.2,92.4
297,萧红故居,20221024,76,0,76,141.0,103.4,100.0
298,萧红故居,20221025,87,0,87,76.0,92.6,94.4
299,萧红故居,20221026,135,59,76,87.0,104.4,101.2
300,萧红故居,20221027,76,0,76,135.0,103.0,96.6
301,萧红故居,20221028,135,59,76,76.0,101.8,103.0
302,萧红故居,20221029,157,64,93,135.0,118.0,110.7
303,萧红故居,20221030,70,0,70,157.0,114.6,103.6
304,萧红故居,20221031,124,59,65,70.0,112.4,108.4
305,萧红故居,20221101,69,0,69,124.0,111.0,107.0
306,萧红故居,20221102,69,0,69,69.0,97.8,99.8
307,萧红故居,20221103,138,59,79,69.0,94.0,106.0
308,萧红故居,20221104,126,59,67,138.0,105.2,109.9
309,萧红故居,20221105,70,0,70,126.0,94.4,103.4
310,萧红故居,20221106,125,59,66,70.0,105.6,108.3
311,萧红故居,20221107,140,66,74,125.0,119.8,108.8
312,萧红故居,20221108,139,59,80,140.0,120.0,107.0
313,萧红故居,20221109,132,59,73,139.0,121.2,113.2
314,萧红故居,20221110,70,0,70,132.0,121.2,107.8
315,萧红故居,20221111,137,61,76,70.0,123.6,114.6
316,萧红故居,20221112,76,0,76,137.0,110.8,115.3
317,萧红故居,20221113,132,61,71,76.0,109.4,114.7
318,萧红故居,20221114,70,0,70,132.0,97.0,109.1
319,萧红故居,20221115,0,0,0,70.0,83.0,102.1
320,萧红故居,20221116,134,61,73,0.0,82.4,103.0
321,萧红故居,20221117,65,0,65,134.0,80.2,95.5
322,萧红故居,20221118,136,63,73,65.0,81.0,95.2
323,萧红故居,20221119,135,61,74,136.0,94.0,95.5
324,萧红故居,20221120,70,0,70,135.0,108.0,95.5
325,萧红故居,20221121,78,0,78,70.0,96.8,89.6
326,萧红故居,20221122,71,0,71,78.0,98.0,89.1
327,萧红故居,20221123,67,0,67,71.0,84.2,82.6
328,萧红故居,20221124,70,0,70,67.0,71.2,82.6
329,萧红故居,20221125,63,0,63,70.0,69.8,88.9
330,萧红故居,20221126,130,61,69,63.0,80.2,88.5
331,萧红故居,20221127,65,0,65,130.0,79.0,88.5
332,萧红故居,20221128,69,0,69,65.0,79.4,81.8
333,萧红故居,20221129,122,59,63,69.0,89.8,80.5
334,萧红故居,20221130,61,0,61,122.0,89.4,79.6
335,萧红故居,20221201,67,0,67,61.0,76.8,78.5
336,萧红故居,20221202,74,0,74,67.0,78.6,78.8
337,萧红故居,20221203,69,0,69,74.0,78.6,79.0
338,萧红故居,20221204,65,0,65,69.0,67.2,78.5
339,萧红故居,20221205,69,0,69,65.0,68.8,79.1
340,萧红故居,20221206,138,59,79,69.0,83.0,79.9
341,萧红故居,20221207,124,61,63,138.0,93.0,85.8
342,萧红故居,20221208,78,0,78,124.0,94.8,86.7
343,萧红故居,20221209,80,0,80,78.0,97.8,82.5
344,萧红故居,20221210,67,0,67,80.0,97.4,83.1
345,萧红故居,20221211,131,61,70,67.0,96.0,89.5
346,萧红故居,20221212,67,0,67,131.0,84.6,88.8
347,萧红故居,20221213,122,61,61,67.0,93.4,94.1
348,萧红故居,20221214,126,61,65,122.0,102.6,100.2
349,萧红故居,20221215,0,0,0,126.0,89.2,93.3
350,萧红故居,20221216,125,59,66,0.0,88.0,92.0
351,萧红故居,20221217,73,0,73,125.0,89.2,86.9
352,萧红故居,20221218,0,0,0,73.0,64.8,79.1
353,萧红故居,20221219,122,59,63,0.0,64.0,83.3
354,萧红故居,20221220,59,59,0,122.0,75.8,82.5
355,萧红故居,20221221,125,59,66,59.0,75.8,81.9
356,萧红故居,20221222,65,0,65,125.0,74.2,81.7
357,萧红故居,20221223,0,0,0,65.0,74.2,69.5
358,萧红故居,20221224,67,0,67,0.0,63.2,63.6
359,萧红故居,20221225,125,59,66,67.0,76.4,76.1
360,萧红故居,20221226,67,0,67,125.0,64.8,70.3
361,萧红故居,20221227,65,0,65,67.0,64.8,69.5
362,萧红故居,20221228,126,63,63,65.0,90.0,82.1
363,萧红故居,20221229,80,0,80,126.0,92.6,77.9
364,萧红故居,20221230,65,0,65,80.0,80.6,78.5
365,萧红故居,20221231,70,0,70,65.0,81.2,73.0
366,萧红故居,20230101,127,61,66,70.0,93.6,79.2
367,萧红故居,20230102,73,0,73,127.0,83.0,86.5
368,萧红故居,20230103,131,61,70,73.0,93.2,92.9
369,萧红故居,20230104,126,61,65,131.0,105.4,93.0
370,萧红故居,20230105,137,63,74,126.0,118.8,100.0
371,萧红故居,20230106,124,61,63,137.0,118.2,105.9
372,萧红故居,20230107,76,0,76,124.0,118.8,100.9
373,萧红故居,20230108,71,0,71,76.0,106.8,100.0
374,萧红故居,20230109,69,0,69,71.0,95.4,100.4
375,萧红故居,20230110,122,59,63,69.0,92.4,105.6
376,萧红故居,20230111,73,0,73,122.0,82.2,100.2
377,萧红故居,20230112,129,64,65,73.0,92.8,105.8
378,萧红故居,20230113,135,61,74,129.0,105.6,106.2
379,萧红故居,20230114,132,59,73,135.0,118.2,106.8
380,萧红故居,20230115,65,0,65,132.0,106.8,99.6
381,萧红故居,20230116,70,0,70,65.0,106.2,94.2
382,萧红故居,20230117,65,0,65,70.0,93.4,93.1
383,萧红故居,20230118,73,0,73,65.0,81.0,93.3
384,萧红故居,20230119,146,59,87,73.0,83.8,101.0
385,萧红故居,20230120,78,0,78,146.0,86.4,96.6
386,萧红故居,20230121,66,0,66,78.0,85.6,95.9
387,萧红故居,20230122,71,0,71,66.0,86.8,90.1
388,萧红故居,20230123,65,0,65,71.0,85.2,83.1
389,萧红故居,20230124,80,0,80,65.0,72.0,77.9
390,萧红故居,20230125,143,61,82,80.0,85.0,85.7
391,萧红故居,20230126,84,0,84,143.0,88.6,87.1
392,萧红故居,20230127,82,0,82,84.0,90.8,88.8
393,萧红故居,20230128,96,0,96,82.0,97.0,91.1
394,萧红故居,20230129,74,0,74,96.0,95.8,83.9
395,萧红故居,20230130,135,59,76,74.0,94.2,89.6
396,萧红故居,20230131,70,0,70,135.0,91.4,90.0
397,萧红故居,20230201,135,61,74,70.0,102.0,96.4
398,萧红故居,20230202,135,59,76,135.0,109.8,103.4
399,萧红故居,20230203,156,61,95,135.0,126.2,111.0
400,萧红故居,20230204,69,0,69,156.0,113.0,103.6
401,萧红故居,20230205,140,61,79,69.0,127.0,109.2
402,萧红故居,20230206,83,0,83,140.0,116.6,109.3
403,萧红故居,20230207,154,61,93,83.0,120.4,115.1
404,萧红故居,20230208,181,64,117,154.0,125.4,125.8
405,萧红故居,20230209,187,64,123,181.0,149.0,131.0
406,萧红故居,20230210,184,59,125,187.0,157.8,142.4
407,萧红故居,20230211,159,59,100,184.0,173.0,144.8
408,萧红故居,20230212,170,61,109,159.0,176.2,148.3
409,萧红故居,20230213,176,61,115,170.0,175.2,150.3
410,萧红故居,20230214,160,61,99,176.0,169.8,159.4
411,萧红故居,20230215,169,64,105,160.0,166.8,162.3
412,萧红故居,20230216,115,0,115,169.0,158.0,165.5
413,萧红故居,20230217,167,61,106,115.0,157.4,166.8
414,萧红故居,20230218,100,0,100,167.0,142.2,158.7
415,萧红故居,20230219,165,59,106,100.0,143.2,156.5
416,萧红故居,20230220,145,59,86,165.0,138.4,152.6
417,萧红故居,20230221,152,59,93,145.0,145.8,151.9
418,萧红故居,20230222,179,64,115,152.0,148.2,152.8
419,萧红故居,20230223,161,61,100,179.0,160.4,151.3
420,萧红故居,20230224,156,61,95,161.0,158.6,150.9
421,萧红故居,20230225,186,68,118,156.0,166.8,152.6
422,萧红故居,20230226,185,63,122,186.0,173.4,159.6
423,萧红故居,20230227,178,63,115,185.0,173.2,160.7
424,萧红故居,20230228,84,0,84,178.0,157.8,159.1
425,萧红故居,20230301,97,0,97,84.0,146.0,152.3
426,萧红故居,20230302,156,64,92,97.0,140.0,153.4
427,萧红故居,20230303,93,0,93,156.0,121.6,147.5
428,萧红故居,20230304,182,63,119,93.0,122.4,147.8
429,萧红故居,20230305,187,61,126,182.0,143.0,150.4
430,萧红故居,20230306,169,59,110,187.0,157.4,151.7
431,萧红故居,20230307,100,0,100,169.0,146.2,143.1
432,萧红故居,20230308,163,72,91,100.0,160.2,140.9
433,萧红故居,20230309,153,61,92,163.0,154.4,138.4
434,萧红故居,20230310,89,0,89,153.0,134.8,138.9
435,萧红故居,20230311,109,0,109,89.0,122.8,140.1
436,萧红故居,20230312,115,0,115,109.0,125.8,136.0
437,萧红故居,20230313,136,66,70,115.0,120.4,140.3
438,萧红故居,20230314,92,0,92,136.0,108.2,131.3
439,萧红故居,20230315,157,64,93,92.0,121.8,128.3
440,萧红故居,20230316,82,0,82,157.0,116.4,119.6
441,萧红故居,20230317,102,0,102,82.0,113.8,119.8
442,萧红故居,20230318,108,0,108,102.0,108.2,114.3
443,萧红故居,20230319,169,64,105,108.0,123.6,115.9
444,萧红故居,20230320,83,0,83,169.0,108.8,115.3
445,萧红故居,20230321,139,59,80,83.0,120.2,118.3
446,萧红故居,20230322,151,59,92,139.0,130.0,121.9
447,萧红故居,20230323,138,59,79,151.0,136.0,122.1
448,萧红故居,20230324,152,68,84,138.0,132.6,128.1
449,萧红故居,20230325,102,0,102,152.0,136.4,122.6
450,萧红故居,20230326,102,0,102,102.0,129.0,124.6
451,萧红故居,20230327,150,61,89,102.0,128.8,129.4
452,萧红故居,20230328,161,59,102,150.0,133.4,134.7
453,萧红故居,20230329,167,61,106,161.0,136.4,134.5
454,萧红故居,20230330,173,61,112,167.0,150.6,143.5
455,萧红故居,20230331,160,68,92,173.0,162.2,145.6
456,萧红故居,20230401,135,0,135,160.0,159.2,144.0
457,萧红故居,20230402,191,63,128,135.0,165.2,149.3
458,萧红故居,20230403,161,59,102,191.0,164.0,150.2
459,萧红故居,20230404,188,63,125,161.0,167.0,158.8
460,萧红故居,20230405,147,0,147,188.0,164.4,163.3
461,萧红故居,20230406,150,59,91,147.0,167.4,163.3
462,萧红故居,20230407,155,59,96,150.0,160.2,162.7
463,萧红故居,20230408,102,0,102,155.0,148.4,156.2
464,萧红故居,20230409,112,0,112,102.0,133.2,150.1
465,萧红故居,20230410,155,63,92,112.0,134.8,149.6
466,萧红故居,20230411,137,63,74,155.0,132.2,149.8
467,萧红故居,20230412,89,0,89,137.0,119.0,139.6
468,萧红故居,20230413,96,0,96,89.0,117.8,133.1
469,萧红故居,20230414,176,61,115,96.0,130.6,131.9
470,萧红故居,20230415,172,59,113,176.0,134.0,134.4
471,萧红故居,20230416,180,59,121,172.0,142.6,137.4
472,萧红故居,20230417,146,59,87,180.0,154.0,136.5
473,萧红故居,20230418,157,64,93,146.0,166.2,142.0
474,萧红故居,20230419,174,59,115,157.0,165.8,148.2
475,萧红故居,20230420,158,61,97,174.0,163.0,148.5
476,萧红故居,20230421,170,66,104,158.0,161.0,151.8
477,萧红故居,20230422,115,0,115,170.0,154.8,154.4
478,萧红故居,20230423,193,70,123,115.0,162.0,164.1
479,萧红故居,20230424,188,63,125,193.0,164.8,165.3
480,萧红故居,20230425,187,70,117,188.0,170.6,166.8
481,萧红故居,20230426,184,61,123,187.0,173.4,167.2
482,萧红故居,20230427,171,66,105,184.0,184.6,169.7
483,萧红故居,20230428,99,0,99,171.0,165.8,163.9
484,萧红故居,20230429,155,0,155,99.0,159.2,162.0
485,萧红故居,20230430,229,59,170,155.0,167.6,169.1
486,萧红故居,20230501,199,0,199,229.0,170.6,172.0
487,萧红故居,20230502,182,0,182,199.0,172.8,178.7
488,萧红故居,20230503,141,0,141,182.0,181.2,173.5
489,萧红故居,20230504,152,61,91,141.0,180.6,169.9
490,萧红故居,20230505,163,59,104,152.0,167.4,167.5
491,萧红故居,20230506,86,0,86,163.0,144.8,157.7
492,萧红故居,20230507,86,0,86,86.0,125.6,149.2
493,萧红故居,20230508,158,63,95,86.0,129.0,155.1
494,萧红故居,20230509,161,61,100,158.0,130.8,155.7
495,萧红故居,20230510,174,61,113,161.0,133.0,150.2
496,萧红故居,20230511,148,74,74,174.0,145.4,145.1
497,萧红故居,20230512,157,66,91,148.0,159.6,142.6
498,萧红故居,20230513,87,0,87,157.0,145.4,137.2
499,萧红故居,20230514,99,0,99,87.0,133.0,131.9
500,萧红故居,20230515,152,66,86,99.0,128.6,130.8
501,萧红故居,20230516,150,59,91,152.0,129.0,137.2
502,萧红故居,20230517,156,61,95,150.0,128.8,144.2
503,萧红故居,20230518,156,61,95,156.0,142.6,144.0
504,萧红故居,20230519,158,59,99,156.0,154.4,143.7
505,萧红故居,20230520,154,59,95,158.0,154.8,141.7
506,萧红故居,20230521,84,0,84,154.0,141.6,135.3
507,萧红故居,20230522,152,59,93,84.0,140.8,134.8
508,萧红故居,20230523,93,0,93,152.0,128.2,135.4
509,萧红故居,20230524,148,59,89,93.0,126.2,140.3
510,萧红故居,20230525,170,61,109,148.0,129.4,142.1
511,萧红故居,20230526,153,66,87,170.0,143.2,142.4
512,萧红故居,20230527,154,61,93,153.0,143.6,142.2
513,萧红故居,20230528,174,61,113,154.0,159.8,144.0
514,萧红故居,20230529,155,66,89,174.0,161.2,143.7
515,萧红故居,20230530,144,61,83,155.0,156.0,142.7
516,萧红故居,20230531,84,0,84,144.0,142.2,142.7
517,萧红故居,20230601,102,0,102,84.0,131.8,137.7
518,萧红故居,20230602,89,0,89,102.0,114.8,137.3
519,萧红故居,20230603,169,61,108,89.0,117.6,139.4
520,萧红故居,20230604,164,68,96,169.0,121.6,138.8
521,萧红故居,20230605,93,0,93,164.0,123.4,132.8
522,萧红故居,20230606,93,0,93,93.0,121.6,126.7
523,萧红故居,20230607,150,59,91,93.0,133.8,124.3
524,萧红故居,20230608,73,0,73,150.0,114.6,116.1
525,萧红故居,20230609,148,61,87,73.0,111.4,116.5
526,萧红故居,20230610,95,0,95,148.0,111.8,117.6
527,萧红故居,20230611,78,0,78,95.0,108.8,115.2
528,萧红故居,20230612,87,0,87,78.0,96.2,115.0
529,萧红故居,20230613,97,0,97,87.0,101.0,107.8
530,萧红故居,20230614,140,61,79,97.0,99.4,105.4
531,萧红故居,20230615,87,0,87,140.0,97.8,104.8
532,萧红故居,20230616,146,66,80,87.0,111.4,110.1
533,萧红故居,20230617,145,59,86,146.0,123.0,109.6
534,萧红故居,20230618,110,0,110,145.0,125.6,113.3
535,萧红故居,20230619,142,63,79,110.0,126.0,112.7
536,萧红故居,20230620,152,61,91,142.0,139.0,118.4
537,萧红故居,20230621,112,0,112,152.0,132.2,121.8
538,萧红故居,20230622,141,0,141,112.0,131.4,127.2
539,萧红故居,20230623,130,0,130,141.0,135.4,130.5
540,萧红故居,20230624,216,61,155,130.0,150.2,138.1
541,萧红故居,20230625,173,63,110,216.0,154.4,146.7
542,萧红故居,20230626,192,64,128,173.0,170.4,151.3
543,萧红故居,20230627,221,70,151,192.0,186.4,158.9
544,萧红故居,20230628,180,63,117,221.0,196.4,165.9
545,萧红故居,20230629,157,64,93,180.0,184.6,167.4
546,萧红故居,20230630,106,0,106,157.0,171.2,162.8
547,萧红故居,20230701,172,59,113,106.0,167.2,168.8
548,萧红故居,20230702,153,61,92,172.0,153.6,170.0
549,萧红故居,20230703,152,59,93,153.0,148.0,172.2
550,萧红故居,20230704,104,0,104,152.0,137.4,161.0
551,萧红故居,20230705,89,0,89,104.0,134.0,152.6
552,萧红故居,20230706,157,61,96,89.0,131.0,149.1
553,萧红故居,20230707,168,64,104,157.0,134.0,143.8
554,萧红故居,20230708,121,0,121,168.0,127.8,137.9
555,萧红故居,20230709,105,0,105,121.0,128.0,132.7
556,萧红故居,20230710,161,61,100,105.0,142.4,138.2
557,萧红故居,20230711,184,63,121,161.0,147.8,139.4
558,萧红故居,20230712,160,61,99,184.0,146.2,140.1
559,萧红故居,20230713,197,61,136,160.0,161.4,144.6
560,萧红故居,20230714,173,64,109,197.0,175.0,151.5
561,萧红故居,20230715,169,61,108,173.0,176.6,159.5
562,萧红故居,20230716,173,63,110,169.0,174.4,161.1
563,萧红故居,20230717,91,0,91,173.0,160.6,153.4
564,萧红故居,20230718,119,0,119,91.0,145.0,153.2
565,萧红故居,20230719,176,59,117,119.0,145.6,160.3
566,萧红故居,20230720,163,59,104,176.0,144.4,160.5
567,萧红故居,20230721,200,70,130,163.0,149.8,162.1
568,萧红故居,20230722,200,61,139,200.0,171.6,166.1
569,萧红故居,20230723,191,61,130,200.0,186.0,165.5
570,萧红故居,20230724,157,64,93,191.0,182.2,163.9
571,萧红故居,20230725,189,59,130,157.0,187.4,165.9
572,萧红故居,20230726,188,63,125,189.0,185.0,167.4
573,萧红故居,20230727,175,63,112,188.0,180.0,175.8
574,萧红故居,20230728,176,61,115,175.0,177.0,181.5
575,萧红故居,20230729,134,0,134,176.0,172.4,177.3
576,萧红故居,20230730,132,0,132,134.0,161.0,174.2
577,萧红故居,20230731,163,59,104,132.0,156.0,170.5
578,萧红故居,20230801,202,59,143,163.0,161.4,170.7
579,萧红故居,20230802,95,0,95,202.0,145.2,161.1
580,萧红故居,20230803,106,0,106,95.0,139.6,156.0
581,萧红故居,20230804,173,63,110,106.0,147.8,154.4
582,萧红故居,20230805,198,59,139,173.0,154.8,155.4
583,萧红故居,20230806,212,63,149,198.0,156.8,159.1
584,萧红故居,20230807,174,66,108,212.0,172.6,158.9
585,萧红故居,20230808,115,0,115,174.0,174.4,157.0
586,萧红故居,20230809,197,66,131,115.0,179.2,163.5
587,萧红故居,20230810,118,0,118,197.0,163.2,159.0
588,萧红故居,20230811,108,0,108,118.0,142.4,149.6
589,萧红故居,20230812,100,0,100,108.0,127.6,150.1
590,萧红故居,20230813,167,59,108,100.0,138.0,156.2
591,萧红故居,20230814,128,0,128,167.0,124.2,151.7
592,萧红故居,20230815,176,63,113,128.0,135.8,149.5
593,萧红故居,20230816,173,63,110,176.0,148.8,145.6
594,萧红故居,20230817,187,61,126,173.0,166.2,146.9
595,萧红故居,20230818,167,59,108,187.0,166.2,152.1
596,萧红故居,20230819,144,0,144,167.0,169.4,146.8
597,萧红故居,20230820,108,0,108,144.0,155.8,145.8
598,萧红故居,20230821,159,63,96,108.0,153.0,150.9
599,萧红故居,20230822,152,59,93,159.0,146.0,156.1
600,萧红故居,20230823,153,61,92,152.0,143.2,154.7
601,萧红故居,20230824,156,64,92,153.0,145.6,157.5
602,萧红故居,20230825,97,0,97,156.0,143.4,149.6
603,萧红故居,20230826,104,0,104,97.0,132.4,142.7
604,萧红故居,20230827,109,0,109,104.0,123.8,134.9
605,萧红故居,20230828,163,59,104,109.0,125.8,134.5
606,萧红故居,20230829,95,0,95,163.0,113.6,129.6
607,萧红故居,20230830,179,74,105,95.0,130.0,136.7
608,萧红故居,20230831,161,66,95,179.0,141.4,136.9
609,萧红故居,20230901,142,63,79,161.0,148.0,135.9
610,萧红故居,20230902,158,61,97,142.0,147.0,136.4
611,萧红故居,20230903,141,61,80,158.0,156.2,134.9
612,萧红故居,20230904,155,59,96,141.0,151.4,140.7
613,萧红故居,20230905,71,0,71,155.0,133.4,137.4
614,萧红故居,20230906,78,0,78,71.0,120.6,134.3
615,萧红故居,20230907,93,0,93,78.0,107.6,127.3
616,萧红故居,20230908,76,0,76,93.0,94.6,125.4
617,萧红故居,20230909,96,0,96,76.0,82.8,117.1
618,萧红故居,20230910,92,0,92,96.0,87.0,110.2
619,萧红故居,20230911,84,0,84,92.0,88.2,104.4
620,萧红故居,20230912,138,59,79,84.0,97.2,102.4
621,萧红故居,20230913,150,63,87,138.0,112.0,103.3
622,萧红故居,20230914,80,0,80,150.0,108.8,95.8
623,萧红故居,20230915,82,0,82,80.0,106.8,96.9
624,萧红故居,20230916,95,0,95,82.0,109.0,98.6
625,萧红故居,20230917,87,0,87,95.0,98.8,98.0
626,萧红故居,20230918,145,63,82,87.0,97.8,104.9
627,萧红故居,20230919,78,0,78,145.0,97.4,103.1
628,萧红故居,20230920,83,0,83,78.0,97.6,102.2
629,萧红故居,20230921,140,61,79,83.0,106.6,107.8
630,萧红故居,20230922,141,59,82,140.0,117.4,108.1
631,萧红故居,20230923,106,0,106,141.0,109.6,103.7
632,萧红故居,20230924,143,61,82,106.0,122.6,110.0
633,萧红故居,20230925,156,63,93,143.0,137.2,117.4
634,萧红故居,20230926,83,0,83,156.0,125.8,116.2
635,萧红故居,20230927,104,0,104,83.0,118.4,117.9
636,萧红故居,20230928,172,63,109,104.0,131.6,120.6
637,萧红故居,20230929,105,0,105,172.0,124.0,123.3
638,萧红故居,20230930,102,0,102,105.0,113.2,125.2
639,萧红故居,20231001,185,59,126,102.0,133.6,129.7
640,萧红故居,20231002,163,0,163,185.0,145.4,131.9
641,萧红故居,20231003,210,66,144,163.0,153.0,142.3
642,萧红故居,20231004,112,0,112,210.0,154.4,139.2
643,萧红故居,20231005,113,0,113,112.0,156.6,134.9
644,萧红故居,20231006,168,59,109,113.0,153.2,143.4
645,萧红故居,20231007,154,61,93,168.0,151.4,148.4
646,萧红故居,20231008,151,59,92,154.0,139.6,146.3
647,萧红故居,20231009,152,70,82,151.0,147.6,151.0
648,萧红故居,20231010,139,63,76,152.0,152.8,154.7
649,萧红故居,20231011,93,0,93,139.0,137.8,145.5
650,萧红故居,20231012,139,59,80,93.0,134.8,143.1
651,萧红故居,20231013,87,0,87,139.0,122.0,130.8
652,萧红故居,20231014,96,0,96,87.0,110.8,129.2
653,萧红故居,20231015,71,0,71,96.0,97.2,125.0
654,萧红故居,20231016,74,0,74,71.0,93.4,115.6
655,萧红故居,20231017,139,63,76,74.0,93.4,114.1
656,萧红故居,20231018,150,68,82,139.0,106.0,114.0
657,萧红故居,20231019,141,59,82,150.0,115.0,112.9
658,萧红故居,20231020,65,0,65,141.0,113.8,105.5
659,萧红故居,20231021,78,0,78,65.0,114.6,104.0
660,萧红故居,20231022,135,59,76,78.0,113.8,103.6
661,萧红故居,20231023,130,59,71,135.0,109.8,107.9
662,萧红故居,20231024,76,0,76,130.0,96.8,105.9
663,萧红故居,20231025,0,0,0,76.0,83.8,98.8
664,萧红故居,20231026,87,0,87,0.0,85.6,100.1
665,萧红故居,20231027,71,0,71,87.0,72.8,93.3
666,萧红故居,20231028,84,0,84,71.0,63.6,86.7
667,萧红故居,20231029,70,0,70,84.0,62.4,79.6
668,萧红故居,20231030,133,63,70,70.0,89.0,86.4
669,萧红故居,20231031,129,59,70,133.0,97.4,91.5
670,萧红故居,20231101,70,0,70,129.0,97.2,85.0
671,萧红故居,20231102,125,59,66,70.0,105.4,84.5
672,萧红故居,20231103,82,0,82,125.0,107.8,85.1
673,萧红故居,20231104,73,0,73,82.0,95.8,92.4
674,萧红故居,20231105,82,0,82,73.0,86.4,91.9
675,萧红故居,20231106,122,59,63,82.0,96.8,97.0
676,萧红故居,20231107,132,66,66,122.0,98.2,101.8
677,萧红故居,20231108,129,66,63,132.0,107.6,107.7
678,萧红故居,20231109,69,0,69,129.0,106.8,101.3
679,萧红故居,20231110,71,0,71,69.0,104.6,95.5
680,萧红故居,20231111,83,0,83,71.0,96.8,96.8
681,萧红故居,20231112,69,0,69,83.0,84.2,91.2
682,萧红故居,20231113,131,61,70,69.0,84.6,96.1
683,萧红故居,20231114,150,61,89,131.0,100.8,103.8
684,萧红故居,20231115,130,61,69,150.0,112.6,108.6
685,萧红故居,20231116,66,0,66,130.0,109.2,103.0
686,萧红故居,20231117,133,59,74,66.0,122.0,103.1
687,萧红故居,20231118,73,0,73,133.0,110.4,97.5
688,萧红故居,20231119,139,59,80,73.0,108.2,104.5
689,萧红故居,20231120,146,59,87,139.0,111.4,112.0
690,萧红故居,20231121,150,59,91,146.0,128.2,118.7
691,萧红故居,20231122,76,0,76,150.0,116.8,119.4
692,萧红故居,20231123,76,0,76,76.0,117.4,113.9
693,萧红故居,20231124,76,0,76,76.0,104.8,106.5
694,萧红故居,20231125,74,0,74,76.0,90.4,100.9
695,萧红故居,20231126,128,59,69,74.0,86.0,107.1
696,萧红故居,20231127,128,61,67,128.0,96.4,106.6
697,萧红故居,20231128,126,61,65,128.0,106.4,111.9
698,萧红故居,20231129,128,61,67,126.0,116.8,110.8
699,萧红故居,20231130,70,0,70,128.0,116.0,103.2
700,萧红故居,20231201,132,63,69,70.0,116.8,101.4
701,萧红故居,20231202,73,0,73,132.0,105.8,101.1
702,萧红故居,20231203,86,0,86,73.0,97.8,102.1
703,萧红故居,20231204,135,61,74,86.0,99.2,108.0
704,萧红故居,20231205,78,0,78,135.0,100.8,108.4
705,萧红故居,20231206,74,0,74,78.0,89.2,103.0
706,萧红故居,20231207,69,0,69,74.0,88.4,97.1
707,萧红故居,20231208,137,59,78,69.0,98.6,98.2
708,萧红故居,20231209,66,0,66,137.0,84.8,92.0
709,萧红故居,20231210,80,0,80,66.0,85.2,93.0
710,萧红故居,20231211,61,0,61,80.0,82.6,85.9
711,萧红故居,20231212,138,59,79,61.0,96.4,92.4
712,萧红故居,20231213,73,0,73,138.0,83.6,91.1
713,萧红故居,20231214,132,61,71,73.0,96.8,90.8
714,萧红故居,20231215,70,0,70,132.0,94.8,90.0
715,萧红故居,20231216,79,0,79,70.0,98.4,90.5
716,萧红故居,20231217,138,64,74,79.0,98.4,97.4
717,萧红故居,20231218,149,63,86,138.0,113.6,98.6
718,萧红故居,20231219,122,59,63,149.0,111.6,104.2
719,萧红故居,20231220,76,0,76,122.0,112.8,103.8
720,萧红故居,20231221,128,59,69,76.0,122.6,110.5
721,萧红故居,20231222,73,0,73,128.0,109.6,104.0
722,萧红故居,20231223,78,0,78,73.0,95.4,104.5
723,萧红故居,20231224,134,63,71,78.0,97.8,104.7
724,萧红故居,20231225,65,0,65,134.0,95.6,104.2
725,萧红故居,20231226,67,0,67,65.0,83.4,103.0
726,萧红故居,20231227,145,59,86,67.0,97.8,103.7
727,萧红故居,20231228,84,0,84,145.0,99.0,97.2
728,萧红故居,20231229,80,0,80,84.0,88.2,93.0
729,萧红故居,20231230,100,0,100,80.0,95.2,95.4
730,萧红故居,20231231,78,0,78,100.0,97.4,90.4
731,萧红故居,20240101,74,0,74,78.0,83.2,90.5
732,萧红故居,20240102,69,0,69,74.0,80.2,89.6
733,萧红故居,20240103,70,0,70,69.0,78.2,83.2
734,萧红故居,20240104,148,61,87,70.0,87.8,91.5
735,萧红故居,20240105,150,64,86,148.0,102.2,99.8
736,萧红故居,20240106,146,59,87,150.0,116.6,99.9
737,萧红故居,20240107,80,0,80,146.0,118.8,99.5
738,萧红故居,20240108,153,61,92,80.0,135.4,106.8
739,萧红故居,20240109,86,0,86,153.0,123.0,105.4
740,萧红故居,20240110,143,61,82,86.0,121.6,111.9
741,萧红故居,20240111,80,0,80,143.0,108.4,112.5
742,萧红故居,20240112,143,61,82,80.0,121.0,119.9
743,萧红故居,20240113,73,0,73,143.0,105.0,120.2
744,萧红故居,20240114,91,0,91,73.0,106.0,114.5
745,萧红故居,20240115,91,0,91,91.0,95.6,108.6
746,萧红故居,20240116,89,0,89,91.0,97.4,102.9
747,萧红故居,20240117,150,63,87,89.0,98.8,109.9
748,萧红故居,20240118,144,61,83,150.0,113.0,109.0
749,萧红故居,20240119,74,0,74,144.0,109.6,107.8
750,萧红故居,20240120,143,59,84,74.0,120.0,107.8
751,萧红故居,20240121,104,0,104,143.0,123.0,110.2
752,萧红故居,20240122,160,64,96,104.0,125.0,111.9
753,萧红故居,20240123,153,66,87,160.0,126.8,119.9
754,萧红故居,20240124,141,59,82,153.0,140.2,124.9
755,萧红故居,20240125,145,59,86,141.0,140.6,130.3
756,萧红故居,20240126,95,0,95,145.0,138.8,130.9
757,萧红故居,20240127,105,0,105,95.0,127.8,126.4
758,萧红故居,20240128,92,0,92,105.0,115.6,121.2
759,萧红故居,20240129,141,63,78,92.0,115.6,127.9
760,萧红故居,20240130,92,0,92,141.0,105.0,122.8
761,萧红故居,20240131,92,0,92,92.0,104.4,121.6
762,萧红故居,20240201,138,59,79,92.0,111.0,119.4
763,萧红故居,20240202,80,0,80,138.0,108.6,112.1
764,萧红故居,20240203,130,61,69,80.0,106.4,111.0
765,萧红故居,20240204,142,59,83,130.0,116.4,110.7
766,萧红故居,20240205,78,0,78,142.0,113.6,109.0
767,萧红故居,20240206,141,59,82,78.0,114.2,112.6
768,萧红故居,20240207,141,59,82,141.0,126.4,117.5
769,萧红故居,20240208,130,59,71,141.0,126.4,116.4
770,萧红故居,20240209,78,0,78,130.0,113.6,115.0
771,萧红故居,20240210,66,0,66,78.0,111.2,112.4
772,萧红故居,20240211,89,0,89,66.0,100.8,107.5
773,萧红故居,20240212,93,0,93,89.0,91.2,108.8
774,萧红故居,20240213,104,0,104,93.0,86.0,106.2
775,萧红故居,20240214,112,0,112,104.0,92.8,103.2
776,萧红故居,20240215,168,59,109,112.0,113.2,112.2
777,萧红故居,20240216,93,0,93,168.0,114.0,107.4
778,萧红故居,20240217,91,0,91,93.0,113.6,102.4
779,萧红故居,20240218,87,0,87,91.0,110.2,98.1
780,萧红故居,20240219,78,0,78,87.0,103.4,98.1
781,萧红故居,20240220,83,0,83,78.0,86.4,99.8
782,萧红故居,20240221,169,63,106,83.0,101.6,107.8
783,萧红故居,20240222,167,61,106,169.0,116.8,115.2
784,萧红故居,20240223,157,66,91,167.0,130.8,120.5
785,萧红故居,20240224,145,59,86,157.0,144.2,123.8
786,萧红故居,20240225,161,61,100,145.0,159.8,123.1
787,萧红故居,20240226,172,59,113,161.0,160.4,131.0
788,萧红故居,20240227,196,68,128,172.0,166.2,141.5
789,萧红故居,20240228,246,72,174,196.0,184.0,157.4
790,萧红故居,20240229,257,70,187,246.0,206.4,175.3
791,萧红故居,20240301,183,64,119,257.0,210.8,185.3
792,萧红故居,20240302,108,0,108,183.0,198.0,179.2
793,萧红故居,20240303,170,61,109,108.0,192.8,179.5
794,萧红故居,20240304,164,68,96,170.0,176.4,180.2
795,萧红故居,20240305,93,0,93,164.0,143.6,175.0
796,萧红故居,20240306,160,68,92,93.0,139.0,174.9
797,萧红故居,20240307,137,61,76,160.0,144.8,171.4
798,萧红故居,20240308,83,0,83,137.0,127.4,160.1
799,萧红故居,20240309,96,0,96,83.0,113.8,145.1
800,萧红故居,20240310,163,59,104,96.0,127.8,135.7
801,萧红故居,20240311,141,59,82,163.0,124.0,131.5
802,萧红故居,20240312,86,0,86,141.0,113.8,129.3
803,萧红故居,20240313,133,59,74,86.0,123.8,125.6
804,萧红故居,20240314,151,59,92,133.0,134.8,124.3
805,萧红故居,20240315,73,0,73,151.0,116.8,122.3
806,萧红故居,20240316,82,0,82,73.0,105.0,114.5
807,萧红故居,20240317,110,0,110,82.0,109.8,111.8
808,萧红故居,20240318,89,0,89,110.0,101.0,112.4
809,萧红故居,20240319,87,0,87,89.0,88.2,111.5
810,萧红故居,20240320,139,61,78,87.0,101.4,109.1
811,萧红故居,20240321,132,59,73,139.0,111.4,108.2
812,萧红故居,20240322,141,61,80,132.0,117.6,113.7
813,萧红故居,20240323,78,0,78,141.0,115.4,108.2
814,萧红故居,20240324,162,63,99,78.0,130.4,109.3
815,萧红故居,20240325,142,59,83,162.0,131.0,116.2
816,萧红故居,20240326,80,0,80,142.0,120.6,116.0
817,萧红故居,20240327,152,59,93,80.0,122.8,120.2
818,萧红故居,20240328,133,63,70,152.0,133.8,124.6
819,萧红故居,20240329,141,63,78,133.0,129.6,130.0
820,萧红故居,20240330,83,0,83,141.0,117.8,124.4
821,萧红故居,20240331,99,0,99,83.0,121.6,121.1
822,萧红故居,20240401,138,64,74,99.0,118.8,120.8
823,萧红故居,20240402,153,64,89,138.0,122.8,128.3
824,萧红故居,20240403,110,0,110,153.0,116.6,123.1
825,萧红故居,20240404,220,63,157,110.0,144.0,130.9
826,萧红故居,20240405,151,0,151,220.0,154.4,138.0
827,萧红故居,20240406,152,59,93,151.0,157.2,138.0
828,萧红故居,20240407,78,0,78,152.0,142.2,132.5
829,萧红故居,20240408,150,61,89,78.0,150.2,133.4
830,萧红故居,20240409,129,59,70,150.0,132.0,138.0
831,萧红故居,20240410,83,0,83,129.0,118.4,136.4
832,萧红故居,20240411,132,61,71,83.0,114.4,135.8
833,萧红故居,20240412,151,59,92,132.0,129.0,135.6
834,萧红故居,20240413,167,59,108,151.0,132.4,141.3
835,萧红故居,20240414,143,61,82,167.0,135.2,133.6
836,萧红故居,20240415,146,63,83,143.0,147.8,133.1
837,萧红故居,20240416,144,61,83,146.0,150.2,132.3
838,萧红故居,20240417,145,61,84,144.0,149.0,139.0
839,萧红故居,20240418,152,61,91,145.0,146.0,139.2
840,萧红故居,20240419,156,57,99,152.0,148.6,141.9
841,萧红故居,20240420,156,61,95,156.0,150.6,149.2
842,萧红故居,20240421,162,63,99,156.0,154.2,152.2
843,萧红故居,20240422,136,63,73,162.0,152.4,150.7
844,萧红故居,20240423,86,0,86,136.0,139.2,142.6
845,萧红故居,20240424,150,57,93,86.0,138.0,143.3
846,萧红故居,20240425,152,61,91,150.0,137.2,143.9
847,萧红故居,20240426,154,59,95,152.0,135.6,144.9
848,萧红故居,20240427,154,57,97,154.0,139.2,145.8
849,萧红故居,20240428,159,66,93,154.0,153.8,146.5
850,萧红故居,20240429,155,64,91,159.0,154.8,146.4
851,萧红故居,20240430,161,66,95,155.0,156.6,146.9
1,沙糖桔,20220101,0,0,0,161.0,125.8,130.7
2,沙糖桔,20220102,0,0,0,0.0,95.0,117.1
3,沙糖桔,20220103,0,0,0,0.0,63.2,108.5
4,沙糖桔,20220104,0,0,0,0.0,32.2,93.5
5,沙糖桔,20220105,0,0,0,0.0,0.0,78.3
6,沙糖桔,20220106,0,0,0,0.0,0.0,62.9
7,沙糖桔,20220107,0,0,0,0.0,0.0,47.5
8,沙糖桔,20220108,0,0,0,0.0,0.0,31.6
9,沙糖桔,20220109,0,0,0,0.0,0.0,16.1
10,沙糖桔,20220110,0,0,0,0.0,0.0,0.0
11,沙糖桔,20220111,0,0,0,0.0,0.0,0.0
12,沙糖桔,20220112,0,0,0,0.0,0.0,0.0
13,沙糖桔,20220113,0,0,0,0.0,0.0,0.0
14,沙糖桔,20220114,0,0,0,0.0,0.0,0.0
15,沙糖桔,20220115,0,0,0,0.0,0.0,0.0
16,沙糖桔,20220116,0,0,0,0.0,0.0,0.0
17,沙糖桔,20220117,0,0,0,0.0,0.0,0.0
18,沙糖桔,20220118,0,0,0,0.0,0.0,0.0
19,沙糖桔,20220119,0,0,0,0.0,0.0,0.0
20,沙糖桔,20220120,0,0,0,0.0,0.0,0.0
21,沙糖桔,20220121,0,0,0,0.0,0.0,0.0
22,沙糖桔,20220122,0,0,0,0.0,0.0,0.0
23,沙糖桔,20220123,0,0,0,0.0,0.0,0.0
24,沙糖桔,20220124,0,0,0,0.0,0.0,0.0
25,沙糖桔,20220125,0,0,0,0.0,0.0,0.0
26,沙糖桔,20220126,0,0,0,0.0,0.0,0.0
27,沙糖桔,20220127,0,0,0,0.0,0.0,0.0
28,沙糖桔,20220128,0,0,0,0.0,0.0,0.0
29,沙糖桔,20220129,0,0,0,0.0,0.0,0.0
30,沙糖桔,20220130,0,0,0,0.0,0.0,0.0
31,沙糖桔,20220131,0,0,0,0.0,0.0,0.0
32,沙糖桔,20220201,0,0,0,0.0,0.0,0.0
33,沙糖桔,20220202,0,0,0,0.0,0.0,0.0
34,沙糖桔,20220203,0,0,0,0.0,0.0,0.0
35,沙糖桔,20220204,0,0,0,0.0,0.0,0.0
36,沙糖桔,20220205,0,0,0,0.0,0.0,0.0
37,沙糖桔,20220206,0,0,0,0.0,0.0,0.0
38,沙糖桔,20220207,0,0,0,0.0,0.0,0.0
39,沙糖桔,20220208,0,0,0,0.0,0.0,0.0
40,沙糖桔,20220209,0,0,0,0.0,0.0,0.0
41,沙糖桔,20220210,0,0,0,0.0,0.0,0.0
42,沙糖桔,20220211,0,0,0,0.0,0.0,0.0
43,沙糖桔,20220212,0,0,0,0.0,0.0,0.0
44,沙糖桔,20220213,0,0,0,0.0,0.0,0.0
45,沙糖桔,20220214,0,0,0,0.0,0.0,0.0
46,沙糖桔,20220215,0,0,0,0.0,0.0,0.0
47,沙糖桔,20220216,0,0,0,0.0,0.0,0.0
48,沙糖桔,20220217,0,0,0,0.0,0.0,0.0
49,沙糖桔,20220218,0,0,0,0.0,0.0,0.0
50,沙糖桔,20220219,0,0,0,0.0,0.0,0.0
51,沙糖桔,20220220,0,0,0,0.0,0.0,0.0
52,沙糖桔,20220221,0,0,0,0.0,0.0,0.0
53,沙糖桔,20220222,0,0,0,0.0,0.0,0.0
54,沙糖桔,20220223,0,0,0,0.0,0.0,0.0
55,沙糖桔,20220224,0,0,0,0.0,0.0,0.0
56,沙糖桔,20220225,0,0,0,0.0,0.0,0.0
57,沙糖桔,20220226,0,0,0,0.0,0.0,0.0
58,沙糖桔,20220227,0,0,0,0.0,0.0,0.0
59,沙糖桔,20220228,0,0,0,0.0,0.0,0.0
60,沙糖桔,20220301,0,0,0,0.0,0.0,0.0
61,沙糖桔,20220302,0,0,0,0.0,0.0,0.0
62,沙糖桔,20220303,0,0,0,0.0,0.0,0.0
63,沙糖桔,20220304,0,0,0,0.0,0.0,0.0
64,沙糖桔,20220305,0,0,0,0.0,0.0,0.0
65,沙糖桔,20220306,0,0,0,0.0,0.0,0.0
66,沙糖桔,20220307,0,0,0,0.0,0.0,0.0
67,沙糖桔,20220308,0,0,0,0.0,0.0,0.0
68,沙糖桔,20220309,0,0,0,0.0,0.0,0.0
69,沙糖桔,20220310,0,0,0,0.0,0.0,0.0
70,沙糖桔,20220311,0,0,0,0.0,0.0,0.0
71,沙糖桔,20220312,0,0,0,0.0,0.0,0.0
72,沙糖桔,20220313,0,0,0,0.0,0.0,0.0
73,沙糖桔,20220314,0,0,0,0.0,0.0,0.0
74,沙糖桔,20220315,0,0,0,0.0,0.0,0.0
75,沙糖桔,20220316,0,0,0,0.0,0.0,0.0
76,沙糖桔,20220317,0,0,0,0.0,0.0,0.0
77,沙糖桔,20220318,0,0,0,0.0,0.0,0.0
78,沙糖桔,20220319,0,0,0,0.0,0.0,0.0
79,沙糖桔,20220320,0,0,0,0.0,0.0,0.0
80,沙糖桔,20220321,0,0,0,0.0,0.0,0.0
81,沙糖桔,20220322,0,0,0,0.0,0.0,0.0
82,沙糖桔,20220323,0,0,0,0.0,0.0,0.0
83,沙糖桔,20220324,0,0,0,0.0,0.0,0.0
84,沙糖桔,20220325,0,0,0,0.0,0.0,0.0
85,沙糖桔,20220326,0,0,0,0.0,0.0,0.0
86,沙糖桔,20220327,0,0,0,0.0,0.0,0.0
87,沙糖桔,20220328,0,0,0,0.0,0.0,0.0
88,沙糖桔,20220329,0,0,0,0.0,0.0,0.0
89,沙糖桔,20220330,0,0,0,0.0,0.0,0.0
90,沙糖桔,20220331,0,0,0,0.0,0.0,0.0
91,沙糖桔,20220401,0,0,0,0.0,0.0,0.0
92,沙糖桔,20220402,0,0,0,0.0,0.0,0.0
93,沙糖桔,20220403,0,0,0,0.0,0.0,0.0
94,沙糖桔,20220404,0,0,0,0.0,0.0,0.0
95,沙糖桔,20220405,0,0,0,0.0,0.0,0.0
96,沙糖桔,20220406,0,0,0,0.0,0.0,0.0
97,沙糖桔,20220407,0,0,0,0.0,0.0,0.0
98,沙糖桔,20220408,0,0,0,0.0,0.0,0.0
99,沙糖桔,20220409,0,0,0,0.0,0.0,0.0
100,沙糖桔,20220410,0,0,0,0.0,0.0,0.0
101,沙糖桔,20220411,0,0,0,0.0,0.0,0.0
102,沙糖桔,20220412,0,0,0,0.0,0.0,0.0
103,沙糖桔,20220413,0,0,0,0.0,0.0,0.0
104,沙糖桔,20220414,0,0,0,0.0,0.0,0.0
105,沙糖桔,20220415,0,0,0,0.0,0.0,0.0
106,沙糖桔,20220416,0,0,0,0.0,0.0,0.0
107,沙糖桔,20220417,0,0,0,0.0,0.0,0.0
108,沙糖桔,20220418,0,0,0,0.0,0.0,0.0
109,沙糖桔,20220419,0,0,0,0.0,0.0,0.0
110,沙糖桔,20220420,0,0,0,0.0,0.0,0.0
111,沙糖桔,20220421,0,0,0,0.0,0.0,0.0
112,沙糖桔,20220422,0,0,0,0.0,0.0,0.0
113,沙糖桔,20220423,0,0,0,0.0,0.0,0.0
114,沙糖桔,20220424,0,0,0,0.0,0.0,0.0
115,沙糖桔,20220425,0,0,0,0.0,0.0,0.0
116,沙糖桔,20220426,0,0,0,0.0,0.0,0.0
117,沙糖桔,20220427,0,0,0,0.0,0.0,0.0
118,沙糖桔,20220428,0,0,0,0.0,0.0,0.0
119,沙糖桔,20220429,0,0,0,0.0,0.0,0.0
120,沙糖桔,20220430,0,0,0,0.0,0.0,0.0
121,沙糖桔,20220501,0,0,0,0.0,0.0,0.0
122,沙糖桔,20220502,0,0,0,0.0,0.0,0.0
123,沙糖桔,20220503,0,0,0,0.0,0.0,0.0
124,沙糖桔,20220504,0,0,0,0.0,0.0,0.0
125,沙糖桔,20220505,0,0,0,0.0,0.0,0.0
126,沙糖桔,20220506,0,0,0,0.0,0.0,0.0
127,沙糖桔,20220507,0,0,0,0.0,0.0,0.0
128,沙糖桔,20220508,0,0,0,0.0,0.0,0.0
129,沙糖桔,20220509,0,0,0,0.0,0.0,0.0
130,沙糖桔,20220510,0,0,0,0.0,0.0,0.0
131,沙糖桔,20220511,0,0,0,0.0,0.0,0.0
132,沙糖桔,20220512,0,0,0,0.0,0.0,0.0
133,沙糖桔,20220513,0,0,0,0.0,0.0,0.0
134,沙糖桔,20220514,0,0,0,0.0,0.0,0.0
135,沙糖桔,20220515,0,0,0,0.0,0.0,0.0
136,沙糖桔,20220516,0,0,0,0.0,0.0,0.0
137,沙糖桔,20220517,0,0,0,0.0,0.0,0.0
138,沙糖桔,20220518,0,0,0,0.0,0.0,0.0
139,沙糖桔,20220519,0,0,0,0.0,0.0,0.0
140,沙糖桔,20220520,0,0,0,0.0,0.0,0.0
141,沙糖桔,20220521,0,0,0,0.0,0.0,0.0
142,沙糖桔,20220522,0,0,0,0.0,0.0,0.0
143,沙糖桔,20220523,0,0,0,0.0,0.0,0.0
144,沙糖桔,20220524,0,0,0,0.0,0.0,0.0
145,沙糖桔,20220525,0,0,0,0.0,0.0,0.0
146,沙糖桔,20220526,0,0,0,0.0,0.0,0.0
147,沙糖桔,20220527,0,0,0,0.0,0.0,0.0
148,沙糖桔,20220528,0,0,0,0.0,0.0,0.0
149,沙糖桔,20220529,0,0,0,0.0,0.0,0.0
150,沙糖桔,20220530,0,0,0,0.0,0.0,0.0
151,沙糖桔,20220531,0,0,0,0.0,0.0,0.0
152,沙糖桔,20220601,0,0,0,0.0,0.0,0.0
153,沙糖桔,20220602,0,0,0,0.0,0.0,0.0
154,沙糖桔,20220603,0,0,0,0.0,0.0,0.0
155,沙糖桔,20220604,0,0,0,0.0,0.0,0.0
156,沙糖桔,20220605,0,0,0,0.0,0.0,0.0
157,沙糖桔,20220606,0,0,0,0.0,0.0,0.0
158,沙糖桔,20220607,0,0,0,0.0,0.0,0.0
159,沙糖桔,20220608,0,0,0,0.0,0.0,0.0
160,沙糖桔,20220609,0,0,0,0.0,0.0,0.0
161,沙糖桔,20220610,0,0,0,0.0,0.0,0.0
162,沙糖桔,20220611,0,0,0,0.0,0.0,0.0
163,沙糖桔,20220612,0,0,0,0.0,0.0,0.0
164,沙糖桔,20220613,0,0,0,0.0,0.0,0.0
165,沙糖桔,20220614,0,0,0,0.0,0.0,0.0
166,沙糖桔,20220615,0,0,0,0.0,0.0,0.0
167,沙糖桔,20220616,0,0,0,0.0,0.0,0.0
168,沙糖桔,20220617,0,0,0,0.0,0.0,0.0
169,沙糖桔,20220618,0,0,0,0.0,0.0,0.0
170,沙糖桔,20220619,0,0,0,0.0,0.0,0.0
171,沙糖桔,20220620,0,0,0,0.0,0.0,0.0
172,沙糖桔,20220621,0,0,0,0.0,0.0,0.0
173,沙糖桔,20220622,0,0,0,0.0,0.0,0.0
174,沙糖桔,20220623,0,0,0,0.0,0.0,0.0
175,沙糖桔,20220624,0,0,0,0.0,0.0,0.0
176,沙糖桔,20220625,0,0,0,0.0,0.0,0.0
177,沙糖桔,20220626,0,0,0,0.0,0.0,0.0
178,沙糖桔,20220627,0,0,0,0.0,0.0,0.0
179,沙糖桔,20220628,0,0,0,0.0,0.0,0.0
180,沙糖桔,20220629,0,0,0,0.0,0.0,0.0
181,沙糖桔,20220630,0,0,0,0.0,0.0,0.0
182,沙糖桔,20220701,0,0,0,0.0,0.0,0.0
183,沙糖桔,20220702,0,0,0,0.0,0.0,0.0
184,沙糖桔,20220703,0,0,0,0.0,0.0,0.0
185,沙糖桔,20220704,0,0,0,0.0,0.0,0.0
186,沙糖桔,20220705,0,0,0,0.0,0.0,0.0
187,沙糖桔,20220706,0,0,0,0.0,0.0,0.0
188,沙糖桔,20220707,0,0,0,0.0,0.0,0.0
189,沙糖桔,20220708,0,0,0,0.0,0.0,0.0
190,沙糖桔,20220709,0,0,0,0.0,0.0,0.0
191,沙糖桔,20220710,0,0,0,0.0,0.0,0.0
192,沙糖桔,20220711,0,0,0,0.0,0.0,0.0
193,沙糖桔,20220712,0,0,0,0.0,0.0,0.0
194,沙糖桔,20220713,0,0,0,0.0,0.0,0.0
195,沙糖桔,20220714,0,0,0,0.0,0.0,0.0
196,沙糖桔,20220715,0,0,0,0.0,0.0,0.0
197,沙糖桔,20220716,0,0,0,0.0,0.0,0.0
198,沙糖桔,20220717,0,0,0,0.0,0.0,0.0
199,沙糖桔,20220718,0,0,0,0.0,0.0,0.0
200,沙糖桔,20220719,0,0,0,0.0,0.0,0.0
201,沙糖桔,20220720,0,0,0,0.0,0.0,0.0
202,沙糖桔,20220721,0,0,0,0.0,0.0,0.0
203,沙糖桔,20220722,0,0,0,0.0,0.0,0.0
204,沙糖桔,20220723,0,0,0,0.0,0.0,0.0
205,沙糖桔,20220724,0,0,0,0.0,0.0,0.0
206,沙糖桔,20220725,0,0,0,0.0,0.0,0.0
207,沙糖桔,20220726,0,0,0,0.0,0.0,0.0
208,沙糖桔,20220727,0,0,0,0.0,0.0,0.0
209,沙糖桔,20220728,0,0,0,0.0,0.0,0.0
210,沙糖桔,20220729,0,0,0,0.0,0.0,0.0
211,沙糖桔,20220730,0,0,0,0.0,0.0,0.0
212,沙糖桔,20220731,0,0,0,0.0,0.0,0.0
213,沙糖桔,20220801,0,0,0,0.0,0.0,0.0
214,沙糖桔,20220802,0,0,0,0.0,0.0,0.0
215,沙糖桔,20220803,0,0,0,0.0,0.0,0.0
216,沙糖桔,20220804,0,0,0,0.0,0.0,0.0
217,沙糖桔,20220805,0,0,0,0.0,0.0,0.0
218,沙糖桔,20220806,0,0,0,0.0,0.0,0.0
219,沙糖桔,20220807,0,0,0,0.0,0.0,0.0
220,沙糖桔,20220808,0,0,0,0.0,0.0,0.0
221,沙糖桔,20220809,0,0,0,0.0,0.0,0.0
222,沙糖桔,20220810,0,0,0,0.0,0.0,0.0
223,沙糖桔,20220811,0,0,0,0.0,0.0,0.0
224,沙糖桔,20220812,0,0,0,0.0,0.0,0.0
225,沙糖桔,20220813,0,0,0,0.0,0.0,0.0
226,沙糖桔,20220814,0,0,0,0.0,0.0,0.0
227,沙糖桔,20220815,0,0,0,0.0,0.0,0.0
228,沙糖桔,20220816,0,0,0,0.0,0.0,0.0
229,沙糖桔,20220817,0,0,0,0.0,0.0,0.0
230,沙糖桔,20220818,0,0,0,0.0,0.0,0.0
231,沙糖桔,20220819,0,0,0,0.0,0.0,0.0
232,沙糖桔,20220820,0,0,0,0.0,0.0,0.0
233,沙糖桔,20220821,0,0,0,0.0,0.0,0.0
234,沙糖桔,20220822,0,0,0,0.0,0.0,0.0
235,沙糖桔,20220823,0,0,0,0.0,0.0,0.0
236,沙糖桔,20220824,0,0,0,0.0,0.0,0.0
237,沙糖桔,20220825,0,0,0,0.0,0.0,0.0
238,沙糖桔,20220826,0,0,0,0.0,0.0,0.0
239,沙糖桔,20220827,0,0,0,0.0,0.0,0.0
240,沙糖桔,20220828,0,0,0,0.0,0.0,0.0
241,沙糖桔,20220829,0,0,0,0.0,0.0,0.0
242,沙糖桔,20220830,0,0,0,0.0,0.0,0.0
243,沙糖桔,20220831,0,0,0,0.0,0.0,0.0
244,沙糖桔,20220901,0,0,0,0.0,0.0,0.0
245,沙糖桔,20220902,0,0,0,0.0,0.0,0.0
246,沙糖桔,20220903,0,0,0,0.0,0.0,0.0
247,沙糖桔,20220904,0,0,0,0.0,0.0,0.0
248,沙糖桔,20220905,0,0,0,0.0,0.0,0.0
249,沙糖桔,20220906,0,0,0,0.0,0.0,0.0
250,沙糖桔,20220907,0,0,0,0.0,0.0,0.0
251,沙糖桔,20220908,0,0,0,0.0,0.0,0.0
252,沙糖桔,20220909,0,0,0,0.0,0.0,0.0
253,沙糖桔,20220910,0,0,0,0.0,0.0,0.0
254,沙糖桔,20220911,0,0,0,0.0,0.0,0.0
255,沙糖桔,20220912,0,0,0,0.0,0.0,0.0
256,沙糖桔,20220913,0,0,0,0.0,0.0,0.0
257,沙糖桔,20220914,0,0,0,0.0,0.0,0.0
258,沙糖桔,20220915,0,0,0,0.0,0.0,0.0
259,沙糖桔,20220916,0,0,0,0.0,0.0,0.0
260,沙糖桔,20220917,0,0,0,0.0,0.0,0.0
261,沙糖桔,20220918,0,0,0,0.0,0.0,0.0
262,沙糖桔,20220919,0,0,0,0.0,0.0,0.0
263,沙糖桔,20220920,0,0,0,0.0,0.0,0.0
264,沙糖桔,20220921,0,0,0,0.0,0.0,0.0
265,沙糖桔,20220922,0,0,0,0.0,0.0,0.0
266,沙糖桔,20220923,0,0,0,0.0,0.0,0.0
267,沙糖桔,20220924,0,0,0,0.0,0.0,0.0
268,沙糖桔,20220925,0,0,0,0.0,0.0,0.0
269,沙糖桔,20220926,0,0,0,0.0,0.0,0.0
270,沙糖桔,20220927,0,0,0,0.0,0.0,0.0
271,沙糖桔,20220928,0,0,0,0.0,0.0,0.0
272,沙糖桔,20220929,0,0,0,0.0,0.0,0.0
273,沙糖桔,20220930,0,0,0,0.0,0.0,0.0
274,沙糖桔,20221001,0,0,0,0.0,0.0,0.0
275,沙糖桔,20221002,0,0,0,0.0,0.0,0.0
276,沙糖桔,20221003,0,0,0,0.0,0.0,0.0
277,沙糖桔,20221004,0,0,0,0.0,0.0,0.0
278,沙糖桔,20221005,0,0,0,0.0,0.0,0.0
279,沙糖桔,20221006,0,0,0,0.0,0.0,0.0
280,沙糖桔,20221007,0,0,0,0.0,0.0,0.0
281,沙糖桔,20221008,0,0,0,0.0,0.0,0.0
282,沙糖桔,20221009,0,0,0,0.0,0.0,0.0
283,沙糖桔,20221010,0,0,0,0.0,0.0,0.0
284,沙糖桔,20221011,0,0,0,0.0,0.0,0.0
285,沙糖桔,20221012,0,0,0,0.0,0.0,0.0
286,沙糖桔,20221013,0,0,0,0.0,0.0,0.0
287,沙糖桔,20221014,0,0,0,0.0,0.0,0.0
288,沙糖桔,20221015,0,0,0,0.0,0.0,0.0
289,沙糖桔,20221016,0,0,0,0.0,0.0,0.0
290,沙糖桔,20221017,0,0,0,0.0,0.0,0.0
291,沙糖桔,20221018,0,0,0,0.0,0.0,0.0
292,沙糖桔,20221019,0,0,0,0.0,0.0,0.0
293,沙糖桔,20221020,0,0,0,0.0,0.0,0.0
294,沙糖桔,20221021,0,0,0,0.0,0.0,0.0
295,沙糖桔,20221022,0,0,0,0.0,0.0,0.0
296,沙糖桔,20221023,0,0,0,0.0,0.0,0.0
297,沙糖桔,20221024,0,0,0,0.0,0.0,0.0
298,沙糖桔,20221025,0,0,0,0.0,0.0,0.0
299,沙糖桔,20221026,0,0,0,0.0,0.0,0.0
300,沙糖桔,20221027,0,0,0,0.0,0.0,0.0
301,沙糖桔,20221028,0,0,0,0.0,0.0,0.0
302,沙糖桔,20221029,0,0,0,0.0,0.0,0.0
303,沙糖桔,20221030,0,0,0,0.0,0.0,0.0
304,沙糖桔,20221031,0,0,0,0.0,0.0,0.0
305,沙糖桔,20221101,0,0,0,0.0,0.0,0.0
306,沙糖桔,20221102,0,0,0,0.0,0.0,0.0
307,沙糖桔,20221103,0,0,0,0.0,0.0,0.0
308,沙糖桔,20221104,0,0,0,0.0,0.0,0.0
309,沙糖桔,20221105,0,0,0,0.0,0.0,0.0
310,沙糖桔,20221106,0,0,0,0.0,0.0,0.0
311,沙糖桔,20221107,0,0,0,0.0,0.0,0.0
312,沙糖桔,20221108,0,0,0,0.0,0.0,0.0
313,沙糖桔,20221109,0,0,0,0.0,0.0,0.0
314,沙糖桔,20221110,0,0,0,0.0,0.0,0.0
315,沙糖桔,20221111,0,0,0,0.0,0.0,0.0
316,沙糖桔,20221112,0,0,0,0.0,0.0,0.0
317,沙糖桔,20221113,0,0,0,0.0,0.0,0.0
318,沙糖桔,20221114,0,0,0,0.0,0.0,0.0
319,沙糖桔,20221115,0,0,0,0.0,0.0,0.0
320,沙糖桔,20221116,0,0,0,0.0,0.0,0.0
321,沙糖桔,20221117,0,0,0,0.0,0.0,0.0
322,沙糖桔,20221118,0,0,0,0.0,0.0,0.0
323,沙糖桔,20221119,0,0,0,0.0,0.0,0.0
324,沙糖桔,20221120,0,0,0,0.0,0.0,0.0
325,沙糖桔,20221121,0,0,0,0.0,0.0,0.0
326,沙糖桔,20221122,0,0,0,0.0,0.0,0.0
327,沙糖桔,20221123,0,0,0,0.0,0.0,0.0
328,沙糖桔,20221124,0,0,0,0.0,0.0,0.0
329,沙糖桔,20221125,0,0,0,0.0,0.0,0.0
330,沙糖桔,20221126,0,0,0,0.0,0.0,0.0
331,沙糖桔,20221127,0,0,0,0.0,0.0,0.0
332,沙糖桔,20221128,0,0,0,0.0,0.0,0.0
333,沙糖桔,20221129,0,0,0,0.0,0.0,0.0
334,沙糖桔,20221130,0,0,0,0.0,0.0,0.0
335,沙糖桔,20221201,0,0,0,0.0,0.0,0.0
336,沙糖桔,20221202,0,0,0,0.0,0.0,0.0
337,沙糖桔,20221203,0,0,0,0.0,0.0,0.0
338,沙糖桔,20221204,0,0,0,0.0,0.0,0.0
339,沙糖桔,20221205,0,0,0,0.0,0.0,0.0
340,沙糖桔,20221206,0,0,0,0.0,0.0,0.0
341,沙糖桔,20221207,0,0,0,0.0,0.0,0.0
342,沙糖桔,20221208,0,0,0,0.0,0.0,0.0
343,沙糖桔,20221209,0,0,0,0.0,0.0,0.0
344,沙糖桔,20221210,0,0,0,0.0,0.0,0.0
345,沙糖桔,20221211,0,0,0,0.0,0.0,0.0
346,沙糖桔,20221212,0,0,0,0.0,0.0,0.0
347,沙糖桔,20221213,0,0,0,0.0,0.0,0.0
348,沙糖桔,20221214,0,0,0,0.0,0.0,0.0
349,沙糖桔,20221215,0,0,0,0.0,0.0,0.0
350,沙糖桔,20221216,0,0,0,0.0,0.0,0.0
351,沙糖桔,20221217,0,0,0,0.0,0.0,0.0
352,沙糖桔,20221218,0,0,0,0.0,0.0,0.0
353,沙糖桔,20221219,0,0,0,0.0,0.0,0.0
354,沙糖桔,20221220,0,0,0,0.0,0.0,0.0
355,沙糖桔,20221221,0,0,0,0.0,0.0,0.0
356,沙糖桔,20221222,0,0,0,0.0,0.0,0.0
357,沙糖桔,20221223,0,0,0,0.0,0.0,0.0
358,沙糖桔,20221224,0,0,0,0.0,0.0,0.0
359,沙糖桔,20221225,0,0,0,0.0,0.0,0.0
360,沙糖桔,20221226,0,0,0,0.0,0.0,0.0
361,沙糖桔,20221227,0,0,0,0.0,0.0,0.0
362,沙糖桔,20221228,0,0,0,0.0,0.0,0.0
363,沙糖桔,20221229,0,0,0,0.0,0.0,0.0
364,沙糖桔,20221230,0,0,0,0.0,0.0,0.0
365,沙糖桔,20221231,0,0,0,0.0,0.0,0.0
366,沙糖桔,20230101,0,0,0,0.0,0.0,0.0
367,沙糖桔,20230102,0,0,0,0.0,0.0,0.0
368,沙糖桔,20230103,0,0,0,0.0,0.0,0.0
369,沙糖桔,20230104,0,0,0,0.0,0.0,0.0
370,沙糖桔,20230105,0,0,0,0.0,0.0,0.0
371,沙糖桔,20230106,0,0,0,0.0,0.0,0.0
372,沙糖桔,20230107,0,0,0,0.0,0.0,0.0
373,沙糖桔,20230108,0,0,0,0.0,0.0,0.0
374,沙糖桔,20230109,0,0,0,0.0,0.0,0.0
375,沙糖桔,20230110,0,0,0,0.0,0.0,0.0
376,沙糖桔,20230111,0,0,0,0.0,0.0,0.0
377,沙糖桔,20230112,0,0,0,0.0,0.0,0.0
378,沙糖桔,20230113,0,0,0,0.0,0.0,0.0
379,沙糖桔,20230114,0,0,0,0.0,0.0,0.0
380,沙糖桔,20230115,0,0,0,0.0,0.0,0.0
381,沙糖桔,20230116,0,0,0,0.0,0.0,0.0
382,沙糖桔,20230117,0,0,0,0.0,0.0,0.0
383,沙糖桔,20230118,0,0,0,0.0,0.0,0.0
384,沙糖桔,20230119,0,0,0,0.0,0.0,0.0
385,沙糖桔,20230120,0,0,0,0.0,0.0,0.0
386,沙糖桔,20230121,0,0,0,0.0,0.0,0.0
387,沙糖桔,20230122,0,0,0,0.0,0.0,0.0
388,沙糖桔,20230123,0,0,0,0.0,0.0,0.0
389,沙糖桔,20230124,0,0,0,0.0,0.0,0.0
390,沙糖桔,20230125,0,0,0,0.0,0.0,0.0
391,沙糖桔,20230126,0,0,0,0.0,0.0,0.0
392,沙糖桔,20230127,0,0,0,0.0,0.0,0.0
393,沙糖桔,20230128,0,0,0,0.0,0.0,0.0
394,沙糖桔,20230129,0,0,0,0.0,0.0,0.0
395,沙糖桔,20230130,0,0,0,0.0,0.0,0.0
396,沙糖桔,20230131,0,0,0,0.0,0.0,0.0
397,沙糖桔,20230201,0,0,0,0.0,0.0,0.0
398,沙糖桔,20230202,0,0,0,0.0,0.0,0.0
399,沙糖桔,20230203,0,0,0,0.0,0.0,0.0
400,沙糖桔,20230204,0,0,0,0.0,0.0,0.0
401,沙糖桔,20230205,0,0,0,0.0,0.0,0.0
402,沙糖桔,20230206,0,0,0,0.0,0.0,0.0
403,沙糖桔,20230207,0,0,0,0.0,0.0,0.0
404,沙糖桔,20230208,0,0,0,0.0,0.0,0.0
405,沙糖桔,20230209,0,0,0,0.0,0.0,0.0
406,沙糖桔,20230210,0,0,0,0.0,0.0,0.0
407,沙糖桔,20230211,0,0,0,0.0,0.0,0.0
408,沙糖桔,20230212,0,0,0,0.0,0.0,0.0
409,沙糖桔,20230213,0,0,0,0.0,0.0,0.0
410,沙糖桔,20230214,0,0,0,0.0,0.0,0.0
411,沙糖桔,20230215,0,0,0,0.0,0.0,0.0
412,沙糖桔,20230216,0,0,0,0.0,0.0,0.0
413,沙糖桔,20230217,0,0,0,0.0,0.0,0.0
414,沙糖桔,20230218,0,0,0,0.0,0.0,0.0
415,沙糖桔,20230219,0,0,0,0.0,0.0,0.0
416,沙糖桔,20230220,0,0,0,0.0,0.0,0.0
417,沙糖桔,20230221,0,0,0,0.0,0.0,0.0
418,沙糖桔,20230222,0,0,0,0.0,0.0,0.0
419,沙糖桔,20230223,0,0,0,0.0,0.0,0.0
420,沙糖桔,20230224,0,0,0,0.0,0.0,0.0
421,沙糖桔,20230225,0,0,0,0.0,0.0,0.0
422,沙糖桔,20230226,0,0,0,0.0,0.0,0.0
423,沙糖桔,20230227,0,0,0,0.0,0.0,0.0
424,沙糖桔,20230228,0,0,0,0.0,0.0,0.0
425,沙糖桔,20230301,0,0,0,0.0,0.0,0.0
426,沙糖桔,20230302,0,0,0,0.0,0.0,0.0
427,沙糖桔,20230303,0,0,0,0.0,0.0,0.0
428,沙糖桔,20230304,0,0,0,0.0,0.0,0.0
429,沙糖桔,20230305,0,0,0,0.0,0.0,0.0
430,沙糖桔,20230306,0,0,0,0.0,0.0,0.0
431,沙糖桔,20230307,0,0,0,0.0,0.0,0.0
432,沙糖桔,20230308,0,0,0,0.0,0.0,0.0
433,沙糖桔,20230309,0,0,0,0.0,0.0,0.0
434,沙糖桔,20230310,0,0,0,0.0,0.0,0.0
435,沙糖桔,20230311,0,0,0,0.0,0.0,0.0
436,沙糖桔,20230312,0,0,0,0.0,0.0,0.0
437,沙糖桔,20230313,0,0,0,0.0,0.0,0.0
438,沙糖桔,20230314,0,0,0,0.0,0.0,0.0
439,沙糖桔,20230315,0,0,0,0.0,0.0,0.0
440,沙糖桔,20230316,0,0,0,0.0,0.0,0.0
441,沙糖桔,20230317,0,0,0,0.0,0.0,0.0
442,沙糖桔,20230318,0,0,0,0.0,0.0,0.0
443,沙糖桔,20230319,0,0,0,0.0,0.0,0.0
444,沙糖桔,20230320,0,0,0,0.0,0.0,0.0
445,沙糖桔,20230321,0,0,0,0.0,0.0,0.0
446,沙糖桔,20230322,0,0,0,0.0,0.0,0.0
447,沙糖桔,20230323,0,0,0,0.0,0.0,0.0
448,沙糖桔,20230324,0,0,0,0.0,0.0,0.0
449,沙糖桔,20230325,0,0,0,0.0,0.0,0.0
450,沙糖桔,20230326,0,0,0,0.0,0.0,0.0
451,沙糖桔,20230327,0,0,0,0.0,0.0,0.0
452,沙糖桔,20230328,0,0,0,0.0,0.0,0.0
453,沙糖桔,20230329,0,0,0,0.0,0.0,0.0
454,沙糖桔,20230330,0,0,0,0.0,0.0,0.0
455,沙糖桔,20230331,0,0,0,0.0,0.0,0.0
456,沙糖桔,20230401,0,0,0,0.0,0.0,0.0
457,沙糖桔,20230402,0,0,0,0.0,0.0,0.0
458,沙糖桔,20230403,0,0,0,0.0,0.0,0.0
459,沙糖桔,20230404,0,0,0,0.0,0.0,0.0
460,沙糖桔,20230405,0,0,0,0.0,0.0,0.0
461,沙糖桔,20230406,0,0,0,0.0,0.0,0.0
462,沙糖桔,20230407,0,0,0,0.0,0.0,0.0
463,沙糖桔,20230408,0,0,0,0.0,0.0,0.0
464,沙糖桔,20230409,0,0,0,0.0,0.0,0.0
465,沙糖桔,20230410,0,0,0,0.0,0.0,0.0
466,沙糖桔,20230411,0,0,0,0.0,0.0,0.0
467,沙糖桔,20230412,0,0,0,0.0,0.0,0.0
468,沙糖桔,20230413,0,0,0,0.0,0.0,0.0
469,沙糖桔,20230414,0,0,0,0.0,0.0,0.0
470,沙糖桔,20230415,0,0,0,0.0,0.0,0.0
471,沙糖桔,20230416,0,0,0,0.0,0.0,0.0
472,沙糖桔,20230417,0,0,0,0.0,0.0,0.0
473,沙糖桔,20230418,0,0,0,0.0,0.0,0.0
474,沙糖桔,20230419,0,0,0,0.0,0.0,0.0
475,沙糖桔,20230420,0,0,0,0.0,0.0,0.0
476,沙糖桔,20230421,0,0,0,0.0,0.0,0.0
477,沙糖桔,20230422,0,0,0,0.0,0.0,0.0
478,沙糖桔,20230423,0,0,0,0.0,0.0,0.0
479,沙糖桔,20230424,0,0,0,0.0,0.0,0.0
480,沙糖桔,20230425,0,0,0,0.0,0.0,0.0
481,沙糖桔,20230426,0,0,0,0.0,0.0,0.0
482,沙糖桔,20230427,0,0,0,0.0,0.0,0.0
483,沙糖桔,20230428,0,0,0,0.0,0.0,0.0
484,沙糖桔,20230429,0,0,0,0.0,0.0,0.0
485,沙糖桔,20230430,0,0,0,0.0,0.0,0.0
486,沙糖桔,20230501,0,0,0,0.0,0.0,0.0
487,沙糖桔,20230502,0,0,0,0.0,0.0,0.0
488,沙糖桔,20230503,0,0,0,0.0,0.0,0.0
489,沙糖桔,20230504,0,0,0,0.0,0.0,0.0
490,沙糖桔,20230505,0,0,0,0.0,0.0,0.0
491,沙糖桔,20230506,0,0,0,0.0,0.0,0.0
492,沙糖桔,20230507,0,0,0,0.0,0.0,0.0
493,沙糖桔,20230508,0,0,0,0.0,0.0,0.0
494,沙糖桔,20230509,0,0,0,0.0,0.0,0.0
495,沙糖桔,20230510,0,0,0,0.0,0.0,0.0
496,沙糖桔,20230511,0,0,0,0.0,0.0,0.0
497,沙糖桔,20230512,0,0,0,0.0,0.0,0.0
498,沙糖桔,20230513,0,0,0,0.0,0.0,0.0
499,沙糖桔,20230514,0,0,0,0.0,0.0,0.0
500,沙糖桔,20230515,0,0,0,0.0,0.0,0.0
501,沙糖桔,20230516,0,0,0,0.0,0.0,0.0
502,沙糖桔,20230517,0,0,0,0.0,0.0,0.0
503,沙糖桔,20230518,0,0,0,0.0,0.0,0.0
504,沙糖桔,20230519,0,0,0,0.0,0.0,0.0
505,沙糖桔,20230520,0,0,0,0.0,0.0,0.0
506,沙糖桔,20230521,0,0,0,0.0,0.0,0.0
507,沙糖桔,20230522,0,0,0,0.0,0.0,0.0
508,沙糖桔,20230523,0,0,0,0.0,0.0,0.0
509,沙糖桔,20230524,0,0,0,0.0,0.0,0.0
510,沙糖桔,20230525,0,0,0,0.0,0.0,0.0
511,沙糖桔,20230526,0,0,0,0.0,0.0,0.0
512,沙糖桔,20230527,0,0,0,0.0,0.0,0.0
513,沙糖桔,20230528,0,0,0,0.0,0.0,0.0
514,沙糖桔,20230529,0,0,0,0.0,0.0,0.0
515,沙糖桔,20230530,0,0,0,0.0,0.0,0.0
516,沙糖桔,20230531,0,0,0,0.0,0.0,0.0
517,沙糖桔,20230601,0,0,0,0.0,0.0,0.0
518,沙糖桔,20230602,0,0,0,0.0,0.0,0.0
519,沙糖桔,20230603,0,0,0,0.0,0.0,0.0
520,沙糖桔,20230604,0,0,0,0.0,0.0,0.0
521,沙糖桔,20230605,0,0,0,0.0,0.0,0.0
522,沙糖桔,20230606,0,0,0,0.0,0.0,0.0
523,沙糖桔,20230607,0,0,0,0.0,0.0,0.0
524,沙糖桔,20230608,0,0,0,0.0,0.0,0.0
525,沙糖桔,20230609,0,0,0,0.0,0.0,0.0
526,沙糖桔,20230610,0,0,0,0.0,0.0,0.0
527,沙糖桔,20230611,0,0,0,0.0,0.0,0.0
528,沙糖桔,20230612,0,0,0,0.0,0.0,0.0
529,沙糖桔,20230613,0,0,0,0.0,0.0,0.0
530,沙糖桔,20230614,0,0,0,0.0,0.0,0.0
531,沙糖桔,20230615,0,0,0,0.0,0.0,0.0
532,沙糖桔,20230616,0,0,0,0.0,0.0,0.0
533,沙糖桔,20230617,0,0,0,0.0,0.0,0.0
534,沙糖桔,20230618,0,0,0,0.0,0.0,0.0
535,沙糖桔,20230619,0,0,0,0.0,0.0,0.0
536,沙糖桔,20230620,0,0,0,0.0,0.0,0.0
537,沙糖桔,20230621,0,0,0,0.0,0.0,0.0
538,沙糖桔,20230622,0,0,0,0.0,0.0,0.0
539,沙糖桔,20230623,0,0,0,0.0,0.0,0.0
540,沙糖桔,20230624,0,0,0,0.0,0.0,0.0
541,沙糖桔,20230625,0,0,0,0.0,0.0,0.0
542,沙糖桔,20230626,0,0,0,0.0,0.0,0.0
543,沙糖桔,20230627,0,0,0,0.0,0.0,0.0
544,沙糖桔,20230628,0,0,0,0.0,0.0,0.0
545,沙糖桔,20230629,0,0,0,0.0,0.0,0.0
546,沙糖桔,20230630,0,0,0,0.0,0.0,0.0
547,沙糖桔,20230701,0,0,0,0.0,0.0,0.0
548,沙糖桔,20230702,0,0,0,0.0,0.0,0.0
549,沙糖桔,20230703,0,0,0,0.0,0.0,0.0
550,沙糖桔,20230704,0,0,0,0.0,0.0,0.0
551,沙糖桔,20230705,0,0,0,0.0,0.0,0.0
552,沙糖桔,20230706,0,0,0,0.0,0.0,0.0
553,沙糖桔,20230707,0,0,0,0.0,0.0,0.0
554,沙糖桔,20230708,0,0,0,0.0,0.0,0.0
555,沙糖桔,20230709,0,0,0,0.0,0.0,0.0
556,沙糖桔,20230710,0,0,0,0.0,0.0,0.0
557,沙糖桔,20230711,0,0,0,0.0,0.0,0.0
558,沙糖桔,20230712,0,0,0,0.0,0.0,0.0
559,沙糖桔,20230713,0,0,0,0.0,0.0,0.0
560,沙糖桔,20230714,0,0,0,0.0,0.0,0.0
561,沙糖桔,20230715,0,0,0,0.0,0.0,0.0
562,沙糖桔,20230716,0,0,0,0.0,0.0,0.0
563,沙糖桔,20230717,0,0,0,0.0,0.0,0.0
564,沙糖桔,20230718,0,0,0,0.0,0.0,0.0
565,沙糖桔,20230719,0,0,0,0.0,0.0,0.0
566,沙糖桔,20230720,0,0,0,0.0,0.0,0.0
567,沙糖桔,20230721,0,0,0,0.0,0.0,0.0
568,沙糖桔,20230722,0,0,0,0.0,0.0,0.0
569,沙糖桔,20230723,0,0,0,0.0,0.0,0.0
570,沙糖桔,20230724,0,0,0,0.0,0.0,0.0
571,沙糖桔,20230725,0,0,0,0.0,0.0,0.0
572,沙糖桔,20230726,0,0,0,0.0,0.0,0.0
573,沙糖桔,20230727,0,0,0,0.0,0.0,0.0
574,沙糖桔,20230728,0,0,0,0.0,0.0,0.0
575,沙糖桔,20230729,0,0,0,0.0,0.0,0.0
576,沙糖桔,20230730,0,0,0,0.0,0.0,0.0
577,沙糖桔,20230731,0,0,0,0.0,0.0,0.0
578,沙糖桔,20230801,0,0,0,0.0,0.0,0.0
579,沙糖桔,20230802,0,0,0,0.0,0.0,0.0
580,沙糖桔,20230803,0,0,0,0.0,0.0,0.0
581,沙糖桔,20230804,0,0,0,0.0,0.0,0.0
582,沙糖桔,20230805,0,0,0,0.0,0.0,0.0
583,沙糖桔,20230806,0,0,0,0.0,0.0,0.0
584,沙糖桔,20230807,0,0,0,0.0,0.0,0.0
585,沙糖桔,20230808,0,0,0,0.0,0.0,0.0
586,沙糖桔,20230809,0,0,0,0.0,0.0,0.0
587,沙糖桔,20230810,0,0,0,0.0,0.0,0.0
588,沙糖桔,20230811,0,0,0,0.0,0.0,0.0
589,沙糖桔,20230812,0,0,0,0.0,0.0,0.0
590,沙糖桔,20230813,0,0,0,0.0,0.0,0.0
591,沙糖桔,20230814,0,0,0,0.0,0.0,0.0
592,沙糖桔,20230815,0,0,0,0.0,0.0,0.0
593,沙糖桔,20230816,0,0,0,0.0,0.0,0.0
594,沙糖桔,20230817,0,0,0,0.0,0.0,0.0
595,沙糖桔,20230818,0,0,0,0.0,0.0,0.0
596,沙糖桔,20230819,0,0,0,0.0,0.0,0.0
597,沙糖桔,20230820,0,0,0,0.0,0.0,0.0
598,沙糖桔,20230821,0,0,0,0.0,0.0,0.0
599,沙糖桔,20230822,0,0,0,0.0,0.0,0.0
600,沙糖桔,20230823,0,0,0,0.0,0.0,0.0
601,沙糖桔,20230824,0,0,0,0.0,0.0,0.0
602,沙糖桔,20230825,0,0,0,0.0,0.0,0.0
603,沙糖桔,20230826,0,0,0,0.0,0.0,0.0
604,沙糖桔,20230827,0,0,0,0.0,0.0,0.0
605,沙糖桔,20230828,0,0,0,0.0,0.0,0.0
606,沙糖桔,20230829,0,0,0,0.0,0.0,0.0
607,沙糖桔,20230830,0,0,0,0.0,0.0,0.0
608,沙糖桔,20230831,0,0,0,0.0,0.0,0.0
609,沙糖桔,20230901,0,0,0,0.0,0.0,0.0
610,沙糖桔,20230902,0,0,0,0.0,0.0,0.0
611,沙糖桔,20230903,0,0,0,0.0,0.0,0.0
612,沙糖桔,20230904,0,0,0,0.0,0.0,0.0
613,沙糖桔,20230905,0,0,0,0.0,0.0,0.0
614,沙糖桔,20230906,0,0,0,0.0,0.0,0.0
615,沙糖桔,20230907,0,0,0,0.0,0.0,0.0
616,沙糖桔,20230908,0,0,0,0.0,0.0,0.0
617,沙糖桔,20230909,0,0,0,0.0,0.0,0.0
618,沙糖桔,20230910,0,0,0,0.0,0.0,0.0
619,沙糖桔,20230911,0,0,0,0.0,0.0,0.0
620,沙糖桔,20230912,0,0,0,0.0,0.0,0.0
621,沙糖桔,20230913,0,0,0,0.0,0.0,0.0
622,沙糖桔,20230914,0,0,0,0.0,0.0,0.0
623,沙糖桔,20230915,0,0,0,0.0,0.0,0.0
624,沙糖桔,20230916,0,0,0,0.0,0.0,0.0
625,沙糖桔,20230917,0,0,0,0.0,0.0,0.0
626,沙糖桔,20230918,0,0,0,0.0,0.0,0.0
627,沙糖桔,20230919,0,0,0,0.0,0.0,0.0
628,沙糖桔,20230920,0,0,0,0.0,0.0,0.0
629,沙糖桔,20230921,0,0,0,0.0,0.0,0.0
630,沙糖桔,20230922,0,0,0,0.0,0.0,0.0
631,沙糖桔,20230923,0,0,0,0.0,0.0,0.0
632,沙糖桔,20230924,0,0,0,0.0,0.0,0.0
633,沙糖桔,20230925,0,0,0,0.0,0.0,0.0
634,沙糖桔,20230926,0,0,0,0.0,0.0,0.0
635,沙糖桔,20230927,0,0,0,0.0,0.0,0.0
636,沙糖桔,20230928,0,0,0,0.0,0.0,0.0
637,沙糖桔,20230929,0,0,0,0.0,0.0,0.0
638,沙糖桔,20230930,0,0,0,0.0,0.0,0.0
639,沙糖桔,20231001,269,61,208,0.0,53.8,26.9
640,沙糖桔,20231002,275,63,212,269.0,108.8,54.4
641,沙糖桔,20231003,256,61,195,275.0,160.0,80.0
642,沙糖桔,20231004,281,66,215,256.0,216.2,108.1
643,沙糖桔,20231005,280,68,212,281.0,272.2,136.1
644,沙糖桔,20231006,314,66,248,280.0,281.2,167.5
645,沙糖桔,20231007,287,78,209,314.0,283.6,196.2
646,沙糖桔,20231008,316,89,227,287.0,295.6,227.8
647,沙糖桔,20231009,308,70,238,316.0,301.0,258.6
648,沙糖桔,20231010,325,70,255,308.0,310.0,291.1
649,沙糖桔,20231011,344,80,264,325.0,316.0,298.6
650,沙糖桔,20231012,335,87,248,344.0,325.6,304.6
651,沙糖桔,20231013,316,82,234,335.0,325.6,310.6
652,沙糖桔,20231014,336,63,273,316.0,331.2,316.1
653,沙糖桔,20231015,383,76,307,336.0,342.8,326.4
654,沙糖桔,20231016,388,85,303,383.0,351.6,333.8
655,沙糖桔,20231017,372,87,285,388.0,359.0,342.3
656,沙糖桔,20231018,378,91,287,372.0,371.4,348.5
657,沙糖桔,20231019,355,93,262,378.0,375.2,353.2
658,沙糖桔,20231020,331,93,238,355.0,364.8,353.8
659,沙糖桔,20231021,427,83,344,331.0,372.6,362.1
660,沙糖桔,20231022,407,74,333,427.0,379.6,369.3
661,沙糖桔,20231023,402,87,315,407.0,384.4,377.9
662,沙糖桔,20231024,370,76,294,402.0,387.4,381.3
663,沙糖桔,20231025,387,102,285,370.0,398.6,381.7
664,沙糖桔,20231026,353,87,266,387.0,383.8,378.2
665,沙糖桔,20231027,402,89,313,353.0,382.8,381.2
666,沙糖桔,20231028,449,82,367,402.0,392.2,388.3
667,沙糖桔,20231029,443,74,369,449.0,406.8,397.1
668,沙糖桔,20231030,404,95,309,443.0,410.2,404.4
669,沙糖桔,20231031,447,95,352,404.0,429.0,406.4
670,沙糖桔,20231101,519,114,405,447.0,452.4,417.6
671,沙糖桔,20231102,448,106,342,519.0,452.2,422.2
672,沙糖桔,20231103,498,97,401,448.0,463.2,435.0
673,沙糖桔,20231104,498,82,416,498.0,482.0,446.1
674,沙糖桔,20231105,468,95,373,498.0,486.2,457.6
675,沙糖桔,20231106,548,108,440,468.0,492.0,472.2
676,沙糖桔,20231107,513,97,416,548.0,505.0,478.6
677,沙糖桔,20231108,591,99,492,513.0,523.6,493.4
678,沙糖桔,20231109,584,116,468,591.0,540.8,511.4
679,沙糖桔,20231110,509,116,393,584.0,549.0,517.6
680,沙糖桔,20231111,523,87,436,509.0,544.0,518.0
681,沙糖桔,20231112,649,78,571,523.0,571.2,538.1
682,沙糖桔,20231113,549,112,437,649.0,562.8,543.2
683,沙糖桔,20231114,657,85,572,549.0,577.4,559.1
684,沙糖桔,20231115,652,133,519,657.0,606.0,577.5
685,沙糖桔,20231116,638,121,517,652.0,629.0,586.5
686,沙糖桔,20231117,735,104,631,638.0,646.2,608.7
687,沙糖桔,20231118,745,114,631,735.0,685.4,624.1
688,沙糖桔,20231119,882,82,800,745.0,730.4,653.9
689,沙糖桔,20231120,943,140,803,882.0,788.6,697.3
690,沙糖桔,20231121,822,116,706,943.0,825.4,727.2
691,沙糖桔,20231122,823,120,703,822.0,843.0,744.6
692,沙糖桔,20231123,783,116,667,823.0,850.6,768.0
693,沙糖桔,20231124,797,133,664,783.0,833.6,782.0
694,沙糖桔,20231125,878,89,789,797.0,820.6,804.6
695,沙糖桔,20231126,996,139,857,878.0,855.4,840.4
696,沙糖桔,20231127,920,140,780,996.0,874.8,858.9
697,沙糖桔,20231128,819,162,657,920.0,882.0,866.3
698,沙糖桔,20231129,912,139,773,819.0,905.0,869.3
699,沙糖桔,20231130,840,137,703,912.0,897.4,859.0
700,沙糖桔,20231201,845,148,697,840.0,867.2,861.3
701,沙糖桔,20231202,837,110,727,845.0,850.6,862.7
702,沙糖桔,20231203,935,102,833,837.0,873.8,877.9
703,沙糖桔,20231204,834,144,690,935.0,858.2,881.6
704,沙糖桔,20231205,806,118,688,834.0,851.4,874.4
705,沙糖桔,20231206,912,157,755,806.0,864.8,866.0
706,沙糖桔,20231207,796,140,656,912.0,856.6,853.6
707,沙糖桔,20231208,774,137,637,796.0,824.4,849.1
708,沙糖桔,20231209,815,116,699,774.0,820.6,839.4
709,沙糖桔,20231210,944,102,842,815.0,848.2,849.8
710,沙糖桔,20231211,619,162,457,944.0,789.6,827.2
711,沙糖桔,20231212,524,148,376,619.0,735.2,795.9
712,沙糖桔,20231213,698,142,556,524.0,720.0,772.2
713,沙糖桔,20231214,738,146,592,698.0,704.6,762.6
714,沙糖桔,20231215,720,146,574,738.0,659.8,754.0
715,沙糖桔,20231216,636,93,543,720.0,663.2,726.4
716,沙糖桔,20231217,686,97,589,636.0,695.6,715.4
717,沙糖桔,20231218,734,148,586,686.0,702.8,711.4
718,沙糖桔,20231219,722,159,563,734.0,699.6,702.1
719,沙糖桔,20231220,754,168,586,722.0,706.4,683.1
720,沙糖桔,20231221,750,151,599,754.0,729.2,696.2
721,沙糖桔,20231222,669,116,553,750.0,725.8,710.7
722,沙糖桔,20231223,661,116,545,669.0,711.2,707.0
723,沙糖桔,20231224,790,116,674,661.0,724.8,712.2
724,沙糖桔,20231225,795,137,658,790.0,733.0,719.7
725,沙糖桔,20231226,798,139,659,795.0,742.6,735.9
726,沙糖桔,20231227,850,165,685,798.0,778.8,752.3
727,沙糖桔,20231228,891,125,766,850.0,824.8,768.0
728,沙糖桔,20231229,840,135,705,891.0,834.8,779.8
729,沙糖桔,20231230,821,91,730,840.0,840.0,786.5
730,沙糖桔,20231231,788,83,705,821.0,838.0,790.3
731,沙糖桔,20240101,873,91,782,788.0,842.6,810.7
732,沙糖桔,20240102,841,168,673,873.0,832.6,828.7
733,沙糖桔,20240103,1310,372,938,841.0,926.6,880.7
734,沙糖桔,20240104,1701,461,1240,1310.0,1102.6,971.3
735,沙糖桔,20240105,2136,512,1624,1701.0,1372.2,1105.1
736,沙糖桔,20240106,2077,264,1813,2136.0,1613.0,1227.8
737,沙糖桔,20240107,1978,211,1767,2077.0,1840.4,1336.5
738,沙糖桔,20240108,1706,330,1376,1978.0,1919.6,1423.1
739,沙糖桔,20240109,1242,279,963,1706.0,1827.8,1465.2
740,沙糖桔,20240110,1190,239,951,1242.0,1638.6,1505.4
741,沙糖桔,20240111,1111,204,907,1190.0,1445.4,1529.2
742,沙糖桔,20240112,1137,205,932,1111.0,1277.2,1558.8
743,沙糖桔,20240113,1082,144,938,1137.0,1152.4,1536.0
744,沙糖桔,20240114,1033,139,894,1082.0,1110.6,1469.2
745,沙糖桔,20240115,1040,176,864,1033.0,1080.6,1359.6
746,沙糖桔,20240116,1039,209,830,1040.0,1066.2,1255.8
747,沙糖桔,20240117,1028,165,863,1039.0,1044.4,1160.8
748,沙糖桔,20240118,1003,162,841,1028.0,1028.6,1090.5
749,沙糖桔,20240119,983,142,841,1003.0,1018.6,1064.6
750,沙糖桔,20240120,952,104,848,983.0,1001.0,1040.8
751,沙糖桔,20240121,953,110,843,952.0,983.8,1025.0
752,沙糖桔,20240122,835,157,678,953.0,945.2,994.8
753,沙糖桔,20240123,888,144,744,835.0,922.2,975.4
754,沙糖桔,20240124,909,125,784,888.0,907.4,963.0
755,沙糖桔,20240125,937,150,787,909.0,904.4,952.7
756,沙糖桔,20240126,946,139,807,937.0,903.0,943.4
757,沙糖桔,20240127,914,93,821,946.0,918.8,932.0
758,沙糖桔,20240128,967,112,855,914.0,934.6,928.4
759,沙糖桔,20240129,1010,163,847,967.0,954.8,931.1
760,沙糖桔,20240130,982,137,845,1010.0,963.8,934.1
761,沙糖桔,20240131,944,150,794,982.0,963.4,933.2
762,沙糖桔,20240201,1047,207,840,944.0,990.0,954.4
763,沙糖桔,20240202,996,148,848,1047.0,995.8,965.2
764,沙糖桔,20240203,964,108,856,996.0,986.6,970.7
765,沙糖桔,20240204,1009,152,857,964.0,992.0,977.9
766,沙糖桔,20240205,977,108,869,1009.0,998.6,981.0
767,沙糖桔,20240206,984,104,880,977.0,986.0,988.0
768,沙糖桔,20240207,1010,118,892,984.0,988.8,992.3
769,沙糖桔,20240208,1032,101,931,1010.0,1002.4,994.5
770,沙糖桔,20240209,951,66,885,1032.0,990.8,991.4
771,沙糖桔,20240210,926,72,854,951.0,980.6,989.6
772,沙糖桔,20240211,930,78,852,926.0,969.8,977.9
773,沙糖桔,20240212,909,64,845,930.0,949.6,969.2
774,沙糖桔,20240213,881,66,815,909.0,919.4,960.9
775,沙糖桔,20240214,869,83,786,881.0,903.0,946.9
776,沙糖桔,20240215,797,78,719,869.0,877.2,928.9
777,沙糖桔,20240216,816,93,723,797.0,854.4,912.1
778,沙糖桔,20240217,804,87,717,816.0,833.4,891.5
779,沙糖桔,20240218,828,125,703,804.0,822.8,871.1
780,沙糖桔,20240219,747,120,627,828.0,798.4,850.7
781,沙糖桔,20240220,650,99,551,747.0,769.0,823.1
782,沙糖桔,20240221,655,123,532,650.0,736.8,795.6
783,沙糖桔,20240222,658,104,554,655.0,707.6,770.5
784,沙糖桔,20240223,627,95,532,658.0,667.4,745.1
785,沙糖桔,20240224,629,80,549,627.0,643.8,721.1
786,沙糖桔,20240225,623,85,538,629.0,638.4,703.7
787,沙糖桔,20240226,547,102,445,623.0,616.8,676.8
788,沙糖桔,20240227,497,97,400,547.0,584.6,646.1
789,沙糖桔,20240228,492,106,386,497.0,557.6,612.5
790,沙糖桔,20240229,441,101,340,492.0,520.0,581.9
791,沙糖桔,20240301,401,87,314,441.0,475.6,557.0
792,沙糖桔,20240302,461,87,374,401.0,458.4,537.6
793,沙糖桔,20240303,432,70,362,461.0,445.4,515.0
794,沙糖桔,20240304,384,85,299,432.0,423.8,490.7
795,沙糖桔,20240305,408,101,307,384.0,417.2,468.6
796,沙糖桔,20240306,367,97,270,408.0,410.4,443.0
797,沙糖桔,20240307,351,74,277,367.0,388.4,423.4
798,沙糖桔,20240308,321,89,232,351.0,366.2,405.8
799,沙糖桔,20240309,305,66,239,321.0,350.4,387.1
800,沙糖桔,20240310,373,78,295,305.0,343.4,380.3
801,沙糖桔,20240311,323,78,245,373.0,334.6,372.5
802,沙糖桔,20240312,340,85,255,323.0,332.4,360.4
803,沙糖桔,20240313,317,83,234,340.0,331.6,348.9
804,沙糖桔,20240314,332,93,239,317.0,337.0,343.7
805,沙糖桔,20240315,303,72,231,332.0,323.0,333.2
806,沙糖桔,20240316,309,68,241,303.0,320.2,327.4
807,沙糖桔,20240317,288,61,227,309.0,309.8,321.1
808,沙糖桔,20240318,259,70,189,288.0,298.2,314.9
809,沙糖桔,20240319,311,93,218,259.0,294.0,315.5
810,沙糖桔,20240320,276,78,198,311.0,288.6,305.8
811,沙糖桔,20240321,287,76,211,276.0,284.2,302.2
812,沙糖桔,20240322,246,72,174,287.0,275.8,292.8
813,沙糖桔,20240323,263,63,200,246.0,276.6,287.4
814,沙糖桔,20240324,279,68,211,263.0,270.2,282.1
815,沙糖桔,20240325,253,76,177,279.0,265.6,277.1
816,沙糖桔,20240326,255,76,179,253.0,259.2,271.7
817,沙糖桔,20240327,248,80,168,255.0,259.6,267.7
818,沙糖桔,20240328,251,70,181,248.0,257.2,266.9
819,沙糖桔,20240329,259,80,179,251.0,253.2,261.7
820,沙糖桔,20240330,233,63,170,259.0,249.2,257.4
821,沙糖桔,20240331,182,0,182,233.0,234.6,246.9
822,沙糖桔,20240401,244,83,161,182.0,233.8,246.7
823,沙糖桔,20240402,248,72,176,244.0,233.2,245.2
824,沙糖桔,20240403,242,74,168,248.0,229.8,241.5
825,沙糖桔,20240404,219,64,155,242.0,227.0,238.1
826,沙糖桔,20240405,231,63,168,219.0,236.8,235.7
827,沙糖桔,20240406,254,70,184,231.0,238.8,236.3
828,沙糖桔,20240407,228,64,164,254.0,234.8,234.0
829,沙糖桔,20240408,225,64,161,228.0,231.4,230.6
830,沙糖桔,20240409,221,64,157,225.0,231.8,229.4
831,沙糖桔,20240410,236,70,166,221.0,232.8,234.8
832,沙糖桔,20240411,191,66,125,236.0,220.2,229.5
833,沙糖桔,20240412,259,70,189,191.0,226.4,230.6
834,沙糖桔,20240413,255,66,189,259.0,232.4,231.9
835,沙糖桔,20240414,230,70,160,255.0,234.2,233.0
836,沙糖桔,20240415,247,64,183,230.0,236.4,234.6
837,沙糖桔,20240416,231,63,168,247.0,244.4,232.3
838,沙糖桔,20240417,227,72,155,231.0,238.0,232.2
839,沙糖桔,20240418,248,85,163,227.0,236.6,234.5
840,沙糖桔,20240419,216,61,155,248.0,233.8,234.0
841,沙糖桔,20240420,224,57,167,216.0,229.2,232.8
842,沙糖桔,20240421,216,61,155,224.0,226.2,235.3
843,沙糖桔,20240422,227,64,163,216.0,226.2,232.1
844,沙糖桔,20240423,195,64,131,227.0,215.6,226.1
845,沙糖桔,20240424,213,66,147,195.0,215.0,224.4
846,沙糖桔,20240425,211,64,147,213.0,212.4,220.8
847,沙糖桔,20240426,207,68,139,211.0,210.6,218.4
848,沙糖桔,20240427,226,61,165,207.0,210.4,218.3
849,沙糖桔,20240428,197,74,123,226.0,210.8,213.2
850,沙糖桔,20240429,184,63,121,197.0,205.0,210.0
851,沙糖桔,20240430,208,57,151,184.0,204.4,208.4
639,沙糖桔,20231001,269,61,208,208.0,216.8,213.7
640,沙糖桔,20231002,275,63,212,269.0,226.6,218.5
641,沙糖桔,20231003,256,61,195,275.0,238.4,224.6
642,沙糖桔,20231004,281,66,215,256.0,257.8,231.4
643,沙糖桔,20231005,280,68,212,281.0,272.2,238.3
644,沙糖桔,20231006,314,66,248,280.0,281.2,249.0
645,沙糖桔,20231007,287,78,209,314.0,283.6,255.1
646,沙糖桔,20231008,316,89,227,287.0,295.6,267.0
647,沙糖桔,20231009,308,70,238,316.0,301.0,279.4
648,沙糖桔,20231010,325,70,255,308.0,310.0,291.1
649,沙糖桔,20231011,344,80,264,325.0,316.0,298.6
650,沙糖桔,20231012,335,87,248,344.0,325.6,304.6
651,沙糖桔,20231013,316,82,234,335.0,325.6,310.6
652,沙糖桔,20231014,336,63,273,316.0,331.2,316.1
653,沙糖桔,20231015,383,76,307,336.0,342.8,326.4
654,沙糖桔,20231016,388,85,303,383.0,351.6,333.8
655,沙糖桔,20231017,372,87,285,388.0,359.0,342.3
656,沙糖桔,20231018,378,91,287,372.0,371.4,348.5
657,沙糖桔,20231019,355,93,262,378.0,375.2,353.2
658,沙糖桔,20231020,331,93,238,355.0,364.8,353.8
659,沙糖桔,20231021,427,83,344,331.0,372.6,362.1
660,沙糖桔,20231022,407,74,333,427.0,379.6,369.3
661,沙糖桔,20231023,402,87,315,407.0,384.4,377.9
662,沙糖桔,20231024,370,76,294,402.0,387.4,381.3
663,沙糖桔,20231025,387,102,285,370.0,398.6,381.7
664,沙糖桔,20231026,353,87,266,387.0,383.8,378.2
665,沙糖桔,20231027,402,89,313,353.0,382.8,381.2
666,沙糖桔,20231028,449,82,367,402.0,392.2,388.3
667,沙糖桔,20231029,443,74,369,449.0,406.8,397.1
668,沙糖桔,20231030,404,95,309,443.0,410.2,404.4
669,沙糖桔,20231031,447,95,352,404.0,429.0,406.4
670,沙糖桔,20231101,519,114,405,447.0,452.4,417.6
671,沙糖桔,20231102,448,106,342,519.0,452.2,422.2
672,沙糖桔,20231103,498,97,401,448.0,463.2,435.0
673,沙糖桔,20231104,498,82,416,498.0,482.0,446.1
674,沙糖桔,20231105,468,95,373,498.0,486.2,457.6
675,沙糖桔,20231106,548,108,440,468.0,492.0,472.2
676,沙糖桔,20231107,513,97,416,548.0,505.0,478.6
677,沙糖桔,20231108,591,99,492,513.0,523.6,493.4
678,沙糖桔,20231109,584,116,468,591.0,540.8,511.4
679,沙糖桔,20231110,509,116,393,584.0,549.0,517.6
680,沙糖桔,20231111,523,87,436,509.0,544.0,518.0
681,沙糖桔,20231112,649,78,571,523.0,571.2,538.1
682,沙糖桔,20231113,549,112,437,649.0,562.8,543.2
683,沙糖桔,20231114,657,85,572,549.0,577.4,559.1
684,沙糖桔,20231115,652,133,519,657.0,606.0,577.5
685,沙糖桔,20231116,638,121,517,652.0,629.0,586.5
686,沙糖桔,20231117,735,104,631,638.0,646.2,608.7
687,沙糖桔,20231118,745,114,631,735.0,685.4,624.1
688,沙糖桔,20231119,882,82,800,745.0,730.4,653.9
689,沙糖桔,20231120,943,140,803,882.0,788.6,697.3
690,沙糖桔,20231121,822,116,706,943.0,825.4,727.2
691,沙糖桔,20231122,823,120,703,822.0,843.0,744.6
692,沙糖桔,20231123,783,116,667,823.0,850.6,768.0
693,沙糖桔,20231124,797,133,664,783.0,833.6,782.0
694,沙糖桔,20231125,878,89,789,797.0,820.6,804.6
695,沙糖桔,20231126,996,139,857,878.0,855.4,840.4
696,沙糖桔,20231127,920,140,780,996.0,874.8,858.9
697,沙糖桔,20231128,819,162,657,920.0,882.0,866.3
698,沙糖桔,20231129,912,139,773,819.0,905.0,869.3
699,沙糖桔,20231130,840,137,703,912.0,897.4,859.0
700,沙糖桔,20231201,845,148,697,840.0,867.2,861.3
701,沙糖桔,20231202,837,110,727,845.0,850.6,862.7
702,沙糖桔,20231203,935,102,833,837.0,873.8,877.9
703,沙糖桔,20231204,834,144,690,935.0,858.2,881.6
704,沙糖桔,20231205,806,118,688,834.0,851.4,874.4
705,沙糖桔,20231206,912,157,755,806.0,864.8,866.0
706,沙糖桔,20231207,796,140,656,912.0,856.6,853.6
707,沙糖桔,20231208,774,137,637,796.0,824.4,849.1
708,沙糖桔,20231209,815,116,699,774.0,820.6,839.4
709,沙糖桔,20231210,944,102,842,815.0,848.2,849.8
710,沙糖桔,20231211,619,162,457,944.0,789.6,827.2
711,沙糖桔,20231212,524,148,376,619.0,735.2,795.9
712,沙糖桔,20231213,698,142,556,524.0,720.0,772.2
713,沙糖桔,20231214,738,146,592,698.0,704.6,762.6
714,沙糖桔,20231215,720,146,574,738.0,659.8,754.0
715,沙糖桔,20231216,636,93,543,720.0,663.2,726.4
716,沙糖桔,20231217,686,97,589,636.0,695.6,715.4
717,沙糖桔,20231218,734,148,586,686.0,702.8,711.4
718,沙糖桔,20231219,722,159,563,734.0,699.6,702.1
719,沙糖桔,20231220,754,168,586,722.0,706.4,683.1
720,沙糖桔,20231221,750,151,599,754.0,729.2,696.2
721,沙糖桔,20231222,669,116,553,750.0,725.8,710.7
722,沙糖桔,20231223,661,116,545,669.0,711.2,707.0
723,沙糖桔,20231224,790,116,674,661.0,724.8,712.2
724,沙糖桔,20231225,795,137,658,790.0,733.0,719.7
725,沙糖桔,20231226,798,139,659,795.0,742.6,735.9
726,沙糖桔,20231227,850,165,685,798.0,778.8,752.3
727,沙糖桔,20231228,891,125,766,850.0,824.8,768.0
728,沙糖桔,20231229,840,135,705,891.0,834.8,779.8
729,沙糖桔,20231230,821,91,730,840.0,840.0,786.5
730,沙糖桔,20231231,788,83,705,821.0,838.0,790.3
731,沙糖桔,20240101,873,91,782,788.0,842.6,810.7
732,沙糖桔,20240102,841,168,673,873.0,832.6,828.7
733,沙糖桔,20240103,1310,372,938,841.0,926.6,880.7
734,沙糖桔,20240104,1701,461,1240,1310.0,1102.6,971.3
735,沙糖桔,20240105,2136,512,1624,1701.0,1372.2,1105.1
736,沙糖桔,20240106,2077,264,1813,2136.0,1613.0,1227.8
737,沙糖桔,20240107,1978,211,1767,2077.0,1840.4,1336.5
738,沙糖桔,20240108,1706,330,1376,1978.0,1919.6,1423.1
739,沙糖桔,20240109,1242,279,963,1706.0,1827.8,1465.2
740,沙糖桔,20240110,1190,239,951,1242.0,1638.6,1505.4
741,沙糖桔,20240111,1111,204,907,1190.0,1445.4,1529.2
742,沙糖桔,20240112,1137,205,932,1111.0,1277.2,1558.8
743,沙糖桔,20240113,1082,144,938,1137.0,1152.4,1536.0
744,沙糖桔,20240114,1033,139,894,1082.0,1110.6,1469.2
745,沙糖桔,20240115,1040,176,864,1033.0,1080.6,1359.6
746,沙糖桔,20240116,1039,209,830,1040.0,1066.2,1255.8
747,沙糖桔,20240117,1028,165,863,1039.0,1044.4,1160.8
748,沙糖桔,20240118,1003,162,841,1028.0,1028.6,1090.5
749,沙糖桔,20240119,983,142,841,1003.0,1018.6,1064.6
750,沙糖桔,20240120,952,104,848,983.0,1001.0,1040.8
751,沙糖桔,20240121,953,110,843,952.0,983.8,1025.0
752,沙糖桔,20240122,835,157,678,953.0,945.2,994.8
753,沙糖桔,20240123,888,144,744,835.0,922.2,975.4
754,沙糖桔,20240124,909,125,784,888.0,907.4,963.0
755,沙糖桔,20240125,937,150,787,909.0,904.4,952.7
756,沙糖桔,20240126,946,139,807,937.0,903.0,943.4
757,沙糖桔,20240127,914,93,821,946.0,918.8,932.0
758,沙糖桔,20240128,967,112,855,914.0,934.6,928.4
759,沙糖桔,20240129,1010,163,847,967.0,954.8,931.1
760,沙糖桔,20240130,982,137,845,1010.0,963.8,934.1
761,沙糖桔,20240131,944,150,794,982.0,963.4,933.2
762,沙糖桔,20240201,1047,207,840,944.0,990.0,954.4
763,沙糖桔,20240202,996,148,848,1047.0,995.8,965.2
764,沙糖桔,20240203,964,108,856,996.0,986.6,970.7
765,沙糖桔,20240204,1009,152,857,964.0,992.0,977.9
766,沙糖桔,20240205,977,108,869,1009.0,998.6,981.0
767,沙糖桔,20240206,984,104,880,977.0,986.0,988.0
768,沙糖桔,20240207,1010,118,892,984.0,988.8,992.3
769,沙糖桔,20240208,1032,101,931,1010.0,1002.4,994.5
770,沙糖桔,20240209,951,66,885,1032.0,990.8,991.4
771,沙糖桔,20240210,926,72,854,951.0,980.6,989.6
772,沙糖桔,20240211,930,78,852,926.0,969.8,977.9
773,沙糖桔,20240212,909,64,845,930.0,949.6,969.2
774,沙糖桔,20240213,881,66,815,909.0,919.4,960.9
775,沙糖桔,20240214,869,83,786,881.0,903.0,946.9
776,沙糖桔,20240215,797,78,719,869.0,877.2,928.9
777,沙糖桔,20240216,816,93,723,797.0,854.4,912.1
778,沙糖桔,20240217,804,87,717,816.0,833.4,891.5
779,沙糖桔,20240218,828,125,703,804.0,822.8,871.1
780,沙糖桔,20240219,747,120,627,828.0,798.4,850.7
781,沙糖桔,20240220,650,99,551,747.0,769.0,823.1
782,沙糖桔,20240221,655,123,532,650.0,736.8,795.6
783,沙糖桔,20240222,658,104,554,655.0,707.6,770.5
784,沙糖桔,20240223,627,95,532,658.0,667.4,745.1
785,沙糖桔,20240224,629,80,549,627.0,643.8,721.1
786,沙糖桔,20240225,623,85,538,629.0,638.4,703.7
787,沙糖桔,20240226,547,102,445,623.0,616.8,676.8
788,沙糖桔,20240227,497,97,400,547.0,584.6,646.1
789,沙糖桔,20240228,492,106,386,497.0,557.6,612.5
790,沙糖桔,20240229,441,101,340,492.0,520.0,581.9
791,沙糖桔,20240301,401,87,314,441.0,475.6,557.0
792,沙糖桔,20240302,461,87,374,401.0,458.4,537.6
793,沙糖桔,20240303,432,70,362,461.0,445.4,515.0
794,沙糖桔,20240304,384,85,299,432.0,423.8,490.7
795,沙糖桔,20240305,408,101,307,384.0,417.2,468.6
796,沙糖桔,20240306,367,97,270,408.0,410.4,443.0
797,沙糖桔,20240307,351,74,277,367.0,388.4,423.4
798,沙糖桔,20240308,321,89,232,351.0,366.2,405.8
799,沙糖桔,20240309,305,66,239,321.0,350.4,387.1
800,沙糖桔,20240310,373,78,295,305.0,343.4,380.3
801,沙糖桔,20240311,323,78,245,373.0,334.6,372.5
802,沙糖桔,20240312,340,85,255,323.0,332.4,360.4
803,沙糖桔,20240313,317,83,234,340.0,331.6,348.9
804,沙糖桔,20240314,332,93,239,317.0,337.0,343.7
805,沙糖桔,20240315,303,72,231,332.0,323.0,333.2
806,沙糖桔,20240316,309,68,241,303.0,320.2,327.4
807,沙糖桔,20240317,288,61,227,309.0,309.8,321.1
808,沙糖桔,20240318,259,70,189,288.0,298.2,314.9
809,沙糖桔,20240319,311,93,218,259.0,294.0,315.5
810,沙糖桔,20240320,276,78,198,311.0,288.6,305.8
811,沙糖桔,20240321,287,76,211,276.0,284.2,302.2
812,沙糖桔,20240322,246,72,174,287.0,275.8,292.8
813,沙糖桔,20240323,263,63,200,246.0,276.6,287.4
814,沙糖桔,20240324,279,68,211,263.0,270.2,282.1
815,沙糖桔,20240325,253,76,177,279.0,265.6,277.1
816,沙糖桔,20240326,255,76,179,253.0,259.2,271.7
817,沙糖桔,20240327,248,80,168,255.0,259.6,267.7
818,沙糖桔,20240328,251,70,181,248.0,257.2,266.9
819,沙糖桔,20240329,259,80,179,251.0,253.2,261.7
820,沙糖桔,20240330,233,63,170,259.0,249.2,257.4
821,沙糖桔,20240331,182,0,182,233.0,234.6,246.9
822,沙糖桔,20240401,244,83,161,182.0,233.8,246.7
823,沙糖桔,20240402,248,72,176,244.0,233.2,245.2
824,沙糖桔,20240403,242,74,168,248.0,229.8,241.5
825,沙糖桔,20240404,219,64,155,242.0,227.0,238.1
826,沙糖桔,20240405,231,63,168,219.0,236.8,235.7
827,沙糖桔,20240406,254,70,184,231.0,238.8,236.3
828,沙糖桔,20240407,228,64,164,254.0,234.8,234.0
829,沙糖桔,20240408,225,64,161,228.0,231.4,230.6
830,沙糖桔,20240409,221,64,157,225.0,231.8,229.4
831,沙糖桔,20240410,236,70,166,221.0,232.8,234.8
832,沙糖桔,20240411,191,66,125,236.0,220.2,229.5
833,沙糖桔,20240412,259,70,189,191.0,226.4,230.6
834,沙糖桔,20240413,255,66,189,259.0,232.4,231.9
835,沙糖桔,20240414,230,70,160,255.0,234.2,233.0
836,沙糖桔,20240415,247,64,183,230.0,236.4,234.6
837,沙糖桔,20240416,231,63,168,247.0,244.4,232.3
838,沙糖桔,20240417,227,72,155,231.0,238.0,232.2
839,沙糖桔,20240418,248,85,163,227.0,236.6,234.5
840,沙糖桔,20240419,216,61,155,248.0,233.8,234.0
841,沙糖桔,20240420,224,57,167,216.0,229.2,232.8
842,沙糖桔,20240421,216,61,155,224.0,226.2,235.3
843,沙糖桔,20240422,227,64,163,216.0,226.2,232.1
844,沙糖桔,20240423,195,64,131,227.0,215.6,226.1
845,沙糖桔,20240424,213,66,147,195.0,215.0,224.4
846,沙糖桔,20240425,211,64,147,213.0,212.4,220.8
847,沙糖桔,20240426,207,68,139,211.0,210.6,218.4
848,沙糖桔,20240427,226,61,165,207.0,210.4,218.3
849,沙糖桔,20240428,197,74,123,226.0,210.8,213.2
850,沙糖桔,20240429,184,63,121,197.0,205.0,210.0
851,沙糖桔,20240430,208,57,151,184.0,204.4,208.4
1,小土豆,20220101,0,0,0,208.0,163.0,186.8
2,小土豆,20220102,0,0,0,0.0,117.8,164.1
3,小土豆,20220103,0,0,0,0.0,78.4,144.6
4,小土豆,20220104,0,0,0,0.0,41.6,123.3
5,小土豆,20220105,0,0,0,0.0,0.0,102.2
6,小土豆,20220106,0,0,0,0.0,0.0,81.5
7,小土豆,20220107,0,0,0,0.0,0.0,58.9
8,小土豆,20220108,0,0,0,0.0,0.0,39.2
9,小土豆,20220109,0,0,0,0.0,0.0,20.8
10,小土豆,20220110,0,0,0,0.0,0.0,0.0
11,小土豆,20220111,0,0,0,0.0,0.0,0.0
12,小土豆,20220112,0,0,0,0.0,0.0,0.0
13,小土豆,20220113,0,0,0,0.0,0.0,0.0
14,小土豆,20220114,0,0,0,0.0,0.0,0.0
15,小土豆,20220115,0,0,0,0.0,0.0,0.0
16,小土豆,20220116,0,0,0,0.0,0.0,0.0
17,小土豆,20220117,0,0,0,0.0,0.0,0.0
18,小土豆,20220118,0,0,0,0.0,0.0,0.0
19,小土豆,20220119,0,0,0,0.0,0.0,0.0
20,小土豆,20220120,0,0,0,0.0,0.0,0.0
21,小土豆,20220121,0,0,0,0.0,0.0,0.0
22,小土豆,20220122,0,0,0,0.0,0.0,0.0
23,小土豆,20220123,0,0,0,0.0,0.0,0.0
24,小土豆,20220124,0,0,0,0.0,0.0,0.0
25,小土豆,20220125,0,0,0,0.0,0.0,0.0
26,小土豆,20220126,0,0,0,0.0,0.0,0.0
27,小土豆,20220127,0,0,0,0.0,0.0,0.0
28,小土豆,20220128,0,0,0,0.0,0.0,0.0
29,小土豆,20220129,0,0,0,0.0,0.0,0.0
30,小土豆,20220130,0,0,0,0.0,0.0,0.0
31,小土豆,20220131,0,0,0,0.0,0.0,0.0
32,小土豆,20220201,0,0,0,0.0,0.0,0.0
33,小土豆,20220202,0,0,0,0.0,0.0,0.0
34,小土豆,20220203,0,0,0,0.0,0.0,0.0
35,小土豆,20220204,0,0,0,0.0,0.0,0.0
36,小土豆,20220205,0,0,0,0.0,0.0,0.0
37,小土豆,20220206,0,0,0,0.0,0.0,0.0
38,小土豆,20220207,0,0,0,0.0,0.0,0.0
39,小土豆,20220208,0,0,0,0.0,0.0,0.0
40,小土豆,20220209,0,0,0,0.0,0.0,0.0
41,小土豆,20220210,0,0,0,0.0,0.0,0.0
42,小土豆,20220211,0,0,0,0.0,0.0,0.0
43,小土豆,20220212,0,0,0,0.0,0.0,0.0
44,小土豆,20220213,0,0,0,0.0,0.0,0.0
45,小土豆,20220214,0,0,0,0.0,0.0,0.0
46,小土豆,20220215,0,0,0,0.0,0.0,0.0
47,小土豆,20220216,0,0,0,0.0,0.0,0.0
48,小土豆,20220217,0,0,0,0.0,0.0,0.0
49,小土豆,20220218,0,0,0,0.0,0.0,0.0
50,小土豆,20220219,0,0,0,0.0,0.0,0.0
51,小土豆,20220220,0,0,0,0.0,0.0,0.0
52,小土豆,20220221,0,0,0,0.0,0.0,0.0
53,小土豆,20220222,0,0,0,0.0,0.0,0.0
54,小土豆,20220223,0,0,0,0.0,0.0,0.0
55,小土豆,20220224,0,0,0,0.0,0.0,0.0
56,小土豆,20220225,0,0,0,0.0,0.0,0.0
57,小土豆,20220226,0,0,0,0.0,0.0,0.0
58,小土豆,20220227,0,0,0,0.0,0.0,0.0
59,小土豆,20220228,0,0,0,0.0,0.0,0.0
60,小土豆,20220301,0,0,0,0.0,0.0,0.0
61,小土豆,20220302,0,0,0,0.0,0.0,0.0
62,小土豆,20220303,0,0,0,0.0,0.0,0.0
63,小土豆,20220304,0,0,0,0.0,0.0,0.0
64,小土豆,20220305,0,0,0,0.0,0.0,0.0
65,小土豆,20220306,0,0,0,0.0,0.0,0.0
66,小土豆,20220307,0,0,0,0.0,0.0,0.0
67,小土豆,20220308,0,0,0,0.0,0.0,0.0
68,小土豆,20220309,0,0,0,0.0,0.0,0.0
69,小土豆,20220310,0,0,0,0.0,0.0,0.0
70,小土豆,20220311,0,0,0,0.0,0.0,0.0
71,小土豆,20220312,0,0,0,0.0,0.0,0.0
72,小土豆,20220313,0,0,0,0.0,0.0,0.0
73,小土豆,20220314,0,0,0,0.0,0.0,0.0
74,小土豆,20220315,0,0,0,0.0,0.0,0.0
75,小土豆,20220316,0,0,0,0.0,0.0,0.0
76,小土豆,20220317,0,0,0,0.0,0.0,0.0
77,小土豆,20220318,0,0,0,0.0,0.0,0.0
78,小土豆,20220319,0,0,0,0.0,0.0,0.0
79,小土豆,20220320,0,0,0,0.0,0.0,0.0
80,小土豆,20220321,0,0,0,0.0,0.0,0.0
81,小土豆,20220322,0,0,0,0.0,0.0,0.0
82,小土豆,20220323,0,0,0,0.0,0.0,0.0
83,小土豆,20220324,0,0,0,0.0,0.0,0.0
84,小土豆,20220325,0,0,0,0.0,0.0,0.0
85,小土豆,20220326,0,0,0,0.0,0.0,0.0
86,小土豆,20220327,0,0,0,0.0,0.0,0.0
87,小土豆,20220328,0,0,0,0.0,0.0,0.0
88,小土豆,20220329,0,0,0,0.0,0.0,0.0
89,小土豆,20220330,0,0,0,0.0,0.0,0.0
90,小土豆,20220331,0,0,0,0.0,0.0,0.0
91,小土豆,20220401,0,0,0,0.0,0.0,0.0
92,小土豆,20220402,0,0,0,0.0,0.0,0.0
93,小土豆,20220403,0,0,0,0.0,0.0,0.0
94,小土豆,20220404,0,0,0,0.0,0.0,0.0
95,小土豆,20220405,0,0,0,0.0,0.0,0.0
96,小土豆,20220406,0,0,0,0.0,0.0,0.0
97,小土豆,20220407,0,0,0,0.0,0.0,0.0
98,小土豆,20220408,0,0,0,0.0,0.0,0.0
99,小土豆,20220409,0,0,0,0.0,0.0,0.0
100,小土豆,20220410,0,0,0,0.0,0.0,0.0
101,小土豆,20220411,0,0,0,0.0,0.0,0.0
102,小土豆,20220412,0,0,0,0.0,0.0,0.0
103,小土豆,20220413,0,0,0,0.0,0.0,0.0
104,小土豆,20220414,0,0,0,0.0,0.0,0.0
105,小土豆,20220415,0,0,0,0.0,0.0,0.0
106,小土豆,20220416,0,0,0,0.0,0.0,0.0
107,小土豆,20220417,0,0,0,0.0,0.0,0.0
108,小土豆,20220418,0,0,0,0.0,0.0,0.0
109,小土豆,20220419,0,0,0,0.0,0.0,0.0
110,小土豆,20220420,0,0,0,0.0,0.0,0.0
111,小土豆,20220421,0,0,0,0.0,0.0,0.0
112,小土豆,20220422,0,0,0,0.0,0.0,0.0
113,小土豆,20220423,0,0,0,0.0,0.0,0.0
114,小土豆,20220424,0,0,0,0.0,0.0,0.0
115,小土豆,20220425,0,0,0,0.0,0.0,0.0
116,小土豆,20220426,0,0,0,0.0,0.0,0.0
117,小土豆,20220427,0,0,0,0.0,0.0,0.0
118,小土豆,20220428,0,0,0,0.0,0.0,0.0
119,小土豆,20220429,0,0,0,0.0,0.0,0.0
120,小土豆,20220430,0,0,0,0.0,0.0,0.0
121,小土豆,20220501,0,0,0,0.0,0.0,0.0
122,小土豆,20220502,0,0,0,0.0,0.0,0.0
123,小土豆,20220503,0,0,0,0.0,0.0,0.0
124,小土豆,20220504,0,0,0,0.0,0.0,0.0
125,小土豆,20220505,0,0,0,0.0,0.0,0.0
126,小土豆,20220506,0,0,0,0.0,0.0,0.0
127,小土豆,20220507,0,0,0,0.0,0.0,0.0
128,小土豆,20220508,0,0,0,0.0,0.0,0.0
129,小土豆,20220509,0,0,0,0.0,0.0,0.0
130,小土豆,20220510,0,0,0,0.0,0.0,0.0
131,小土豆,20220511,0,0,0,0.0,0.0,0.0
132,小土豆,20220512,0,0,0,0.0,0.0,0.0
133,小土豆,20220513,0,0,0,0.0,0.0,0.0
134,小土豆,20220514,0,0,0,0.0,0.0,0.0
135,小土豆,20220515,0,0,0,0.0,0.0,0.0
136,小土豆,20220516,0,0,0,0.0,0.0,0.0
137,小土豆,20220517,0,0,0,0.0,0.0,0.0
138,小土豆,20220518,0,0,0,0.0,0.0,0.0
139,小土豆,20220519,0,0,0,0.0,0.0,0.0
140,小土豆,20220520,0,0,0,0.0,0.0,0.0
141,小土豆,20220521,0,0,0,0.0,0.0,0.0
142,小土豆,20220522,0,0,0,0.0,0.0,0.0
143,小土豆,20220523,0,0,0,0.0,0.0,0.0
144,小土豆,20220524,0,0,0,0.0,0.0,0.0
145,小土豆,20220525,0,0,0,0.0,0.0,0.0
146,小土豆,20220526,0,0,0,0.0,0.0,0.0
147,小土豆,20220527,0,0,0,0.0,0.0,0.0
148,小土豆,20220528,0,0,0,0.0,0.0,0.0
149,小土豆,20220529,0,0,0,0.0,0.0,0.0
150,小土豆,20220530,0,0,0,0.0,0.0,0.0
151,小土豆,20220531,0,0,0,0.0,0.0,0.0
152,小土豆,20220601,0,0,0,0.0,0.0,0.0
153,小土豆,20220602,0,0,0,0.0,0.0,0.0
154,小土豆,20220603,0,0,0,0.0,0.0,0.0
155,小土豆,20220604,0,0,0,0.0,0.0,0.0
156,小土豆,20220605,0,0,0,0.0,0.0,0.0
157,小土豆,20220606,0,0,0,0.0,0.0,0.0
158,小土豆,20220607,0,0,0,0.0,0.0,0.0
159,小土豆,20220608,0,0,0,0.0,0.0,0.0
160,小土豆,20220609,0,0,0,0.0,0.0,0.0
161,小土豆,20220610,0,0,0,0.0,0.0,0.0
162,小土豆,20220611,0,0,0,0.0,0.0,0.0
163,小土豆,20220612,0,0,0,0.0,0.0,0.0
164,小土豆,20220613,0,0,0,0.0,0.0,0.0
165,小土豆,20220614,0,0,0,0.0,0.0,0.0
166,小土豆,20220615,0,0,0,0.0,0.0,0.0
167,小土豆,20220616,0,0,0,0.0,0.0,0.0
168,小土豆,20220617,0,0,0,0.0,0.0,0.0
169,小土豆,20220618,0,0,0,0.0,0.0,0.0
170,小土豆,20220619,0,0,0,0.0,0.0,0.0
171,小土豆,20220620,0,0,0,0.0,0.0,0.0
172,小土豆,20220621,0,0,0,0.0,0.0,0.0
173,小土豆,20220622,0,0,0,0.0,0.0,0.0
174,小土豆,20220623,0,0,0,0.0,0.0,0.0
175,小土豆,20220624,0,0,0,0.0,0.0,0.0
176,小土豆,20220625,0,0,0,0.0,0.0,0.0
177,小土豆,20220626,0,0,0,0.0,0.0,0.0
178,小土豆,20220627,0,0,0,0.0,0.0,0.0
179,小土豆,20220628,0,0,0,0.0,0.0,0.0
180,小土豆,20220629,0,0,0,0.0,0.0,0.0
181,小土豆,20220630,0,0,0,0.0,0.0,0.0
182,小土豆,20220701,0,0,0,0.0,0.0,0.0
183,小土豆,20220702,0,0,0,0.0,0.0,0.0
184,小土豆,20220703,0,0,0,0.0,0.0,0.0
185,小土豆,20220704,0,0,0,0.0,0.0,0.0
186,小土豆,20220705,0,0,0,0.0,0.0,0.0
187,小土豆,20220706,0,0,0,0.0,0.0,0.0
188,小土豆,20220707,0,0,0,0.0,0.0,0.0
189,小土豆,20220708,0,0,0,0.0,0.0,0.0
190,小土豆,20220709,0,0,0,0.0,0.0,0.0
191,小土豆,20220710,0,0,0,0.0,0.0,0.0
192,小土豆,20220711,0,0,0,0.0,0.0,0.0
193,小土豆,20220712,0,0,0,0.0,0.0,0.0
194,小土豆,20220713,0,0,0,0.0,0.0,0.0
195,小土豆,20220714,0,0,0,0.0,0.0,0.0
196,小土豆,20220715,0,0,0,0.0,0.0,0.0
197,小土豆,20220716,0,0,0,0.0,0.0,0.0
198,小土豆,20220717,0,0,0,0.0,0.0,0.0
199,小土豆,20220718,0,0,0,0.0,0.0,0.0
200,小土豆,20220719,0,0,0,0.0,0.0,0.0
201,小土豆,20220720,0,0,0,0.0,0.0,0.0
202,小土豆,20220721,0,0,0,0.0,0.0,0.0
203,小土豆,20220722,0,0,0,0.0,0.0,0.0
204,小土豆,20220723,0,0,0,0.0,0.0,0.0
205,小土豆,20220724,0,0,0,0.0,0.0,0.0
206,小土豆,20220725,0,0,0,0.0,0.0,0.0
207,小土豆,20220726,0,0,0,0.0,0.0,0.0
208,小土豆,20220727,0,0,0,0.0,0.0,0.0
209,小土豆,20220728,0,0,0,0.0,0.0,0.0
210,小土豆,20220729,0,0,0,0.0,0.0,0.0
211,小土豆,20220730,0,0,0,0.0,0.0,0.0
212,小土豆,20220731,0,0,0,0.0,0.0,0.0
213,小土豆,20220801,0,0,0,0.0,0.0,0.0
214,小土豆,20220802,0,0,0,0.0,0.0,0.0
215,小土豆,20220803,0,0,0,0.0,0.0,0.0
216,小土豆,20220804,0,0,0,0.0,0.0,0.0
217,小土豆,20220805,0,0,0,0.0,0.0,0.0
218,小土豆,20220806,0,0,0,0.0,0.0,0.0
219,小土豆,20220807,0,0,0,0.0,0.0,0.0
220,小土豆,20220808,0,0,0,0.0,0.0,0.0
221,小土豆,20220809,0,0,0,0.0,0.0,0.0
222,小土豆,20220810,0,0,0,0.0,0.0,0.0
223,小土豆,20220811,0,0,0,0.0,0.0,0.0
224,小土豆,20220812,0,0,0,0.0,0.0,0.0
225,小土豆,20220813,0,0,0,0.0,0.0,0.0
226,小土豆,20220814,0,0,0,0.0,0.0,0.0
227,小土豆,20220815,0,0,0,0.0,0.0,0.0
228,小土豆,20220816,0,0,0,0.0,0.0,0.0
229,小土豆,20220817,0,0,0,0.0,0.0,0.0
230,小土豆,20220818,0,0,0,0.0,0.0,0.0
231,小土豆,20220819,0,0,0,0.0,0.0,0.0
232,小土豆,20220820,0,0,0,0.0,0.0,0.0
233,小土豆,20220821,0,0,0,0.0,0.0,0.0
234,小土豆,20220822,0,0,0,0.0,0.0,0.0
235,小土豆,20220823,0,0,0,0.0,0.0,0.0
236,小土豆,20220824,0,0,0,0.0,0.0,0.0
237,小土豆,20220825,0,0,0,0.0,0.0,0.0
238,小土豆,20220826,0,0,0,0.0,0.0,0.0
239,小土豆,20220827,0,0,0,0.0,0.0,0.0
240,小土豆,20220828,0,0,0,0.0,0.0,0.0
241,小土豆,20220829,0,0,0,0.0,0.0,0.0
242,小土豆,20220830,0,0,0,0.0,0.0,0.0
243,小土豆,20220831,0,0,0,0.0,0.0,0.0
244,小土豆,20220901,0,0,0,0.0,0.0,0.0
245,小土豆,20220902,0,0,0,0.0,0.0,0.0
246,小土豆,20220903,0,0,0,0.0,0.0,0.0
247,小土豆,20220904,0,0,0,0.0,0.0,0.0
248,小土豆,20220905,0,0,0,0.0,0.0,0.0
249,小土豆,20220906,0,0,0,0.0,0.0,0.0
250,小土豆,20220907,0,0,0,0.0,0.0,0.0
251,小土豆,20220908,0,0,0,0.0,0.0,0.0
252,小土豆,20220909,0,0,0,0.0,0.0,0.0
253,小土豆,20220910,0,0,0,0.0,0.0,0.0
254,小土豆,20220911,0,0,0,0.0,0.0,0.0
255,小土豆,20220912,0,0,0,0.0,0.0,0.0
256,小土豆,20220913,0,0,0,0.0,0.0,0.0
257,小土豆,20220914,0,0,0,0.0,0.0,0.0
258,小土豆,20220915,0,0,0,0.0,0.0,0.0
259,小土豆,20220916,0,0,0,0.0,0.0,0.0
260,小土豆,20220917,0,0,0,0.0,0.0,0.0
261,小土豆,20220918,0,0,0,0.0,0.0,0.0
262,小土豆,20220919,0,0,0,0.0,0.0,0.0
263,小土豆,20220920,0,0,0,0.0,0.0,0.0
264,小土豆,20220921,0,0,0,0.0,0.0,0.0
265,小土豆,20220922,0,0,0,0.0,0.0,0.0
266,小土豆,20220923,0,0,0,0.0,0.0,0.0
267,小土豆,20220924,0,0,0,0.0,0.0,0.0
268,小土豆,20220925,0,0,0,0.0,0.0,0.0
269,小土豆,20220926,0,0,0,0.0,0.0,0.0
270,小土豆,20220927,0,0,0,0.0,0.0,0.0
271,小土豆,20220928,0,0,0,0.0,0.0,0.0
272,小土豆,20220929,0,0,0,0.0,0.0,0.0
273,小土豆,20220930,0,0,0,0.0,0.0,0.0
274,小土豆,20221001,0,0,0,0.0,0.0,0.0
275,小土豆,20221002,0,0,0,0.0,0.0,0.0
276,小土豆,20221003,0,0,0,0.0,0.0,0.0
277,小土豆,20221004,0,0,0,0.0,0.0,0.0
278,小土豆,20221005,0,0,0,0.0,0.0,0.0
279,小土豆,20221006,0,0,0,0.0,0.0,0.0
280,小土豆,20221007,0,0,0,0.0,0.0,0.0
281,小土豆,20221008,0,0,0,0.0,0.0,0.0
282,小土豆,20221009,0,0,0,0.0,0.0,0.0
283,小土豆,20221010,0,0,0,0.0,0.0,0.0
284,小土豆,20221011,0,0,0,0.0,0.0,0.0
285,小土豆,20221012,0,0,0,0.0,0.0,0.0
286,小土豆,20221013,0,0,0,0.0,0.0,0.0
287,小土豆,20221014,0,0,0,0.0,0.0,0.0
288,小土豆,20221015,0,0,0,0.0,0.0,0.0
289,小土豆,20221016,0,0,0,0.0,0.0,0.0
290,小土豆,20221017,0,0,0,0.0,0.0,0.0
291,小土豆,20221018,0,0,0,0.0,0.0,0.0
292,小土豆,20221019,0,0,0,0.0,0.0,0.0
293,小土豆,20221020,0,0,0,0.0,0.0,0.0
294,小土豆,20221021,0,0,0,0.0,0.0,0.0
295,小土豆,20221022,0,0,0,0.0,0.0,0.0
296,小土豆,20221023,0,0,0,0.0,0.0,0.0
297,小土豆,20221024,0,0,0,0.0,0.0,0.0
298,小土豆,20221025,0,0,0,0.0,0.0,0.0
299,小土豆,20221026,0,0,0,0.0,0.0,0.0
300,小土豆,20221027,0,0,0,0.0,0.0,0.0
301,小土豆,20221028,0,0,0,0.0,0.0,0.0
302,小土豆,20221029,0,0,0,0.0,0.0,0.0
303,小土豆,20221030,0,0,0,0.0,0.0,0.0
304,小土豆,20221031,0,0,0,0.0,0.0,0.0
305,小土豆,20221101,0,0,0,0.0,0.0,0.0
306,小土豆,20221102,0,0,0,0.0,0.0,0.0
307,小土豆,20221103,0,0,0,0.0,0.0,0.0
308,小土豆,20221104,0,0,0,0.0,0.0,0.0
309,小土豆,20221105,0,0,0,0.0,0.0,0.0
310,小土豆,20221106,0,0,0,0.0,0.0,0.0
311,小土豆,20221107,0,0,0,0.0,0.0,0.0
312,小土豆,20221108,0,0,0,0.0,0.0,0.0
313,小土豆,20221109,0,0,0,0.0,0.0,0.0
314,小土豆,20221110,0,0,0,0.0,0.0,0.0
315,小土豆,20221111,0,0,0,0.0,0.0,0.0
316,小土豆,20221112,0,0,0,0.0,0.0,0.0
317,小土豆,20221113,0,0,0,0.0,0.0,0.0
318,小土豆,20221114,0,0,0,0.0,0.0,0.0
319,小土豆,20221115,0,0,0,0.0,0.0,0.0
320,小土豆,20221116,0,0,0,0.0,0.0,0.0
321,小土豆,20221117,0,0,0,0.0,0.0,0.0
322,小土豆,20221118,0,0,0,0.0,0.0,0.0
323,小土豆,20221119,0,0,0,0.0,0.0,0.0
324,小土豆,20221120,0,0,0,0.0,0.0,0.0
325,小土豆,20221121,0,0,0,0.0,0.0,0.0
326,小土豆,20221122,0,0,0,0.0,0.0,0.0
327,小土豆,20221123,0,0,0,0.0,0.0,0.0
328,小土豆,20221124,0,0,0,0.0,0.0,0.0
329,小土豆,20221125,0,0,0,0.0,0.0,0.0
330,小土豆,20221126,0,0,0,0.0,0.0,0.0
331,小土豆,20221127,0,0,0,0.0,0.0,0.0
332,小土豆,20221128,0,0,0,0.0,0.0,0.0
333,小土豆,20221129,0,0,0,0.0,0.0,0.0
334,小土豆,20221130,0,0,0,0.0,0.0,0.0
335,小土豆,20221201,0,0,0,0.0,0.0,0.0
336,小土豆,20221202,0,0,0,0.0,0.0,0.0
337,小土豆,20221203,0,0,0,0.0,0.0,0.0
338,小土豆,20221204,0,0,0,0.0,0.0,0.0
339,小土豆,20221205,0,0,0,0.0,0.0,0.0
340,小土豆,20221206,0,0,0,0.0,0.0,0.0
341,小土豆,20221207,0,0,0,0.0,0.0,0.0
342,小土豆,20221208,0,0,0,0.0,0.0,0.0
343,小土豆,20221209,0,0,0,0.0,0.0,0.0
344,小土豆,20221210,0,0,0,0.0,0.0,0.0
345,小土豆,20221211,0,0,0,0.0,0.0,0.0
346,小土豆,20221212,0,0,0,0.0,0.0,0.0
347,小土豆,20221213,0,0,0,0.0,0.0,0.0
348,小土豆,20221214,0,0,0,0.0,0.0,0.0
349,小土豆,20221215,0,0,0,0.0,0.0,0.0
350,小土豆,20221216,0,0,0,0.0,0.0,0.0
351,小土豆,20221217,0,0,0,0.0,0.0,0.0
352,小土豆,20221218,0,0,0,0.0,0.0,0.0
353,小土豆,20221219,0,0,0,0.0,0.0,0.0
354,小土豆,20221220,0,0,0,0.0,0.0,0.0
355,小土豆,20221221,0,0,0,0.0,0.0,0.0
356,小土豆,20221222,0,0,0,0.0,0.0,0.0
357,小土豆,20221223,0,0,0,0.0,0.0,0.0
358,小土豆,20221224,0,0,0,0.0,0.0,0.0
359,小土豆,20221225,0,0,0,0.0,0.0,0.0
360,小土豆,20221226,0,0,0,0.0,0.0,0.0
361,小土豆,20221227,0,0,0,0.0,0.0,0.0
362,小土豆,20221228,0,0,0,0.0,0.0,0.0
363,小土豆,20221229,0,0,0,0.0,0.0,0.0
364,小土豆,20221230,0,0,0,0.0,0.0,0.0
365,小土豆,20221231,0,0,0,0.0,0.0,0.0
366,小土豆,20230101,0,0,0,0.0,0.0,0.0
367,小土豆,20230102,0,0,0,0.0,0.0,0.0
368,小土豆,20230103,0,0,0,0.0,0.0,0.0
369,小土豆,20230104,0,0,0,0.0,0.0,0.0
370,小土豆,20230105,0,0,0,0.0,0.0,0.0
371,小土豆,20230106,0,0,0,0.0,0.0,0.0
372,小土豆,20230107,0,0,0,0.0,0.0,0.0
373,小土豆,20230108,0,0,0,0.0,0.0,0.0
374,小土豆,20230109,0,0,0,0.0,0.0,0.0
375,小土豆,20230110,0,0,0,0.0,0.0,0.0
376,小土豆,20230111,0,0,0,0.0,0.0,0.0
377,小土豆,20230112,0,0,0,0.0,0.0,0.0
378,小土豆,20230113,0,0,0,0.0,0.0,0.0
379,小土豆,20230114,0,0,0,0.0,0.0,0.0
380,小土豆,20230115,0,0,0,0.0,0.0,0.0
381,小土豆,20230116,0,0,0,0.0,0.0,0.0
382,小土豆,20230117,0,0,0,0.0,0.0,0.0
383,小土豆,20230118,0,0,0,0.0,0.0,0.0
384,小土豆,20230119,0,0,0,0.0,0.0,0.0
385,小土豆,20230120,0,0,0,0.0,0.0,0.0
386,小土豆,20230121,0,0,0,0.0,0.0,0.0
387,小土豆,20230122,0,0,0,0.0,0.0,0.0
388,小土豆,20230123,0,0,0,0.0,0.0,0.0
389,小土豆,20230124,0,0,0,0.0,0.0,0.0
390,小土豆,20230125,0,0,0,0.0,0.0,0.0
391,小土豆,20230126,0,0,0,0.0,0.0,0.0
392,小土豆,20230127,0,0,0,0.0,0.0,0.0
393,小土豆,20230128,0,0,0,0.0,0.0,0.0
394,小土豆,20230129,0,0,0,0.0,0.0,0.0
395,小土豆,20230130,0,0,0,0.0,0.0,0.0
396,小土豆,20230131,0,0,0,0.0,0.0,0.0
397,小土豆,20230201,0,0,0,0.0,0.0,0.0
398,小土豆,20230202,0,0,0,0.0,0.0,0.0
399,小土豆,20230203,0,0,0,0.0,0.0,0.0
400,小土豆,20230204,0,0,0,0.0,0.0,0.0
401,小土豆,20230205,0,0,0,0.0,0.0,0.0
402,小土豆,20230206,0,0,0,0.0,0.0,0.0
403,小土豆,20230207,0,0,0,0.0,0.0,0.0
404,小土豆,20230208,0,0,0,0.0,0.0,0.0
405,小土豆,20230209,0,0,0,0.0,0.0,0.0
406,小土豆,20230210,0,0,0,0.0,0.0,0.0
407,小土豆,20230211,0,0,0,0.0,0.0,0.0
408,小土豆,20230212,0,0,0,0.0,0.0,0.0
409,小土豆,20230213,0,0,0,0.0,0.0,0.0
410,小土豆,20230214,0,0,0,0.0,0.0,0.0
411,小土豆,20230215,0,0,0,0.0,0.0,0.0
412,小土豆,20230216,0,0,0,0.0,0.0,0.0
413,小土豆,20230217,0,0,0,0.0,0.0,0.0
414,小土豆,20230218,0,0,0,0.0,0.0,0.0
415,小土豆,20230219,0,0,0,0.0,0.0,0.0
416,小土豆,20230220,0,0,0,0.0,0.0,0.0
417,小土豆,20230221,0,0,0,0.0,0.0,0.0
418,小土豆,20230222,0,0,0,0.0,0.0,0.0
419,小土豆,20230223,0,0,0,0.0,0.0,0.0
420,小土豆,20230224,0,0,0,0.0,0.0,0.0
421,小土豆,20230225,0,0,0,0.0,0.0,0.0
422,小土豆,20230226,0,0,0,0.0,0.0,0.0
423,小土豆,20230227,0,0,0,0.0,0.0,0.0
424,小土豆,20230228,0,0,0,0.0,0.0,0.0
425,小土豆,20230301,0,0,0,0.0,0.0,0.0
426,小土豆,20230302,0,0,0,0.0,0.0,0.0
427,小土豆,20230303,0,0,0,0.0,0.0,0.0
428,小土豆,20230304,0,0,0,0.0,0.0,0.0
429,小土豆,20230305,0,0,0,0.0,0.0,0.0
430,小土豆,20230306,0,0,0,0.0,0.0,0.0
431,小土豆,20230307,0,0,0,0.0,0.0,0.0
432,小土豆,20230308,0,0,0,0.0,0.0,0.0
433,小土豆,20230309,0,0,0,0.0,0.0,0.0
434,小土豆,20230310,0,0,0,0.0,0.0,0.0
435,小土豆,20230311,0,0,0,0.0,0.0,0.0
436,小土豆,20230312,0,0,0,0.0,0.0,0.0
437,小土豆,20230313,0,0,0,0.0,0.0,0.0
438,小土豆,20230314,0,0,0,0.0,0.0,0.0
439,小土豆,20230315,0,0,0,0.0,0.0,0.0
440,小土豆,20230316,0,0,0,0.0,0.0,0.0
441,小土豆,20230317,0,0,0,0.0,0.0,0.0
442,小土豆,20230318,0,0,0,0.0,0.0,0.0
443,小土豆,20230319,0,0,0,0.0,0.0,0.0
444,小土豆,20230320,0,0,0,0.0,0.0,0.0
445,小土豆,20230321,0,0,0,0.0,0.0,0.0
446,小土豆,20230322,0,0,0,0.0,0.0,0.0
447,小土豆,20230323,0,0,0,0.0,0.0,0.0
448,小土豆,20230324,0,0,0,0.0,0.0,0.0
449,小土豆,20230325,0,0,0,0.0,0.0,0.0
450,小土豆,20230326,0,0,0,0.0,0.0,0.0
451,小土豆,20230327,0,0,0,0.0,0.0,0.0
452,小土豆,20230328,0,0,0,0.0,0.0,0.0
453,小土豆,20230329,0,0,0,0.0,0.0,0.0
454,小土豆,20230330,0,0,0,0.0,0.0,0.0
455,小土豆,20230331,0,0,0,0.0,0.0,0.0
456,小土豆,20230401,0,0,0,0.0,0.0,0.0
457,小土豆,20230402,0,0,0,0.0,0.0,0.0
458,小土豆,20230403,0,0,0,0.0,0.0,0.0
459,小土豆,20230404,0,0,0,0.0,0.0,0.0
460,小土豆,20230405,0,0,0,0.0,0.0,0.0
461,小土豆,20230406,0,0,0,0.0,0.0,0.0
462,小土豆,20230407,0,0,0,0.0,0.0,0.0
463,小土豆,20230408,0,0,0,0.0,0.0,0.0
464,小土豆,20230409,0,0,0,0.0,0.0,0.0
465,小土豆,20230410,0,0,0,0.0,0.0,0.0
466,小土豆,20230411,0,0,0,0.0,0.0,0.0
467,小土豆,20230412,0,0,0,0.0,0.0,0.0
468,小土豆,20230413,0,0,0,0.0,0.0,0.0
469,小土豆,20230414,0,0,0,0.0,0.0,0.0
470,小土豆,20230415,0,0,0,0.0,0.0,0.0
471,小土豆,20230416,0,0,0,0.0,0.0,0.0
472,小土豆,20230417,0,0,0,0.0,0.0,0.0
473,小土豆,20230418,0,0,0,0.0,0.0,0.0
474,小土豆,20230419,0,0,0,0.0,0.0,0.0
475,小土豆,20230420,0,0,0,0.0,0.0,0.0
476,小土豆,20230421,0,0,0,0.0,0.0,0.0
477,小土豆,20230422,0,0,0,0.0,0.0,0.0
478,小土豆,20230423,0,0,0,0.0,0.0,0.0
479,小土豆,20230424,0,0,0,0.0,0.0,0.0
480,小土豆,20230425,0,0,0,0.0,0.0,0.0
481,小土豆,20230426,0,0,0,0.0,0.0,0.0
482,小土豆,20230427,0,0,0,0.0,0.0,0.0
483,小土豆,20230428,0,0,0,0.0,0.0,0.0
484,小土豆,20230429,0,0,0,0.0,0.0,0.0
485,小土豆,20230430,0,0,0,0.0,0.0,0.0
486,小土豆,20230501,0,0,0,0.0,0.0,0.0
487,小土豆,20230502,0,0,0,0.0,0.0,0.0
488,小土豆,20230503,0,0,0,0.0,0.0,0.0
489,小土豆,20230504,0,0,0,0.0,0.0,0.0
490,小土豆,20230505,0,0,0,0.0,0.0,0.0
491,小土豆,20230506,0,0,0,0.0,0.0,0.0
492,小土豆,20230507,0,0,0,0.0,0.0,0.0
493,小土豆,20230508,0,0,0,0.0,0.0,0.0
494,小土豆,20230509,0,0,0,0.0,0.0,0.0
495,小土豆,20230510,0,0,0,0.0,0.0,0.0
496,小土豆,20230511,0,0,0,0.0,0.0,0.0
497,小土豆,20230512,0,0,0,0.0,0.0,0.0
498,小土豆,20230513,0,0,0,0.0,0.0,0.0
499,小土豆,20230514,0,0,0,0.0,0.0,0.0
500,小土豆,20230515,0,0,0,0.0,0.0,0.0
501,小土豆,20230516,0,0,0,0.0,0.0,0.0
502,小土豆,20230517,0,0,0,0.0,0.0,0.0
503,小土豆,20230518,0,0,0,0.0,0.0,0.0
504,小土豆,20230519,0,0,0,0.0,0.0,0.0
505,小土豆,20230520,0,0,0,0.0,0.0,0.0
506,小土豆,20230521,0,0,0,0.0,0.0,0.0
507,小土豆,20230522,0,0,0,0.0,0.0,0.0
508,小土豆,20230523,0,0,0,0.0,0.0,0.0
509,小土豆,20230524,0,0,0,0.0,0.0,0.0
510,小土豆,20230525,0,0,0,0.0,0.0,0.0
511,小土豆,20230526,0,0,0,0.0,0.0,0.0
512,小土豆,20230527,0,0,0,0.0,0.0,0.0
513,小土豆,20230528,0,0,0,0.0,0.0,0.0
514,小土豆,20230529,0,0,0,0.0,0.0,0.0
515,小土豆,20230530,0,0,0,0.0,0.0,0.0
516,小土豆,20230531,0,0,0,0.0,0.0,0.0
517,小土豆,20230601,0,0,0,0.0,0.0,0.0
518,小土豆,20230602,0,0,0,0.0,0.0,0.0
519,小土豆,20230603,0,0,0,0.0,0.0,0.0
520,小土豆,20230604,0,0,0,0.0,0.0,0.0
521,小土豆,20230605,0,0,0,0.0,0.0,0.0
522,小土豆,20230606,0,0,0,0.0,0.0,0.0
523,小土豆,20230607,0,0,0,0.0,0.0,0.0
524,小土豆,20230608,0,0,0,0.0,0.0,0.0
525,小土豆,20230609,0,0,0,0.0,0.0,0.0
526,小土豆,20230610,0,0,0,0.0,0.0,0.0
527,小土豆,20230611,0,0,0,0.0,0.0,0.0
528,小土豆,20230612,0,0,0,0.0,0.0,0.0
529,小土豆,20230613,0,0,0,0.0,0.0,0.0
530,小土豆,20230614,0,0,0,0.0,0.0,0.0
531,小土豆,20230615,0,0,0,0.0,0.0,0.0
532,小土豆,20230616,0,0,0,0.0,0.0,0.0
533,小土豆,20230617,0,0,0,0.0,0.0,0.0
534,小土豆,20230618,0,0,0,0.0,0.0,0.0
535,小土豆,20230619,0,0,0,0.0,0.0,0.0
536,小土豆,20230620,0,0,0,0.0,0.0,0.0
537,小土豆,20230621,0,0,0,0.0,0.0,0.0
538,小土豆,20230622,0,0,0,0.0,0.0,0.0
539,小土豆,20230623,0,0,0,0.0,0.0,0.0
540,小土豆,20230624,0,0,0,0.0,0.0,0.0
541,小土豆,20230625,0,0,0,0.0,0.0,0.0
542,小土豆,20230626,0,0,0,0.0,0.0,0.0
543,小土豆,20230627,0,0,0,0.0,0.0,0.0
544,小土豆,20230628,0,0,0,0.0,0.0,0.0
545,小土豆,20230629,0,0,0,0.0,0.0,0.0
546,小土豆,20230630,0,0,0,0.0,0.0,0.0
547,小土豆,20230701,0,0,0,0.0,0.0,0.0
548,小土豆,20230702,0,0,0,0.0,0.0,0.0
549,小土豆,20230703,0,0,0,0.0,0.0,0.0
550,小土豆,20230704,0,0,0,0.0,0.0,0.0
551,小土豆,20230705,0,0,0,0.0,0.0,0.0
552,小土豆,20230706,0,0,0,0.0,0.0,0.0
553,小土豆,20230707,0,0,0,0.0,0.0,0.0
554,小土豆,20230708,0,0,0,0.0,0.0,0.0
555,小土豆,20230709,0,0,0,0.0,0.0,0.0
556,小土豆,20230710,0,0,0,0.0,0.0,0.0
557,小土豆,20230711,0,0,0,0.0,0.0,0.0
558,小土豆,20230712,0,0,0,0.0,0.0,0.0
559,小土豆,20230713,0,0,0,0.0,0.0,0.0
560,小土豆,20230714,0,0,0,0.0,0.0,0.0
561,小土豆,20230715,0,0,0,0.0,0.0,0.0
562,小土豆,20230716,0,0,0,0.0,0.0,0.0
563,小土豆,20230717,0,0,0,0.0,0.0,0.0
564,小土豆,20230718,0,0,0,0.0,0.0,0.0
565,小土豆,20230719,0,0,0,0.0,0.0,0.0
566,小土豆,20230720,0,0,0,0.0,0.0,0.0
567,小土豆,20230721,0,0,0,0.0,0.0,0.0
568,小土豆,20230722,0,0,0,0.0,0.0,0.0
569,小土豆,20230723,0,0,0,0.0,0.0,0.0
570,小土豆,20230724,0,0,0,0.0,0.0,0.0
571,小土豆,20230725,0,0,0,0.0,0.0,0.0
572,小土豆,20230726,0,0,0,0.0,0.0,0.0
573,小土豆,20230727,0,0,0,0.0,0.0,0.0
574,小土豆,20230728,0,0,0,0.0,0.0,0.0
575,小土豆,20230729,0,0,0,0.0,0.0,0.0
576,小土豆,20230730,0,0,0,0.0,0.0,0.0
577,小土豆,20230731,0,0,0,0.0,0.0,0.0
578,小土豆,20230801,0,0,0,0.0,0.0,0.0
579,小土豆,20230802,0,0,0,0.0,0.0,0.0
580,小土豆,20230803,0,0,0,0.0,0.0,0.0
581,小土豆,20230804,0,0,0,0.0,0.0,0.0
582,小土豆,20230805,0,0,0,0.0,0.0,0.0
583,小土豆,20230806,0,0,0,0.0,0.0,0.0
584,小土豆,20230807,0,0,0,0.0,0.0,0.0
585,小土豆,20230808,0,0,0,0.0,0.0,0.0
586,小土豆,20230809,0,0,0,0.0,0.0,0.0
587,小土豆,20230810,0,0,0,0.0,0.0,0.0
588,小土豆,20230811,0,0,0,0.0,0.0,0.0
589,小土豆,20230812,0,0,0,0.0,0.0,0.0
590,小土豆,20230813,0,0,0,0.0,0.0,0.0
591,小土豆,20230814,0,0,0,0.0,0.0,0.0
592,小土豆,20230815,0,0,0,0.0,0.0,0.0
593,小土豆,20230816,0,0,0,0.0,0.0,0.0
594,小土豆,20230817,0,0,0,0.0,0.0,0.0
595,小土豆,20230818,0,0,0,0.0,0.0,0.0
596,小土豆,20230819,0,0,0,0.0,0.0,0.0
597,小土豆,20230820,0,0,0,0.0,0.0,0.0
598,小土豆,20230821,0,0,0,0.0,0.0,0.0
599,小土豆,20230822,0,0,0,0.0,0.0,0.0
600,小土豆,20230823,0,0,0,0.0,0.0,0.0
601,小土豆,20230824,0,0,0,0.0,0.0,0.0
602,小土豆,20230825,0,0,0,0.0,0.0,0.0
603,小土豆,20230826,0,0,0,0.0,0.0,0.0
604,小土豆,20230827,0,0,0,0.0,0.0,0.0
605,小土豆,20230828,0,0,0,0.0,0.0,0.0
606,小土豆,20230829,0,0,0,0.0,0.0,0.0
607,小土豆,20230830,0,0,0,0.0,0.0,0.0
608,小土豆,20230831,0,0,0,0.0,0.0,0.0
609,小土豆,20230901,0,0,0,0.0,0.0,0.0
610,小土豆,20230902,0,0,0,0.0,0.0,0.0
611,小土豆,20230903,0,0,0,0.0,0.0,0.0
612,小土豆,20230904,0,0,0,0.0,0.0,0.0
613,小土豆,20230905,0,0,0,0.0,0.0,0.0
614,小土豆,20230906,0,0,0,0.0,0.0,0.0
615,小土豆,20230907,0,0,0,0.0,0.0,0.0
616,小土豆,20230908,0,0,0,0.0,0.0,0.0
617,小土豆,20230909,0,0,0,0.0,0.0,0.0
618,小土豆,20230910,0,0,0,0.0,0.0,0.0
619,小土豆,20230911,0,0,0,0.0,0.0,0.0
620,小土豆,20230912,0,0,0,0.0,0.0,0.0
621,小土豆,20230913,0,0,0,0.0,0.0,0.0
622,小土豆,20230914,0,0,0,0.0,0.0,0.0
623,小土豆,20230915,0,0,0,0.0,0.0,0.0
624,小土豆,20230916,0,0,0,0.0,0.0,0.0
625,小土豆,20230917,0,0,0,0.0,0.0,0.0
626,小土豆,20230918,0,0,0,0.0,0.0,0.0
627,小土豆,20230919,0,0,0,0.0,0.0,0.0
628,小土豆,20230920,0,0,0,0.0,0.0,0.0
629,小土豆,20230921,0,0,0,0.0,0.0,0.0
630,小土豆,20230922,0,0,0,0.0,0.0,0.0
631,小土豆,20230923,0,0,0,0.0,0.0,0.0
632,小土豆,20230924,0,0,0,0.0,0.0,0.0
633,小土豆,20230925,0,0,0,0.0,0.0,0.0
634,小土豆,20230926,0,0,0,0.0,0.0,0.0
635,小土豆,20230927,0,0,0,0.0,0.0,0.0
636,小土豆,20230928,0,0,0,0.0,0.0,0.0
637,小土豆,20230929,0,0,0,0.0,0.0,0.0
638,小土豆,20230930,0,0,0,0.0,0.0,0.0
639,小土豆,20231001,353,66,287,0.0,70.6,35.3
640,小土豆,20231002,331,72,259,353.0,136.8,68.4
641,小土豆,20231003,356,68,288,331.0,208.0,104.0
642,小土豆,20231004,369,66,303,356.0,281.8,140.9
643,小土豆,20231005,366,74,292,369.0,355.0,177.5
644,小土豆,20231006,375,66,309,366.0,359.4,215.0
645,小土豆,20231007,412,85,327,375.0,375.6,256.2
646,小土豆,20231008,371,82,289,412.0,378.6,293.3
647,小土豆,20231009,355,108,247,371.0,375.8,328.8
648,小土豆,20231010,368,80,288,355.0,376.2,365.6
649,小土豆,20231011,362,82,280,368.0,373.6,366.5
650,小土豆,20231012,349,78,271,362.0,361.0,368.3
651,小土豆,20231013,369,87,282,349.0,360.6,369.6
652,小土豆,20231014,351,70,281,369.0,359.8,367.8
653,小土豆,20231015,410,68,342,351.0,368.2,372.2
654,小土豆,20231016,382,72,310,410.0,372.2,372.9
655,小土豆,20231017,361,99,262,382.0,374.6,367.8
656,小土豆,20231018,346,85,261,361.0,370.0,365.3
657,小土豆,20231019,364,82,282,346.0,372.6,366.2
658,小土豆,20231020,347,74,273,364.0,360.0,364.1
659,小土豆,20231021,392,85,307,347.0,362.0,367.1
660,小土豆,20231022,366,68,298,392.0,363.0,368.8
661,小土豆,20231023,348,82,266,366.0,363.4,366.7
662,小土豆,20231024,303,74,229,348.0,351.2,361.9
663,小土豆,20231025,272,74,198,303.0,336.2,348.1
664,小土豆,20231026,297,72,225,272.0,317.2,339.6
665,小土豆,20231027,327,68,259,297.0,309.4,336.2
666,小土豆,20231028,363,68,295,327.0,312.4,337.9
667,小土豆,20231029,327,66,261,363.0,317.2,334.2
668,小土豆,20231030,304,83,221,327.0,323.6,329.9
669,小土豆,20231031,318,91,227,304.0,327.8,322.5
670,小土豆,20231101,375,83,292,318.0,337.4,323.4
671,小土豆,20231102,325,101,224,375.0,329.8,321.1
672,小土豆,20231103,369,89,280,325.0,338.2,327.7
673,小土豆,20231104,375,63,312,369.0,352.4,338.0
674,小土豆,20231105,416,76,340,375.0,372.0,349.9
675,小土豆,20231106,358,83,275,416.0,368.6,353.0
676,小土豆,20231107,368,91,277,358.0,377.2,353.5
677,小土豆,20231108,349,87,262,368.0,373.2,355.7
678,小土豆,20231109,377,89,288,349.0,373.6,363.0
679,小土豆,20231110,410,93,317,377.0,372.4,372.2
680,小土豆,20231111,408,70,338,410.0,382.4,375.5
681,小土豆,20231112,490,82,408,408.0,406.8,392.0
682,小土豆,20231113,376,89,287,490.0,412.2,392.7
683,小土豆,20231114,408,74,334,376.0,418.4,396.0
684,小土豆,20231115,361,101,260,408.0,408.6,390.5
685,小土豆,20231116,396,114,282,361.0,406.2,394.3
686,小土豆,20231117,478,101,377,396.0,403.8,405.3
687,小土豆,20231118,418,80,338,478.0,412.2,412.2
688,小土豆,20231119,411,70,341,418.0,412.8,415.6
689,小土豆,20231120,368,91,277,411.0,414.2,411.4
690,小土豆,20231121,428,91,337,368.0,420.6,413.4
691,小土豆,20231122,422,101,321,428.0,409.4,406.6
692,小土豆,20231123,368,108,260,422.0,399.4,405.8
693,小土豆,20231124,432,85,347,368.0,403.6,408.2
694,小土豆,20231125,514,82,432,432.0,432.8,423.5
695,小土豆,20231126,475,68,407,514.0,442.2,431.4
696,小土豆,20231127,448,102,346,475.0,447.4,428.4
697,小土豆,20231128,410,104,306,448.0,455.8,427.6
698,小土豆,20231129,454,110,344,410.0,460.2,431.9
699,小土豆,20231130,472,120,352,454.0,451.8,442.3
700,小土豆,20231201,548,114,434,472.0,466.4,454.3
701,小土豆,20231202,561,83,478,548.0,489.0,468.2
702,小土豆,20231203,555,72,483,561.0,518.0,486.9
703,小土豆,20231204,529,116,413,555.0,533.0,496.6
704,小土豆,20231205,520,106,414,529.0,542.6,497.2
705,小土豆,20231206,579,131,448,520.0,548.8,507.6
706,小土豆,20231207,517,118,399,579.0,540.0,514.5
707,小土豆,20231208,603,135,468,517.0,549.6,533.8
708,小土豆,20231209,566,83,483,603.0,557.0,545.0
709,小土豆,20231210,676,97,579,566.0,588.2,565.4
710,小土豆,20231211,514,152,362,676.0,575.2,562.0
711,小土豆,20231212,435,144,291,514.0,558.8,549.4
712,小土豆,20231213,554,135,419,435.0,549.0,549.3
713,小土豆,20231214,613,127,486,554.0,558.4,557.7
714,小土豆,20231215,674,146,528,613.0,558.0,573.1
715,小土豆,20231216,644,83,561,674.0,584.0,579.6
716,小土豆,20231217,669,101,568,644.0,630.8,594.8
717,小土豆,20231218,766,159,607,669.0,673.2,611.1
718,小土豆,20231219,704,168,536,766.0,691.4,624.9
719,小土豆,20231220,794,173,621,704.0,715.4,636.7
720,小土豆,20231221,956,204,752,794.0,777.8,680.9
721,小土豆,20231222,893,166,727,956.0,822.6,726.7
722,小土豆,20231223,923,112,811,893.0,854.0,763.6
723,小土豆,20231224,978,112,866,923.0,908.8,800.1
724,小土豆,20231225,1265,360,905,978.0,1003.0,859.2
725,小土豆,20231226,1313,350,963,1265.0,1074.4,926.1
726,小土豆,20231227,1447,447,1000,1313.0,1185.2,1003.9
727,小土豆,20231228,1768,628,1140,1447.0,1354.2,1104.1
728,小土豆,20231229,1921,647,1274,1768.0,1542.8,1225.8
729,小土豆,20231230,1943,369,1574,1921.0,1678.4,1340.7
730,小土豆,20231231,2151,459,1692,1943.0,1846.0,1460.2
731,小土豆,20240101,2738,720,2018,2151.0,2104.2,1644.7
732,小土豆,20240102,2840,1064,1776,2738.0,2318.6,1836.4
733,小土豆,20240103,6936,3755,3181,2840.0,3321.6,2432.2
734,小土豆,20240104,6526,2537,3989,6936.0,4238.2,2958.3
735,小土豆,20240105,5834,1908,3926,6526.0,4974.8,3410.4
736,小土豆,20240106,4459,1053,3406,5834.0,5319.0,3711.6
737,小土豆,20240107,3747,685,3062,4459.0,5500.4,3909.5
738,小土豆,20240108,3460,943,2517,3747.0,4805.2,4063.4
739,小土豆,20240109,2572,852,1720,3460.0,4014.4,4126.3
740,小土豆,20240110,2446,842,1604,2572.0,3336.8,4155.8
741,小土豆,20240111,2083,704,1379,2446.0,2861.6,4090.3
742,小土豆,20240112,2423,670,1753,2083.0,2596.8,4048.6
743,小土豆,20240113,2275,375,1900,2423.0,2359.8,3582.5
744,小土豆,20240114,1954,326,1628,2275.0,2236.2,3125.3
745,小土豆,20240115,2020,510,1510,1954.0,2151.0,2743.9
746,小土豆,20240116,2193,603,1590,2020.0,2173.0,2517.3
747,小土豆,20240117,2346,465,1881,2193.0,2157.6,2377.2
748,小土豆,20240118,2207,388,1819,2346.0,2144.0,2251.9
749,小土豆,20240119,2604,374,2230,2207.0,2274.0,2255.1
750,小土豆,20240120,2712,274,2438,2604.0,2412.4,2281.7
751,小土豆,20240121,3252,295,2957,2712.0,2624.2,2398.6
752,小土豆,20240122,3570,555,3015,3252.0,2869.0,2513.3
753,小土豆,20240123,3687,453,3234,3570.0,3165.0,2654.5
754,小土豆,20240124,3808,412,3396,3687.0,3405.8,2839.9
755,小土豆,20240125,3795,344,3451,3808.0,3622.4,3017.4
756,小土豆,20240126,3783,323,3460,3795.0,3728.6,3176.4
757,小土豆,20240127,4492,595,3897,3783.0,3913.0,3391.0
758,小土豆,20240128,5216,552,4664,4492.0,4218.8,3691.9
759,小土豆,20240129,3982,416,3566,5216.0,4253.6,3829.7
760,小土豆,20240130,3900,313,3587,3982.0,4274.6,3948.5
761,小土豆,20240131,4194,310,3884,3900.0,4356.8,4042.7
762,小土豆,20240201,3921,326,3595,4194.0,4242.6,4077.8
763,小土豆,20240202,4585,270,4315,3921.0,4116.4,4167.6
764,小土豆,20240203,4569,307,4262,4585.0,4233.8,4243.7
765,小土豆,20240204,4089,307,3782,4569.0,4271.6,4273.1
766,小土豆,20240205,4235,245,3990,4089.0,4279.8,4318.3
767,小土豆,20240206,4001,256,3745,4235.0,4295.8,4269.2
768,小土豆,20240207,3893,207,3686,4001.0,4157.4,4136.9
769,小土豆,20240208,4082,161,3921,3893.0,4060.0,4146.9
770,小土豆,20240209,4391,144,4247,4082.0,4120.4,4196.0
771,小土豆,20240210,4484,161,4323,4391.0,4170.2,4225.0
772,小土豆,20240211,4561,170,4391,4484.0,4282.2,4289.0
773,小土豆,20240212,3911,140,3771,4561.0,4285.8,4221.6
774,小土豆,20240213,4031,133,3898,3911.0,4275.6,4167.8
775,小土豆,20240214,3696,161,3535,4031.0,4136.6,4128.5
776,小土豆,20240215,3442,144,3298,3696.0,3928.2,4049.2
777,小土豆,20240216,3449,148,3301,3442.0,3705.8,3994.0
778,小土豆,20240217,3130,152,2978,3449.0,3549.6,3917.7
779,小土豆,20240218,3036,236,2800,3130.0,3350.6,3813.1
780,小土豆,20240219,2777,225,2552,3036.0,3166.8,3651.7
781,小土豆,20240220,3038,200,2838,2777.0,3086.0,3507.1
782,小土豆,20240221,2954,226,2728,3038.0,2987.0,3346.4
783,小土豆,20240222,3152,226,2926,2954.0,2991.4,3270.5
784,小土豆,20240223,2587,190,2397,3152.0,2901.6,3126.1
785,小土豆,20240224,3209,168,3041,2587.0,2988.0,3077.4
786,小土豆,20240225,2458,158,2300,3209.0,2872.0,2979.0
787,小土豆,20240226,2613,251,2362,2458.0,2803.8,2895.4
788,小土豆,20240227,2075,225,1850,2613.0,2588.4,2789.9
789,小土豆,20240228,2035,200,1835,2075.0,2478.0,2689.8
790,小土豆,20240229,1896,231,1665,2035.0,2215.4,2601.7
791,小土豆,20240301,1941,195,1746,1896.0,2112.0,2492.0
792,小土豆,20240302,2358,157,2201,1941.0,2061.0,2432.4
793,小土豆,20240303,2165,146,2019,2358.0,2079.0,2333.7
794,小土豆,20240304,1680,190,1490,2165.0,2008.0,2243.0
795,小土豆,20240305,1773,205,1568,1680.0,1983.4,2099.4
796,小土豆,20240306,1529,162,1367,1773.0,1901.0,2006.5
797,小土豆,20240307,1704,190,1514,1529.0,1770.2,1915.6
798,小土豆,20240308,1716,157,1559,1704.0,1680.4,1879.7
799,小土豆,20240309,1891,150,1741,1716.0,1722.6,1865.3
800,小土豆,20240310,1959,137,1822,1891.0,1759.8,1871.6
801,小土豆,20240311,1403,179,1224,1959.0,1734.6,1817.8
802,小土豆,20240312,1458,207,1251,1403.0,1685.4,1727.8
803,小土豆,20240313,1280,173,1107,1458.0,1598.2,1639.3
804,小土豆,20240314,1341,162,1179,1280.0,1488.2,1605.4
805,小土豆,20240315,1498,152,1346,1341.0,1396.0,1577.9
806,小土豆,20240316,1826,140,1686,1498.0,1480.6,1607.6
807,小土豆,20240317,1734,137,1597,1826.0,1535.8,1610.6
808,小土豆,20240318,1248,142,1106,1734.0,1529.4,1563.8
809,小土豆,20240319,1279,139,1140,1248.0,1517.0,1502.6
810,小土豆,20240320,1184,146,1038,1279.0,1454.2,1425.1
811,小土豆,20240321,1335,137,1198,1184.0,1356.0,1418.3
812,小土豆,20240322,1199,146,1053,1335.0,1249.0,1392.4
813,小土豆,20240323,1591,110,1481,1199.0,1317.6,1423.5
814,小土豆,20240324,1658,144,1514,1591.0,1393.4,1455.2
815,小土豆,20240325,1148,157,991,1658.0,1386.2,1420.2
816,小土豆,20240326,1148,148,1000,1148.0,1348.8,1352.4
817,小土豆,20240327,1217,163,1054,1148.0,1352.4,1300.7
818,小土豆,20240328,1130,139,991,1217.0,1260.2,1288.9
819,小土豆,20240329,1111,121,990,1130.0,1150.8,1272.1
820,小土豆,20240330,1424,114,1310,1111.0,1206.0,1296.1
821,小土豆,20240331,1401,112,1289,1424.0,1256.6,1302.7
822,小土豆,20240401,1130,131,999,1401.0,1239.2,1295.8
823,小土豆,20240402,1071,125,946,1130.0,1227.4,1243.8
824,小土豆,20240403,1175,146,1029,1071.0,1240.2,1195.5
825,小土豆,20240404,1556,106,1450,1175.0,1266.6,1236.3
826,小土豆,20240405,1551,95,1456,1556.0,1296.6,1276.6
827,小土豆,20240406,1386,127,1259,1551.0,1347.8,1293.5
828,小土豆,20240407,1078,106,972,1386.0,1349.2,1288.3
829,小土豆,20240408,1088,135,953,1078.0,1331.8,1286.0
830,小土豆,20240409,1101,137,964,1088.0,1240.8,1253.7
831,小土豆,20240410,1112,139,973,1101.0,1153.0,1224.8
832,小土豆,20240411,1051,157,894,1112.0,1086.0,1216.9
833,小土豆,20240412,1134,144,990,1051.0,1097.2,1223.2
834,小土豆,20240413,1352,118,1234,1134.0,1150.0,1240.9
835,小土豆,20240414,1301,133,1168,1352.0,1190.0,1215.4
836,小土豆,20240415,1025,108,917,1301.0,1172.6,1162.8
837,小土豆,20240416,1050,125,925,1025.0,1172.4,1129.2
838,小土豆,20240417,1032,125,907,1050.0,1152.0,1124.6
839,小土豆,20240418,1060,123,937,1032.0,1093.6,1121.8
840,小土豆,20240419,1112,129,983,1060.0,1055.8,1122.9
841,小土豆,20240420,1093,99,994,1112.0,1069.4,1121.0
842,小土豆,20240421,1126,114,1012,1093.0,1084.6,1128.5
843,小土豆,20240422,1020,114,906,1126.0,1082.2,1117.1
844,小土豆,20240423,1060,150,910,1020.0,1082.2,1087.9
845,小土豆,20240424,1009,106,903,1060.0,1061.6,1058.7
846,小土豆,20240425,1061,135,926,1009.0,1055.2,1062.3
847,小土豆,20240426,1052,129,923,1061.0,1040.4,1062.5
848,小土豆,20240427,1211,131,1080,1052.0,1078.6,1080.4
849,小土豆,20240428,1111,166,945,1211.0,1088.8,1085.5
850,小土豆,20240429,984,131,853,1111.0,1083.8,1072.7
851,小土豆,20240430,1082,129,953,984.0,1088.0,1071.6
1,尔滨,20220101,0,0,0,1082.0,877.6,959.0
2,尔滨,20220102,0,0,0,0.0,635.4,857.0
3,尔滨,20220103,0,0,0,0.0,413.2,751.0
4,尔滨,20220104,0,0,0,0.0,216.4,650.1
5,尔滨,20220105,0,0,0,0.0,0.0,544.0
6,尔滨,20220106,0,0,0,0.0,0.0,438.8
7,尔滨,20220107,0,0,0,0.0,0.0,317.7
8,尔滨,20220108,0,0,0,0.0,0.0,206.6
9,尔滨,20220109,0,0,0,0.0,0.0,108.2
10,尔滨,20220110,0,0,0,0.0,0.0,0.0
11,尔滨,20220111,0,0,0,0.0,0.0,0.0
12,尔滨,20220112,0,0,0,0.0,0.0,0.0
13,尔滨,20220113,0,0,0,0.0,0.0,0.0
14,尔滨,20220114,0,0,0,0.0,0.0,0.0
15,尔滨,20220115,0,0,0,0.0,0.0,0.0
16,尔滨,20220116,0,0,0,0.0,0.0,0.0
17,尔滨,20220117,0,0,0,0.0,0.0,0.0
18,尔滨,20220118,0,0,0,0.0,0.0,0.0
19,尔滨,20220119,0,0,0,0.0,0.0,0.0
20,尔滨,20220120,0,0,0,0.0,0.0,0.0
21,尔滨,20220121,0,0,0,0.0,0.0,0.0
22,尔滨,20220122,0,0,0,0.0,0.0,0.0
23,尔滨,20220123,0,0,0,0.0,0.0,0.0
24,尔滨,20220124,0,0,0,0.0,0.0,0.0
25,尔滨,20220125,0,0,0,0.0,0.0,0.0
26,尔滨,20220126,0,0,0,0.0,0.0,0.0
27,尔滨,20220127,0,0,0,0.0,0.0,0.0
28,尔滨,20220128,0,0,0,0.0,0.0,0.0
29,尔滨,20220129,0,0,0,0.0,0.0,0.0
30,尔滨,20220130,0,0,0,0.0,0.0,0.0
31,尔滨,20220131,0,0,0,0.0,0.0,0.0
32,尔滨,20220201,0,0,0,0.0,0.0,0.0
33,尔滨,20220202,0,0,0,0.0,0.0,0.0
34,尔滨,20220203,0,0,0,0.0,0.0,0.0
35,尔滨,20220204,0,0,0,0.0,0.0,0.0
36,尔滨,20220205,0,0,0,0.0,0.0,0.0
37,尔滨,20220206,0,0,0,0.0,0.0,0.0
38,尔滨,20220207,0,0,0,0.0,0.0,0.0
39,尔滨,20220208,0,0,0,0.0,0.0,0.0
40,尔滨,20220209,0,0,0,0.0,0.0,0.0
41,尔滨,20220210,0,0,0,0.0,0.0,0.0
42,尔滨,20220211,0,0,0,0.0,0.0,0.0
43,尔滨,20220212,0,0,0,0.0,0.0,0.0
44,尔滨,20220213,0,0,0,0.0,0.0,0.0
45,尔滨,20220214,0,0,0,0.0,0.0,0.0
46,尔滨,20220215,0,0,0,0.0,0.0,0.0
47,尔滨,20220216,0,0,0,0.0,0.0,0.0
48,尔滨,20220217,0,0,0,0.0,0.0,0.0
49,尔滨,20220218,0,0,0,0.0,0.0,0.0
50,尔滨,20220219,0,0,0,0.0,0.0,0.0
51,尔滨,20220220,0,0,0,0.0,0.0,0.0
52,尔滨,20220221,0,0,0,0.0,0.0,0.0
53,尔滨,20220222,0,0,0,0.0,0.0,0.0
54,尔滨,20220223,0,0,0,0.0,0.0,0.0
55,尔滨,20220224,0,0,0,0.0,0.0,0.0
56,尔滨,20220225,0,0,0,0.0,0.0,0.0
57,尔滨,20220226,0,0,0,0.0,0.0,0.0
58,尔滨,20220227,0,0,0,0.0,0.0,0.0
59,尔滨,20220228,0,0,0,0.0,0.0,0.0
60,尔滨,20220301,0,0,0,0.0,0.0,0.0
61,尔滨,20220302,0,0,0,0.0,0.0,0.0
62,尔滨,20220303,0,0,0,0.0,0.0,0.0
63,尔滨,20220304,0,0,0,0.0,0.0,0.0
64,尔滨,20220305,0,0,0,0.0,0.0,0.0
65,尔滨,20220306,0,0,0,0.0,0.0,0.0
66,尔滨,20220307,0,0,0,0.0,0.0,0.0
67,尔滨,20220308,0,0,0,0.0,0.0,0.0
68,尔滨,20220309,0,0,0,0.0,0.0,0.0
69,尔滨,20220310,0,0,0,0.0,0.0,0.0
70,尔滨,20220311,0,0,0,0.0,0.0,0.0
71,尔滨,20220312,0,0,0,0.0,0.0,0.0
72,尔滨,20220313,0,0,0,0.0,0.0,0.0
73,尔滨,20220314,0,0,0,0.0,0.0,0.0
74,尔滨,20220315,0,0,0,0.0,0.0,0.0
75,尔滨,20220316,0,0,0,0.0,0.0,0.0
76,尔滨,20220317,0,0,0,0.0,0.0,0.0
77,尔滨,20220318,0,0,0,0.0,0.0,0.0
78,尔滨,20220319,0,0,0,0.0,0.0,0.0
79,尔滨,20220320,0,0,0,0.0,0.0,0.0
80,尔滨,20220321,0,0,0,0.0,0.0,0.0
81,尔滨,20220322,0,0,0,0.0,0.0,0.0
82,尔滨,20220323,0,0,0,0.0,0.0,0.0
83,尔滨,20220324,0,0,0,0.0,0.0,0.0
84,尔滨,20220325,0,0,0,0.0,0.0,0.0
85,尔滨,20220326,0,0,0,0.0,0.0,0.0
86,尔滨,20220327,0,0,0,0.0,0.0,0.0
87,尔滨,20220328,0,0,0,0.0,0.0,0.0
88,尔滨,20220329,0,0,0,0.0,0.0,0.0
89,尔滨,20220330,0,0,0,0.0,0.0,0.0
90,尔滨,20220331,0,0,0,0.0,0.0,0.0
91,尔滨,20220401,0,0,0,0.0,0.0,0.0
92,尔滨,20220402,0,0,0,0.0,0.0,0.0
93,尔滨,20220403,0,0,0,0.0,0.0,0.0
94,尔滨,20220404,0,0,0,0.0,0.0,0.0
95,尔滨,20220405,0,0,0,0.0,0.0,0.0
96,尔滨,20220406,0,0,0,0.0,0.0,0.0
97,尔滨,20220407,0,0,0,0.0,0.0,0.0
98,尔滨,20220408,0,0,0,0.0,0.0,0.0
99,尔滨,20220409,0,0,0,0.0,0.0,0.0
100,尔滨,20220410,0,0,0,0.0,0.0,0.0
101,尔滨,20220411,0,0,0,0.0,0.0,0.0
102,尔滨,20220412,0,0,0,0.0,0.0,0.0
103,尔滨,20220413,0,0,0,0.0,0.0,0.0
104,尔滨,20220414,0,0,0,0.0,0.0,0.0
105,尔滨,20220415,0,0,0,0.0,0.0,0.0
106,尔滨,20220416,0,0,0,0.0,0.0,0.0
107,尔滨,20220417,0,0,0,0.0,0.0,0.0
108,尔滨,20220418,0,0,0,0.0,0.0,0.0
109,尔滨,20220419,0,0,0,0.0,0.0,0.0
110,尔滨,20220420,0,0,0,0.0,0.0,0.0
111,尔滨,20220421,0,0,0,0.0,0.0,0.0
112,尔滨,20220422,0,0,0,0.0,0.0,0.0
113,尔滨,20220423,0,0,0,0.0,0.0,0.0
114,尔滨,20220424,0,0,0,0.0,0.0,0.0
115,尔滨,20220425,0,0,0,0.0,0.0,0.0
116,尔滨,20220426,0,0,0,0.0,0.0,0.0
117,尔滨,20220427,0,0,0,0.0,0.0,0.0
118,尔滨,20220428,0,0,0,0.0,0.0,0.0
119,尔滨,20220429,0,0,0,0.0,0.0,0.0
120,尔滨,20220430,0,0,0,0.0,0.0,0.0
121,尔滨,20220501,0,0,0,0.0,0.0,0.0
122,尔滨,20220502,0,0,0,0.0,0.0,0.0
123,尔滨,20220503,0,0,0,0.0,0.0,0.0
124,尔滨,20220504,0,0,0,0.0,0.0,0.0
125,尔滨,20220505,0,0,0,0.0,0.0,0.0
126,尔滨,20220506,0,0,0,0.0,0.0,0.0
127,尔滨,20220507,0,0,0,0.0,0.0,0.0
128,尔滨,20220508,0,0,0,0.0,0.0,0.0
129,尔滨,20220509,0,0,0,0.0,0.0,0.0
130,尔滨,20220510,0,0,0,0.0,0.0,0.0
131,尔滨,20220511,0,0,0,0.0,0.0,0.0
132,尔滨,20220512,0,0,0,0.0,0.0,0.0
133,尔滨,20220513,0,0,0,0.0,0.0,0.0
134,尔滨,20220514,0,0,0,0.0,0.0,0.0
135,尔滨,20220515,0,0,0,0.0,0.0,0.0
136,尔滨,20220516,0,0,0,0.0,0.0,0.0
137,尔滨,20220517,0,0,0,0.0,0.0,0.0
138,尔滨,20220518,0,0,0,0.0,0.0,0.0
139,尔滨,20220519,0,0,0,0.0,0.0,0.0
140,尔滨,20220520,0,0,0,0.0,0.0,0.0
141,尔滨,20220521,0,0,0,0.0,0.0,0.0
142,尔滨,20220522,0,0,0,0.0,0.0,0.0
143,尔滨,20220523,0,0,0,0.0,0.0,0.0
144,尔滨,20220524,0,0,0,0.0,0.0,0.0
145,尔滨,20220525,0,0,0,0.0,0.0,0.0
146,尔滨,20220526,0,0,0,0.0,0.0,0.0
147,尔滨,20220527,0,0,0,0.0,0.0,0.0
148,尔滨,20220528,0,0,0,0.0,0.0,0.0
149,尔滨,20220529,0,0,0,0.0,0.0,0.0
150,尔滨,20220530,0,0,0,0.0,0.0,0.0
151,尔滨,20220531,0,0,0,0.0,0.0,0.0
152,尔滨,20220601,0,0,0,0.0,0.0,0.0
153,尔滨,20220602,0,0,0,0.0,0.0,0.0
154,尔滨,20220603,0,0,0,0.0,0.0,0.0
155,尔滨,20220604,0,0,0,0.0,0.0,0.0
156,尔滨,20220605,0,0,0,0.0,0.0,0.0
157,尔滨,20220606,0,0,0,0.0,0.0,0.0
158,尔滨,20220607,0,0,0,0.0,0.0,0.0
159,尔滨,20220608,0,0,0,0.0,0.0,0.0
160,尔滨,20220609,0,0,0,0.0,0.0,0.0
161,尔滨,20220610,0,0,0,0.0,0.0,0.0
162,尔滨,20220611,0,0,0,0.0,0.0,0.0
163,尔滨,20220612,0,0,0,0.0,0.0,0.0
164,尔滨,20220613,0,0,0,0.0,0.0,0.0
165,尔滨,20220614,0,0,0,0.0,0.0,0.0
166,尔滨,20220615,0,0,0,0.0,0.0,0.0
167,尔滨,20220616,0,0,0,0.0,0.0,0.0
168,尔滨,20220617,0,0,0,0.0,0.0,0.0
169,尔滨,20220618,0,0,0,0.0,0.0,0.0
170,尔滨,20220619,0,0,0,0.0,0.0,0.0
171,尔滨,20220620,0,0,0,0.0,0.0,0.0
172,尔滨,20220621,0,0,0,0.0,0.0,0.0
173,尔滨,20220622,0,0,0,0.0,0.0,0.0
174,尔滨,20220623,0,0,0,0.0,0.0,0.0
175,尔滨,20220624,0,0,0,0.0,0.0,0.0
176,尔滨,20220625,0,0,0,0.0,0.0,0.0
177,尔滨,20220626,0,0,0,0.0,0.0,0.0
178,尔滨,20220627,0,0,0,0.0,0.0,0.0
179,尔滨,20220628,0,0,0,0.0,0.0,0.0
180,尔滨,20220629,0,0,0,0.0,0.0,0.0
181,尔滨,20220630,0,0,0,0.0,0.0,0.0
182,尔滨,20220701,0,0,0,0.0,0.0,0.0
183,尔滨,20220702,0,0,0,0.0,0.0,0.0
184,尔滨,20220703,0,0,0,0.0,0.0,0.0
185,尔滨,20220704,0,0,0,0.0,0.0,0.0
186,尔滨,20220705,0,0,0,0.0,0.0,0.0
187,尔滨,20220706,0,0,0,0.0,0.0,0.0
188,尔滨,20220707,0,0,0,0.0,0.0,0.0
189,尔滨,20220708,0,0,0,0.0,0.0,0.0
190,尔滨,20220709,0,0,0,0.0,0.0,0.0
191,尔滨,20220710,0,0,0,0.0,0.0,0.0
192,尔滨,20220711,0,0,0,0.0,0.0,0.0
193,尔滨,20220712,0,0,0,0.0,0.0,0.0
194,尔滨,20220713,0,0,0,0.0,0.0,0.0
195,尔滨,20220714,0,0,0,0.0,0.0,0.0
196,尔滨,20220715,0,0,0,0.0,0.0,0.0
197,尔滨,20220716,0,0,0,0.0,0.0,0.0
198,尔滨,20220717,0,0,0,0.0,0.0,0.0
199,尔滨,20220718,0,0,0,0.0,0.0,0.0
200,尔滨,20220719,0,0,0,0.0,0.0,0.0
201,尔滨,20220720,0,0,0,0.0,0.0,0.0
202,尔滨,20220721,0,0,0,0.0,0.0,0.0
203,尔滨,20220722,0,0,0,0.0,0.0,0.0
204,尔滨,20220723,0,0,0,0.0,0.0,0.0
205,尔滨,20220724,0,0,0,0.0,0.0,0.0
206,尔滨,20220725,0,0,0,0.0,0.0,0.0
207,尔滨,20220726,0,0,0,0.0,0.0,0.0
208,尔滨,20220727,0,0,0,0.0,0.0,0.0
209,尔滨,20220728,0,0,0,0.0,0.0,0.0
210,尔滨,20220729,0,0,0,0.0,0.0,0.0
211,尔滨,20220730,0,0,0,0.0,0.0,0.0
212,尔滨,20220731,0,0,0,0.0,0.0,0.0
213,尔滨,20220801,0,0,0,0.0,0.0,0.0
214,尔滨,20220802,0,0,0,0.0,0.0,0.0
215,尔滨,20220803,0,0,0,0.0,0.0,0.0
216,尔滨,20220804,0,0,0,0.0,0.0,0.0
217,尔滨,20220805,0,0,0,0.0,0.0,0.0
218,尔滨,20220806,0,0,0,0.0,0.0,0.0
219,尔滨,20220807,0,0,0,0.0,0.0,0.0
220,尔滨,20220808,0,0,0,0.0,0.0,0.0
221,尔滨,20220809,0,0,0,0.0,0.0,0.0
222,尔滨,20220810,0,0,0,0.0,0.0,0.0
223,尔滨,20220811,0,0,0,0.0,0.0,0.0
224,尔滨,20220812,0,0,0,0.0,0.0,0.0
225,尔滨,20220813,0,0,0,0.0,0.0,0.0
226,尔滨,20220814,0,0,0,0.0,0.0,0.0
227,尔滨,20220815,0,0,0,0.0,0.0,0.0
228,尔滨,20220816,0,0,0,0.0,0.0,0.0
229,尔滨,20220817,0,0,0,0.0,0.0,0.0
230,尔滨,20220818,0,0,0,0.0,0.0,0.0
231,尔滨,20220819,0,0,0,0.0,0.0,0.0
232,尔滨,20220820,0,0,0,0.0,0.0,0.0
233,尔滨,20220821,0,0,0,0.0,0.0,0.0
234,尔滨,20220822,0,0,0,0.0,0.0,0.0
235,尔滨,20220823,0,0,0,0.0,0.0,0.0
236,尔滨,20220824,0,0,0,0.0,0.0,0.0
237,尔滨,20220825,0,0,0,0.0,0.0,0.0
238,尔滨,20220826,0,0,0,0.0,0.0,0.0
239,尔滨,20220827,0,0,0,0.0,0.0,0.0
240,尔滨,20220828,0,0,0,0.0,0.0,0.0
241,尔滨,20220829,0,0,0,0.0,0.0,0.0
242,尔滨,20220830,0,0,0,0.0,0.0,0.0
243,尔滨,20220831,0,0,0,0.0,0.0,0.0
244,尔滨,20220901,0,0,0,0.0,0.0,0.0
245,尔滨,20220902,0,0,0,0.0,0.0,0.0
246,尔滨,20220903,0,0,0,0.0,0.0,0.0
247,尔滨,20220904,0,0,0,0.0,0.0,0.0
248,尔滨,20220905,0,0,0,0.0,0.0,0.0
249,尔滨,20220906,0,0,0,0.0,0.0,0.0
250,尔滨,20220907,0,0,0,0.0,0.0,0.0
251,尔滨,20220908,0,0,0,0.0,0.0,0.0
252,尔滨,20220909,0,0,0,0.0,0.0,0.0
253,尔滨,20220910,0,0,0,0.0,0.0,0.0
254,尔滨,20220911,0,0,0,0.0,0.0,0.0
255,尔滨,20220912,0,0,0,0.0,0.0,0.0
256,尔滨,20220913,0,0,0,0.0,0.0,0.0
257,尔滨,20220914,0,0,0,0.0,0.0,0.0
258,尔滨,20220915,0,0,0,0.0,0.0,0.0
259,尔滨,20220916,0,0,0,0.0,0.0,0.0
260,尔滨,20220917,0,0,0,0.0,0.0,0.0
261,尔滨,20220918,0,0,0,0.0,0.0,0.0
262,尔滨,20220919,0,0,0,0.0,0.0,0.0
263,尔滨,20220920,0,0,0,0.0,0.0,0.0
264,尔滨,20220921,0,0,0,0.0,0.0,0.0
265,尔滨,20220922,0,0,0,0.0,0.0,0.0
266,尔滨,20220923,0,0,0,0.0,0.0,0.0
267,尔滨,20220924,0,0,0,0.0,0.0,0.0
268,尔滨,20220925,0,0,0,0.0,0.0,0.0
269,尔滨,20220926,0,0,0,0.0,0.0,0.0
270,尔滨,20220927,0,0,0,0.0,0.0,0.0
271,尔滨,20220928,0,0,0,0.0,0.0,0.0
272,尔滨,20220929,0,0,0,0.0,0.0,0.0
273,尔滨,20220930,0,0,0,0.0,0.0,0.0
274,尔滨,20221001,0,0,0,0.0,0.0,0.0
275,尔滨,20221002,0,0,0,0.0,0.0,0.0
276,尔滨,20221003,0,0,0,0.0,0.0,0.0
277,尔滨,20221004,0,0,0,0.0,0.0,0.0
278,尔滨,20221005,0,0,0,0.0,0.0,0.0
279,尔滨,20221006,0,0,0,0.0,0.0,0.0
280,尔滨,20221007,0,0,0,0.0,0.0,0.0
281,尔滨,20221008,0,0,0,0.0,0.0,0.0
282,尔滨,20221009,0,0,0,0.0,0.0,0.0
283,尔滨,20221010,0,0,0,0.0,0.0,0.0
284,尔滨,20221011,0,0,0,0.0,0.0,0.0
285,尔滨,20221012,0,0,0,0.0,0.0,0.0
286,尔滨,20221013,0,0,0,0.0,0.0,0.0
287,尔滨,20221014,0,0,0,0.0,0.0,0.0
288,尔滨,20221015,0,0,0,0.0,0.0,0.0
289,尔滨,20221016,0,0,0,0.0,0.0,0.0
290,尔滨,20221017,0,0,0,0.0,0.0,0.0
291,尔滨,20221018,0,0,0,0.0,0.0,0.0
292,尔滨,20221019,0,0,0,0.0,0.0,0.0
293,尔滨,20221020,0,0,0,0.0,0.0,0.0
294,尔滨,20221021,0,0,0,0.0,0.0,0.0
295,尔滨,20221022,0,0,0,0.0,0.0,0.0
296,尔滨,20221023,0,0,0,0.0,0.0,0.0
297,尔滨,20221024,0,0,0,0.0,0.0,0.0
298,尔滨,20221025,0,0,0,0.0,0.0,0.0
299,尔滨,20221026,0,0,0,0.0,0.0,0.0
300,尔滨,20221027,0,0,0,0.0,0.0,0.0
301,尔滨,20221028,0,0,0,0.0,0.0,0.0
302,尔滨,20221029,0,0,0,0.0,0.0,0.0
303,尔滨,20221030,0,0,0,0.0,0.0,0.0
304,尔滨,20221031,0,0,0,0.0,0.0,0.0
305,尔滨,20221101,0,0,0,0.0,0.0,0.0
306,尔滨,20221102,0,0,0,0.0,0.0,0.0
307,尔滨,20221103,0,0,0,0.0,0.0,0.0
308,尔滨,20221104,0,0,0,0.0,0.0,0.0
309,尔滨,20221105,0,0,0,0.0,0.0,0.0
310,尔滨,20221106,0,0,0,0.0,0.0,0.0
311,尔滨,20221107,0,0,0,0.0,0.0,0.0
312,尔滨,20221108,0,0,0,0.0,0.0,0.0
313,尔滨,20221109,0,0,0,0.0,0.0,0.0
314,尔滨,20221110,0,0,0,0.0,0.0,0.0
315,尔滨,20221111,0,0,0,0.0,0.0,0.0
316,尔滨,20221112,0,0,0,0.0,0.0,0.0
317,尔滨,20221113,0,0,0,0.0,0.0,0.0
318,尔滨,20221114,0,0,0,0.0,0.0,0.0
319,尔滨,20221115,0,0,0,0.0,0.0,0.0
320,尔滨,20221116,0,0,0,0.0,0.0,0.0
321,尔滨,20221117,0,0,0,0.0,0.0,0.0
322,尔滨,20221118,0,0,0,0.0,0.0,0.0
323,尔滨,20221119,0,0,0,0.0,0.0,0.0
324,尔滨,20221120,0,0,0,0.0,0.0,0.0
325,尔滨,20221121,0,0,0,0.0,0.0,0.0
326,尔滨,20221122,0,0,0,0.0,0.0,0.0
327,尔滨,20221123,0,0,0,0.0,0.0,0.0
328,尔滨,20221124,0,0,0,0.0,0.0,0.0
329,尔滨,20221125,0,0,0,0.0,0.0,0.0
330,尔滨,20221126,0,0,0,0.0,0.0,0.0
331,尔滨,20221127,0,0,0,0.0,0.0,0.0
332,尔滨,20221128,0,0,0,0.0,0.0,0.0
333,尔滨,20221129,0,0,0,0.0,0.0,0.0
334,尔滨,20221130,0,0,0,0.0,0.0,0.0
335,尔滨,20221201,0,0,0,0.0,0.0,0.0
336,尔滨,20221202,0,0,0,0.0,0.0,0.0
337,尔滨,20221203,0,0,0,0.0,0.0,0.0
338,尔滨,20221204,0,0,0,0.0,0.0,0.0
339,尔滨,20221205,0,0,0,0.0,0.0,0.0
340,尔滨,20221206,0,0,0,0.0,0.0,0.0
341,尔滨,20221207,0,0,0,0.0,0.0,0.0
342,尔滨,20221208,0,0,0,0.0,0.0,0.0
343,尔滨,20221209,0,0,0,0.0,0.0,0.0
344,尔滨,20221210,0,0,0,0.0,0.0,0.0
345,尔滨,20221211,0,0,0,0.0,0.0,0.0
346,尔滨,20221212,0,0,0,0.0,0.0,0.0
347,尔滨,20221213,0,0,0,0.0,0.0,0.0
348,尔滨,20221214,0,0,0,0.0,0.0,0.0
349,尔滨,20221215,0,0,0,0.0,0.0,0.0
350,尔滨,20221216,0,0,0,0.0,0.0,0.0
351,尔滨,20221217,0,0,0,0.0,0.0,0.0
352,尔滨,20221218,0,0,0,0.0,0.0,0.0
353,尔滨,20221219,0,0,0,0.0,0.0,0.0
354,尔滨,20221220,0,0,0,0.0,0.0,0.0
355,尔滨,20221221,0,0,0,0.0,0.0,0.0
356,尔滨,20221222,0,0,0,0.0,0.0,0.0
357,尔滨,20221223,0,0,0,0.0,0.0,0.0
358,尔滨,20221224,0,0,0,0.0,0.0,0.0
359,尔滨,20221225,0,0,0,0.0,0.0,0.0
360,尔滨,20221226,0,0,0,0.0,0.0,0.0
361,尔滨,20221227,0,0,0,0.0,0.0,0.0
362,尔滨,20221228,0,0,0,0.0,0.0,0.0
363,尔滨,20221229,0,0,0,0.0,0.0,0.0
364,尔滨,20221230,0,0,0,0.0,0.0,0.0
365,尔滨,20221231,0,0,0,0.0,0.0,0.0
366,尔滨,20230101,0,0,0,0.0,0.0,0.0
367,尔滨,20230102,0,0,0,0.0,0.0,0.0
368,尔滨,20230103,0,0,0,0.0,0.0,0.0
369,尔滨,20230104,0,0,0,0.0,0.0,0.0
370,尔滨,20230105,0,0,0,0.0,0.0,0.0
371,尔滨,20230106,0,0,0,0.0,0.0,0.0
372,尔滨,20230107,0,0,0,0.0,0.0,0.0
373,尔滨,20230108,0,0,0,0.0,0.0,0.0
374,尔滨,20230109,0,0,0,0.0,0.0,0.0
375,尔滨,20230110,0,0,0,0.0,0.0,0.0
376,尔滨,20230111,0,0,0,0.0,0.0,0.0
377,尔滨,20230112,0,0,0,0.0,0.0,0.0
378,尔滨,20230113,0,0,0,0.0,0.0,0.0
379,尔滨,20230114,0,0,0,0.0,0.0,0.0
380,尔滨,20230115,0,0,0,0.0,0.0,0.0
381,尔滨,20230116,0,0,0,0.0,0.0,0.0
382,尔滨,20230117,0,0,0,0.0,0.0,0.0
383,尔滨,20230118,0,0,0,0.0,0.0,0.0
384,尔滨,20230119,0,0,0,0.0,0.0,0.0
385,尔滨,20230120,0,0,0,0.0,0.0,0.0
386,尔滨,20230121,0,0,0,0.0,0.0,0.0
387,尔滨,20230122,0,0,0,0.0,0.0,0.0
388,尔滨,20230123,0,0,0,0.0,0.0,0.0
389,尔滨,20230124,0,0,0,0.0,0.0,0.0
390,尔滨,20230125,0,0,0,0.0,0.0,0.0
391,尔滨,20230126,0,0,0,0.0,0.0,0.0
392,尔滨,20230127,0,0,0,0.0,0.0,0.0
393,尔滨,20230128,0,0,0,0.0,0.0,0.0
394,尔滨,20230129,0,0,0,0.0,0.0,0.0
395,尔滨,20230130,0,0,0,0.0,0.0,0.0
396,尔滨,20230131,0,0,0,0.0,0.0,0.0
397,尔滨,20230201,0,0,0,0.0,0.0,0.0
398,尔滨,20230202,0,0,0,0.0,0.0,0.0
399,尔滨,20230203,0,0,0,0.0,0.0,0.0
400,尔滨,20230204,0,0,0,0.0,0.0,0.0
401,尔滨,20230205,0,0,0,0.0,0.0,0.0
402,尔滨,20230206,0,0,0,0.0,0.0,0.0
403,尔滨,20230207,0,0,0,0.0,0.0,0.0
404,尔滨,20230208,0,0,0,0.0,0.0,0.0
405,尔滨,20230209,0,0,0,0.0,0.0,0.0
406,尔滨,20230210,0,0,0,0.0,0.0,0.0
407,尔滨,20230211,0,0,0,0.0,0.0,0.0
408,尔滨,20230212,0,0,0,0.0,0.0,0.0
409,尔滨,20230213,0,0,0,0.0,0.0,0.0
410,尔滨,20230214,0,0,0,0.0,0.0,0.0
411,尔滨,20230215,0,0,0,0.0,0.0,0.0
412,尔滨,20230216,0,0,0,0.0,0.0,0.0
413,尔滨,20230217,0,0,0,0.0,0.0,0.0
414,尔滨,20230218,0,0,0,0.0,0.0,0.0
415,尔滨,20230219,0,0,0,0.0,0.0,0.0
416,尔滨,20230220,0,0,0,0.0,0.0,0.0
417,尔滨,20230221,0,0,0,0.0,0.0,0.0
418,尔滨,20230222,0,0,0,0.0,0.0,0.0
419,尔滨,20230223,0,0,0,0.0,0.0,0.0
420,尔滨,20230224,0,0,0,0.0,0.0,0.0
421,尔滨,20230225,0,0,0,0.0,0.0,0.0
422,尔滨,20230226,0,0,0,0.0,0.0,0.0
423,尔滨,20230227,0,0,0,0.0,0.0,0.0
424,尔滨,20230228,0,0,0,0.0,0.0,0.0
425,尔滨,20230301,0,0,0,0.0,0.0,0.0
426,尔滨,20230302,0,0,0,0.0,0.0,0.0
427,尔滨,20230303,0,0,0,0.0,0.0,0.0
428,尔滨,20230304,0,0,0,0.0,0.0,0.0
429,尔滨,20230305,0,0,0,0.0,0.0,0.0
430,尔滨,20230306,0,0,0,0.0,0.0,0.0
431,尔滨,20230307,0,0,0,0.0,0.0,0.0
432,尔滨,20230308,0,0,0,0.0,0.0,0.0
433,尔滨,20230309,0,0,0,0.0,0.0,0.0
434,尔滨,20230310,0,0,0,0.0,0.0,0.0
435,尔滨,20230311,0,0,0,0.0,0.0,0.0
436,尔滨,20230312,0,0,0,0.0,0.0,0.0
437,尔滨,20230313,0,0,0,0.0,0.0,0.0
438,尔滨,20230314,0,0,0,0.0,0.0,0.0
439,尔滨,20230315,0,0,0,0.0,0.0,0.0
440,尔滨,20230316,0,0,0,0.0,0.0,0.0
441,尔滨,20230317,0,0,0,0.0,0.0,0.0
442,尔滨,20230318,0,0,0,0.0,0.0,0.0
443,尔滨,20230319,0,0,0,0.0,0.0,0.0
444,尔滨,20230320,0,0,0,0.0,0.0,0.0
445,尔滨,20230321,0,0,0,0.0,0.0,0.0
446,尔滨,20230322,0,0,0,0.0,0.0,0.0
447,尔滨,20230323,0,0,0,0.0,0.0,0.0
448,尔滨,20230324,0,0,0,0.0,0.0,0.0
449,尔滨,20230325,0,0,0,0.0,0.0,0.0
450,尔滨,20230326,0,0,0,0.0,0.0,0.0
451,尔滨,20230327,0,0,0,0.0,0.0,0.0
452,尔滨,20230328,0,0,0,0.0,0.0,0.0
453,尔滨,20230329,0,0,0,0.0,0.0,0.0
454,尔滨,20230330,0,0,0,0.0,0.0,0.0
455,尔滨,20230331,0,0,0,0.0,0.0,0.0
456,尔滨,20230401,0,0,0,0.0,0.0,0.0
457,尔滨,20230402,0,0,0,0.0,0.0,0.0
458,尔滨,20230403,0,0,0,0.0,0.0,0.0
459,尔滨,20230404,0,0,0,0.0,0.0,0.0
460,尔滨,20230405,0,0,0,0.0,0.0,0.0
461,尔滨,20230406,0,0,0,0.0,0.0,0.0
462,尔滨,20230407,0,0,0,0.0,0.0,0.0
463,尔滨,20230408,0,0,0,0.0,0.0,0.0
464,尔滨,20230409,0,0,0,0.0,0.0,0.0
465,尔滨,20230410,0,0,0,0.0,0.0,0.0
466,尔滨,20230411,0,0,0,0.0,0.0,0.0
467,尔滨,20230412,0,0,0,0.0,0.0,0.0
468,尔滨,20230413,0,0,0,0.0,0.0,0.0
469,尔滨,20230414,0,0,0,0.0,0.0,0.0
470,尔滨,20230415,0,0,0,0.0,0.0,0.0
471,尔滨,20230416,0,0,0,0.0,0.0,0.0
472,尔滨,20230417,0,0,0,0.0,0.0,0.0
473,尔滨,20230418,0,0,0,0.0,0.0,0.0
474,尔滨,20230419,0,0,0,0.0,0.0,0.0
475,尔滨,20230420,0,0,0,0.0,0.0,0.0
476,尔滨,20230421,0,0,0,0.0,0.0,0.0
477,尔滨,20230422,0,0,0,0.0,0.0,0.0
478,尔滨,20230423,0,0,0,0.0,0.0,0.0
479,尔滨,20230424,0,0,0,0.0,0.0,0.0
480,尔滨,20230425,0,0,0,0.0,0.0,0.0
481,尔滨,20230426,0,0,0,0.0,0.0,0.0
482,尔滨,20230427,0,0,0,0.0,0.0,0.0
483,尔滨,20230428,0,0,0,0.0,0.0,0.0
484,尔滨,20230429,0,0,0,0.0,0.0,0.0
485,尔滨,20230430,0,0,0,0.0,0.0,0.0
486,尔滨,20230501,0,0,0,0.0,0.0,0.0
487,尔滨,20230502,0,0,0,0.0,0.0,0.0
488,尔滨,20230503,0,0,0,0.0,0.0,0.0
489,尔滨,20230504,0,0,0,0.0,0.0,0.0
490,尔滨,20230505,0,0,0,0.0,0.0,0.0
491,尔滨,20230506,0,0,0,0.0,0.0,0.0
492,尔滨,20230507,0,0,0,0.0,0.0,0.0
493,尔滨,20230508,0,0,0,0.0,0.0,0.0
494,尔滨,20230509,0,0,0,0.0,0.0,0.0
495,尔滨,20230510,0,0,0,0.0,0.0,0.0
496,尔滨,20230511,0,0,0,0.0,0.0,0.0
497,尔滨,20230512,0,0,0,0.0,0.0,0.0
498,尔滨,20230513,0,0,0,0.0,0.0,0.0
499,尔滨,20230514,0,0,0,0.0,0.0,0.0
500,尔滨,20230515,0,0,0,0.0,0.0,0.0
501,尔滨,20230516,0,0,0,0.0,0.0,0.0
502,尔滨,20230517,0,0,0,0.0,0.0,0.0
503,尔滨,20230518,0,0,0,0.0,0.0,0.0
504,尔滨,20230519,0,0,0,0.0,0.0,0.0
505,尔滨,20230520,0,0,0,0.0,0.0,0.0
506,尔滨,20230521,0,0,0,0.0,0.0,0.0
507,尔滨,20230522,0,0,0,0.0,0.0,0.0
508,尔滨,20230523,0,0,0,0.0,0.0,0.0
509,尔滨,20230524,0,0,0,0.0,0.0,0.0
510,尔滨,20230525,0,0,0,0.0,0.0,0.0
511,尔滨,20230526,0,0,0,0.0,0.0,0.0
512,尔滨,20230527,0,0,0,0.0,0.0,0.0
513,尔滨,20230528,0,0,0,0.0,0.0,0.0
514,尔滨,20230529,0,0,0,0.0,0.0,0.0
515,尔滨,20230530,0,0,0,0.0,0.0,0.0
516,尔滨,20230531,0,0,0,0.0,0.0,0.0
517,尔滨,20230601,0,0,0,0.0,0.0,0.0
518,尔滨,20230602,0,0,0,0.0,0.0,0.0
519,尔滨,20230603,0,0,0,0.0,0.0,0.0
520,尔滨,20230604,0,0,0,0.0,0.0,0.0
521,尔滨,20230605,0,0,0,0.0,0.0,0.0
522,尔滨,20230606,0,0,0,0.0,0.0,0.0
523,尔滨,20230607,0,0,0,0.0,0.0,0.0
524,尔滨,20230608,0,0,0,0.0,0.0,0.0
525,尔滨,20230609,0,0,0,0.0,0.0,0.0
526,尔滨,20230610,0,0,0,0.0,0.0,0.0
527,尔滨,20230611,0,0,0,0.0,0.0,0.0
528,尔滨,20230612,0,0,0,0.0,0.0,0.0
529,尔滨,20230613,0,0,0,0.0,0.0,0.0
530,尔滨,20230614,0,0,0,0.0,0.0,0.0
531,尔滨,20230615,0,0,0,0.0,0.0,0.0
532,尔滨,20230616,0,0,0,0.0,0.0,0.0
533,尔滨,20230617,0,0,0,0.0,0.0,0.0
534,尔滨,20230618,0,0,0,0.0,0.0,0.0
535,尔滨,20230619,0,0,0,0.0,0.0,0.0
536,尔滨,20230620,0,0,0,0.0,0.0,0.0
537,尔滨,20230621,0,0,0,0.0,0.0,0.0
538,尔滨,20230622,0,0,0,0.0,0.0,0.0
539,尔滨,20230623,0,0,0,0.0,0.0,0.0
540,尔滨,20230624,0,0,0,0.0,0.0,0.0
541,尔滨,20230625,0,0,0,0.0,0.0,0.0
542,尔滨,20230626,0,0,0,0.0,0.0,0.0
543,尔滨,20230627,0,0,0,0.0,0.0,0.0
544,尔滨,20230628,0,0,0,0.0,0.0,0.0
545,尔滨,20230629,0,0,0,0.0,0.0,0.0
546,尔滨,20230630,0,0,0,0.0,0.0,0.0
547,尔滨,20230701,0,0,0,0.0,0.0,0.0
548,尔滨,20230702,0,0,0,0.0,0.0,0.0
549,尔滨,20230703,0,0,0,0.0,0.0,0.0
550,尔滨,20230704,0,0,0,0.0,0.0,0.0
551,尔滨,20230705,0,0,0,0.0,0.0,0.0
552,尔滨,20230706,0,0,0,0.0,0.0,0.0
553,尔滨,20230707,0,0,0,0.0,0.0,0.0
554,尔滨,20230708,0,0,0,0.0,0.0,0.0
555,尔滨,20230709,0,0,0,0.0,0.0,0.0
556,尔滨,20230710,0,0,0,0.0,0.0,0.0
557,尔滨,20230711,0,0,0,0.0,0.0,0.0
558,尔滨,20230712,0,0,0,0.0,0.0,0.0
559,尔滨,20230713,0,0,0,0.0,0.0,0.0
560,尔滨,20230714,0,0,0,0.0,0.0,0.0
561,尔滨,20230715,0,0,0,0.0,0.0,0.0
562,尔滨,20230716,0,0,0,0.0,0.0,0.0
563,尔滨,20230717,0,0,0,0.0,0.0,0.0
564,尔滨,20230718,0,0,0,0.0,0.0,0.0
565,尔滨,20230719,0,0,0,0.0,0.0,0.0
566,尔滨,20230720,0,0,0,0.0,0.0,0.0
567,尔滨,20230721,0,0,0,0.0,0.0,0.0
568,尔滨,20230722,0,0,0,0.0,0.0,0.0
569,尔滨,20230723,0,0,0,0.0,0.0,0.0
570,尔滨,20230724,0,0,0,0.0,0.0,0.0
571,尔滨,20230725,0,0,0,0.0,0.0,0.0
572,尔滨,20230726,0,0,0,0.0,0.0,0.0
573,尔滨,20230727,0,0,0,0.0,0.0,0.0
574,尔滨,20230728,0,0,0,0.0,0.0,0.0
575,尔滨,20230729,0,0,0,0.0,0.0,0.0
576,尔滨,20230730,0,0,0,0.0,0.0,0.0
577,尔滨,20230731,0,0,0,0.0,0.0,0.0
578,尔滨,20230801,0,0,0,0.0,0.0,0.0
579,尔滨,20230802,0,0,0,0.0,0.0,0.0
580,尔滨,20230803,0,0,0,0.0,0.0,0.0
581,尔滨,20230804,0,0,0,0.0,0.0,0.0
582,尔滨,20230805,0,0,0,0.0,0.0,0.0
583,尔滨,20230806,0,0,0,0.0,0.0,0.0
584,尔滨,20230807,0,0,0,0.0,0.0,0.0
585,尔滨,20230808,0,0,0,0.0,0.0,0.0
586,尔滨,20230809,0,0,0,0.0,0.0,0.0
587,尔滨,20230810,0,0,0,0.0,0.0,0.0
588,尔滨,20230811,0,0,0,0.0,0.0,0.0
589,尔滨,20230812,0,0,0,0.0,0.0,0.0
590,尔滨,20230813,0,0,0,0.0,0.0,0.0
591,尔滨,20230814,0,0,0,0.0,0.0,0.0
592,尔滨,20230815,0,0,0,0.0,0.0,0.0
593,尔滨,20230816,0,0,0,0.0,0.0,0.0
594,尔滨,20230817,0,0,0,0.0,0.0,0.0
595,尔滨,20230818,0,0,0,0.0,0.0,0.0
596,尔滨,20230819,0,0,0,0.0,0.0,0.0
597,尔滨,20230820,0,0,0,0.0,0.0,0.0
598,尔滨,20230821,0,0,0,0.0,0.0,0.0
599,尔滨,20230822,0,0,0,0.0,0.0,0.0
600,尔滨,20230823,0,0,0,0.0,0.0,0.0
601,尔滨,20230824,0,0,0,0.0,0.0,0.0
602,尔滨,20230825,0,0,0,0.0,0.0,0.0
603,尔滨,20230826,0,0,0,0.0,0.0,0.0
604,尔滨,20230827,0,0,0,0.0,0.0,0.0
605,尔滨,20230828,0,0,0,0.0,0.0,0.0
606,尔滨,20230829,0,0,0,0.0,0.0,0.0
607,尔滨,20230830,0,0,0,0.0,0.0,0.0
608,尔滨,20230831,0,0,0,0.0,0.0,0.0
609,尔滨,20230901,0,0,0,0.0,0.0,0.0
610,尔滨,20230902,0,0,0,0.0,0.0,0.0
611,尔滨,20230903,0,0,0,0.0,0.0,0.0
612,尔滨,20230904,0,0,0,0.0,0.0,0.0
613,尔滨,20230905,0,0,0,0.0,0.0,0.0
614,尔滨,20230906,0,0,0,0.0,0.0,0.0
615,尔滨,20230907,0,0,0,0.0,0.0,0.0
616,尔滨,20230908,0,0,0,0.0,0.0,0.0
617,尔滨,20230909,0,0,0,0.0,0.0,0.0
618,尔滨,20230910,0,0,0,0.0,0.0,0.0
619,尔滨,20230911,0,0,0,0.0,0.0,0.0
620,尔滨,20230912,0,0,0,0.0,0.0,0.0
621,尔滨,20230913,0,0,0,0.0,0.0,0.0
622,尔滨,20230914,0,0,0,0.0,0.0,0.0
623,尔滨,20230915,0,0,0,0.0,0.0,0.0
624,尔滨,20230916,0,0,0,0.0,0.0,0.0
625,尔滨,20230917,0,0,0,0.0,0.0,0.0
626,尔滨,20230918,0,0,0,0.0,0.0,0.0
627,尔滨,20230919,0,0,0,0.0,0.0,0.0
628,尔滨,20230920,0,0,0,0.0,0.0,0.0
629,尔滨,20230921,0,0,0,0.0,0.0,0.0
630,尔滨,20230922,0,0,0,0.0,0.0,0.0
631,尔滨,20230923,0,0,0,0.0,0.0,0.0
632,尔滨,20230924,0,0,0,0.0,0.0,0.0
633,尔滨,20230925,0,0,0,0.0,0.0,0.0
634,尔滨,20230926,0,0,0,0.0,0.0,0.0
635,尔滨,20230927,0,0,0,0.0,0.0,0.0
636,尔滨,20230928,0,0,0,0.0,0.0,0.0
637,尔滨,20230929,0,0,0,0.0,0.0,0.0
638,尔滨,20230930,0,0,0,0.0,0.0,0.0
639,尔滨,20231001,0,0,0,0.0,0.0,0.0
640,尔滨,20231002,0,0,0,0.0,0.0,0.0
641,尔滨,20231003,0,0,0,0.0,0.0,0.0
642,尔滨,20231004,0,0,0,0.0,0.0,0.0
643,尔滨,20231005,0,0,0,0.0,0.0,0.0
644,尔滨,20231006,0,0,0,0.0,0.0,0.0
645,尔滨,20231007,0,0,0,0.0,0.0,0.0
646,尔滨,20231008,0,0,0,0.0,0.0,0.0
647,尔滨,20231009,0,0,0,0.0,0.0,0.0
648,尔滨,20231010,0,0,0,0.0,0.0,0.0
649,尔滨,20231011,0,0,0,0.0,0.0,0.0
650,尔滨,20231012,0,0,0,0.0,0.0,0.0
651,尔滨,20231013,0,0,0,0.0,0.0,0.0
652,尔滨,20231014,0,0,0,0.0,0.0,0.0
653,尔滨,20231015,0,0,0,0.0,0.0,0.0
654,尔滨,20231016,0,0,0,0.0,0.0,0.0
655,尔滨,20231017,0,0,0,0.0,0.0,0.0
656,尔滨,20231018,0,0,0,0.0,0.0,0.0
657,尔滨,20231019,0,0,0,0.0,0.0,0.0
658,尔滨,20231020,0,0,0,0.0,0.0,0.0
659,尔滨,20231021,0,0,0,0.0,0.0,0.0
660,尔滨,20231022,0,0,0,0.0,0.0,0.0
661,尔滨,20231023,0,0,0,0.0,0.0,0.0
662,尔滨,20231024,0,0,0,0.0,0.0,0.0
663,尔滨,20231025,0,0,0,0.0,0.0,0.0
664,尔滨,20231026,0,0,0,0.0,0.0,0.0
665,尔滨,20231027,0,0,0,0.0,0.0,0.0
666,尔滨,20231028,0,0,0,0.0,0.0,0.0
667,尔滨,20231029,0,0,0,0.0,0.0,0.0
668,尔滨,20231030,0,0,0,0.0,0.0,0.0
669,尔滨,20231031,0,0,0,0.0,0.0,0.0
670,尔滨,20231101,0,0,0,0.0,0.0,0.0
671,尔滨,20231102,0,0,0,0.0,0.0,0.0
672,尔滨,20231103,0,0,0,0.0,0.0,0.0
673,尔滨,20231104,0,0,0,0.0,0.0,0.0
674,尔滨,20231105,0,0,0,0.0,0.0,0.0
675,尔滨,20231106,0,0,0,0.0,0.0,0.0
676,尔滨,20231107,0,0,0,0.0,0.0,0.0
677,尔滨,20231108,0,0,0,0.0,0.0,0.0
678,尔滨,20231109,0,0,0,0.0,0.0,0.0
679,尔滨,20231110,0,0,0,0.0,0.0,0.0
680,尔滨,20231111,0,0,0,0.0,0.0,0.0
681,尔滨,20231112,0,0,0,0.0,0.0,0.0
682,尔滨,20231113,0,0,0,0.0,0.0,0.0
683,尔滨,20231114,0,0,0,0.0,0.0,0.0
684,尔滨,20231115,0,0,0,0.0,0.0,0.0
685,尔滨,20231116,0,0,0,0.0,0.0,0.0
686,尔滨,20231117,0,0,0,0.0,0.0,0.0
687,尔滨,20231118,0,0,0,0.0,0.0,0.0
688,尔滨,20231119,0,0,0,0.0,0.0,0.0
689,尔滨,20231120,0,0,0,0.0,0.0,0.0
690,尔滨,20231121,0,0,0,0.0,0.0,0.0
691,尔滨,20231122,0,0,0,0.0,0.0,0.0
692,尔滨,20231123,0,0,0,0.0,0.0,0.0
693,尔滨,20231124,0,0,0,0.0,0.0,0.0
694,尔滨,20231125,0,0,0,0.0,0.0,0.0
695,尔滨,20231126,0,0,0,0.0,0.0,0.0
696,尔滨,20231127,0,0,0,0.0,0.0,0.0
697,尔滨,20231128,0,0,0,0.0,0.0,0.0
698,尔滨,20231129,0,0,0,0.0,0.0,0.0
699,尔滨,20231130,0,0,0,0.0,0.0,0.0
700,尔滨,20231201,0,0,0,0.0,0.0,0.0
701,尔滨,20231202,0,0,0,0.0,0.0,0.0
702,尔滨,20231203,0,0,0,0.0,0.0,0.0
703,尔滨,20231204,0,0,0,0.0,0.0,0.0
704,尔滨,20231205,0,0,0,0.0,0.0,0.0
705,尔滨,20231206,0,0,0,0.0,0.0,0.0
706,尔滨,20231207,0,0,0,0.0,0.0,0.0
707,尔滨,20231208,0,0,0,0.0,0.0,0.0
708,尔滨,20231209,0,0,0,0.0,0.0,0.0
709,尔滨,20231210,0,0,0,0.0,0.0,0.0
710,尔滨,20231211,0,0,0,0.0,0.0,0.0
711,尔滨,20231212,0,0,0,0.0,0.0,0.0
712,尔滨,20231213,0,0,0,0.0,0.0,0.0
713,尔滨,20231214,0,0,0,0.0,0.0,0.0
714,尔滨,20231215,0,0,0,0.0,0.0,0.0
715,尔滨,20231216,0,0,0,0.0,0.0,0.0
716,尔滨,20231217,0,0,0,0.0,0.0,0.0
717,尔滨,20231218,0,0,0,0.0,0.0,0.0
718,尔滨,20231219,0,0,0,0.0,0.0,0.0
719,尔滨,20231220,0,0,0,0.0,0.0,0.0
720,尔滨,20231221,0,0,0,0.0,0.0,0.0
721,尔滨,20231222,0,0,0,0.0,0.0,0.0
722,尔滨,20231223,0,0,0,0.0,0.0,0.0
723,尔滨,20231224,0,0,0,0.0,0.0,0.0
724,尔滨,20231225,0,0,0,0.0,0.0,0.0
725,尔滨,20231226,0,0,0,0.0,0.0,0.0
726,尔滨,20231227,0,0,0,0.0,0.0,0.0
727,尔滨,20231228,0,0,0,0.0,0.0,0.0
728,尔滨,20231229,0,0,0,0.0,0.0,0.0
729,尔滨,20231230,0,0,0,0.0,0.0,0.0
730,尔滨,20231231,0,0,0,0.0,0.0,0.0
731,尔滨,20240101,0,0,0,0.0,0.0,0.0
732,尔滨,20240102,0,0,0,0.0,0.0,0.0
733,尔滨,20240103,0,0,0,0.0,0.0,0.0
734,尔滨,20240104,0,0,0,0.0,0.0,0.0
735,尔滨,20240105,2746,928,1818,0.0,549.2,274.6
736,尔滨,20240106,0,0,0,2746.0,549.2,274.6
737,尔滨,20240107,1902,412,1490,0.0,929.6,464.8
738,尔滨,20240108,1673,456,1217,1902.0,1264.2,632.1
739,尔滨,20240109,1874,894,980,1673.0,1639.0,819.5
740,尔滨,20240110,1811,889,922,1874.0,1452.0,1000.6
741,尔滨,20240111,2306,1380,926,1811.0,1913.2,1231.2
742,尔滨,20240112,2269,1165,1104,2306.0,1986.6,1458.1
743,尔滨,20240113,1588,642,946,2269.0,1969.6,1616.9
744,尔滨,20240114,1270,372,898,1588.0,1848.8,1743.9
745,尔滨,20240115,1628,749,879,1270.0,1812.2,1632.1
746,尔滨,20240116,1736,884,852,1628.0,1698.2,1805.7
747,尔滨,20240117,1423,605,818,1736.0,1529.0,1757.8
748,尔滨,20240118,1213,473,740,1423.0,1454.0,1711.8
749,尔滨,20240119,1350,564,786,1213.0,1470.0,1659.4
750,尔滨,20240120,855,204,651,1350.0,1315.4,1563.8
751,尔滨,20240121,1190,349,841,855.0,1206.2,1452.2
752,尔滨,20240122,1126,428,698,1190.0,1146.8,1337.9
753,尔滨,20240123,1061,388,673,1126.0,1116.4,1285.2
754,尔滨,20240124,861,316,545,1061.0,1018.6,1244.3
755,尔滨,20240125,783,265,518,861.0,1004.2,1159.8
756,尔滨,20240126,734,251,483,783.0,913.0,1059.6
757,尔滨,20240127,671,184,487,734.0,822.0,984.4
758,尔滨,20240128,620,172,448,671.0,733.8,925.1
759,尔滨,20240129,654,270,384,620.0,692.4,855.5
760,尔滨,20240130,759,293,466,654.0,687.6,845.9
761,尔滨,20240131,669,260,409,759.0,674.6,793.8
762,尔滨,20240201,585,223,362,669.0,657.4,739.7
763,尔滨,20240202,527,187,340,585.0,638.8,686.3
764,尔滨,20240203,648,253,395,527.0,637.6,665.0
765,尔滨,20240204,621,226,395,648.0,610.0,648.8
766,尔滨,20240205,486,172,314,621.0,573.4,624.0
767,尔滨,20240206,541,169,372,486.0,564.6,611.0
768,尔滨,20240207,396,133,263,541.0,538.4,588.6
769,尔滨,20240208,368,101,267,396.0,482.4,560.0
770,尔滨,20240209,376,78,298,368.0,433.4,521.7
771,尔滨,20240210,350,70,280,376.0,406.2,489.8
772,尔滨,20240211,334,72,262,350.0,364.8,464.7
773,尔滨,20240212,358,70,288,334.0,357.2,447.8
774,尔滨,20240213,383,91,292,358.0,360.2,421.3
775,尔滨,20240214,372,91,281,383.0,359.4,396.4
776,尔滨,20240215,429,108,321,372.0,375.2,390.7
777,尔滨,20240216,384,102,282,429.0,385.2,375.0
778,尔滨,20240217,417,129,288,384.0,397.0,377.1
779,尔滨,20240218,457,180,277,417.0,411.8,386.0
780,尔滨,20240219,440,179,261,457.0,425.4,392.4
781,尔滨,20240220,386,169,217,440.0,416.8,396.0
782,尔滨,20240221,332,121,211,386.0,406.4,395.8
783,尔滨,20240222,343,169,174,332.0,391.6,394.3
784,尔滨,20240223,348,144,204,343.0,369.8,390.8
785,尔滨,20240224,296,97,199,348.0,341.0,383.2
786,尔滨,20240225,264,101,163,296.0,316.6,366.7
787,尔滨,20240226,631,349,282,264.0,376.4,391.4
788,尔滨,20240227,430,218,212,631.0,393.8,392.7
789,尔滨,20240228,343,157,186,430.0,392.8,381.3
790,尔滨,20240229,278,127,151,343.0,389.2,365.1
791,尔滨,20240301,248,97,151,278.0,386.0,351.3
792,尔滨,20240302,233,85,148,248.0,306.4,341.4
793,尔滨,20240303,225,95,130,233.0,265.4,329.6
794,尔滨,20240304,282,116,166,225.0,253.2,323.0
795,尔滨,20240305,239,121,118,282.0,245.4,317.3
796,尔滨,20240306,262,127,135,239.0,248.2,317.1
797,尔滨,20240307,322,144,178,262.0,266.0,286.2
798,尔滨,20240308,230,102,128,322.0,267.0,266.2
799,尔滨,20240309,185,76,109,230.0,247.6,250.4
800,尔滨,20240310,201,76,125,185.0,240.0,242.7
801,尔滨,20240311,221,104,117,201.0,231.8,240.0
802,尔滨,20240312,239,129,110,221.0,215.2,240.6
803,尔滨,20240313,219,91,128,239.0,213.0,240.0
804,尔滨,20240314,241,123,118,219.0,224.2,235.9
805,尔滨,20240315,253,106,147,241.0,234.6,237.3
806,尔滨,20240316,227,78,149,253.0,235.8,233.8
807,尔滨,20240317,210,78,132,227.0,230.0,222.6
808,尔滨,20240318,249,127,122,210.0,236.0,224.5
809,尔滨,20240319,243,120,123,249.0,236.4,230.3
810,尔滨,20240320,208,104,104,243.0,227.4,231.0
811,尔滨,20240321,210,110,100,208.0,224.0,229.9
812,尔滨,20240322,186,99,87,210.0,219.2,224.6
813,尔滨,20240323,179,80,99,186.0,205.2,220.6
814,尔滨,20240324,214,82,132,179.0,199.4,217.9
815,尔滨,20240325,186,89,97,214.0,195.0,211.2
816,尔滨,20240326,218,106,112,186.0,196.6,210.3
817,尔滨,20240327,217,95,122,218.0,202.8,211.0
818,尔滨,20240328,198,102,96,217.0,206.6,205.9
819,尔滨,20240329,186,78,108,198.0,201.0,200.2
820,尔滨,20240330,178,76,102,186.0,199.4,197.2
821,尔滨,20240331,160,68,92,178.0,187.8,192.2
822,尔滨,20240401,194,95,99,160.0,183.2,193.0
823,尔滨,20240402,192,101,91,194.0,182.0,194.3
824,尔滨,20240403,177,80,97,192.0,180.2,190.6
825,尔滨,20240404,163,68,95,177.0,177.2,188.3
826,尔滨,20240405,163,66,97,163.0,177.8,182.8
827,尔滨,20240406,177,82,95,163.0,174.4,178.8
828,尔滨,20240407,209,104,105,177.0,177.8,179.9
829,尔滨,20240408,185,89,96,209.0,179.4,179.8
830,尔滨,20240409,194,99,95,185.0,185.6,181.4
831,尔滨,20240410,190,99,91,194.0,191.0,184.4
832,尔滨,20240411,177,93,84,190.0,191.0,182.7
833,尔滨,20240412,177,93,84,177.0,184.6,181.2
834,尔滨,20240413,171,76,95,177.0,181.8,180.6
835,尔滨,20240414,177,82,95,171.0,178.4,182.0
836,尔滨,20240415,181,97,84,177.0,176.6,183.8
837,尔滨,20240416,195,87,108,181.0,180.2,185.6
838,尔滨,20240417,193,101,92,195.0,183.4,184.0
839,尔滨,20240418,180,85,95,193.0,185.2,183.5
840,尔滨,20240419,170,74,96,180.0,183.8,181.1
841,尔滨,20240420,167,80,87,170.0,181.0,178.8
842,尔滨,20240421,195,83,112,167.0,181.0,180.6
843,尔滨,20240422,182,83,99,195.0,178.8,181.1
844,尔滨,20240423,175,97,78,182.0,177.8,181.5
845,尔滨,20240424,179,82,97,175.0,179.6,181.7
846,尔滨,20240425,174,85,89,179.0,181.0,181.0
847,尔滨,20240426,179,87,92,174.0,177.8,179.4
848,尔滨,20240427,175,66,109,179.0,176.4,177.6
849,尔滨,20240428,194,95,99,175.0,180.2,179.0
850,尔滨,20240429,158,78,80,194.0,176.0,177.8
851,尔滨,20240430,163,76,87,158.0,173.8,177.4
1,冰雪大世界,20220101,1027,114,913,163.0,343.4,260.6
2,冰雪大世界,20220102,993,129,864,1027.0,507.0,341.7
3,冰雪大世界,20220103,986,142,844,993.0,665.4,422.8
4,冰雪大世界,20220104,1035,193,842,986.0,840.8,508.4
5,冰雪大世界,20220105,966,166,800,1035.0,1001.4,587.6
6,冰雪大世界,20220106,956,176,780,966.0,987.2,665.3
7,冰雪大世界,20220107,845,162,683,956.0,957.6,732.3
8,冰雪大世界,20220108,879,97,782,845.0,936.2,800.8
9,冰雪大世界,20220109,849,114,735,879.0,899.0,869.9
10,冰雪大世界,20220110,847,163,684,849.0,875.2,938.3
11,冰雪大世界,20220111,776,148,628,847.0,839.2,913.2
12,冰雪大世界,20220112,754,157,597,776.0,821.0,889.3
13,冰雪大世界,20220113,836,170,666,754.0,812.4,874.3
14,冰雪大世界,20220114,826,168,658,836.0,807.8,853.4
15,冰雪大世界,20220115,790,95,695,826.0,796.4,835.8
16,冰雪大世界,20220116,730,102,628,790.0,787.2,813.2
17,冰雪大世界,20220117,712,172,540,730.0,778.8,799.9
18,冰雪大世界,20220118,680,127,553,712.0,747.6,780.0
19,冰雪大世界,20220119,600,129,471,680.0,702.4,755.1
20,冰雪大世界,20220120,655,159,496,600.0,675.4,735.9
21,冰雪大世界,20220121,727,118,609,655.0,674.8,731.0
22,冰雪大世界,20220122,727,118,609,727.0,677.8,728.3
23,冰雪大世界,20220123,715,95,620,727.0,684.8,716.2
24,冰雪大世界,20220124,654,108,546,715.0,695.6,699.0
25,冰雪大世界,20220125,617,110,507,654.0,688.0,681.7
26,冰雪大世界,20220126,656,125,531,617.0,673.8,674.3
27,冰雪大世界,20220127,655,131,524,656.0,659.4,668.6
28,冰雪大世界,20220128,690,152,538,655.0,654.4,669.6
29,冰雪大世界,20220129,696,125,571,690.0,662.8,679.2
30,冰雪大世界,20220130,568,93,475,696.0,653.0,670.5
31,冰雪大世界,20220131,592,70,522,568.0,640.2,657.0
32,冰雪大世界,20220201,898,91,807,592.0,688.8,674.1
33,冰雪大世界,20220202,974,106,868,898.0,745.6,700.0
34,冰雪大世界,20220203,965,85,880,974.0,799.4,731.1
35,冰雪大世界,20220204,983,91,892,965.0,882.4,767.7
36,冰雪大世界,20220205,975,106,869,983.0,959.0,799.6
37,冰雪大世界,20220206,938,97,841,975.0,967.0,827.9
38,冰雪大世界,20220207,918,166,752,938.0,955.8,850.7
39,冰雪大世界,20220208,855,150,705,918.0,933.8,866.6
40,冰雪大世界,20220209,757,150,607,855.0,888.6,885.5
41,冰雪大世界,20220210,813,161,652,757.0,856.2,907.6
42,冰雪大世界,20220211,794,157,637,813.0,827.4,897.2
43,冰雪大世界,20220212,747,104,643,794.0,793.2,874.5
44,冰雪大世界,20220213,776,106,670,747.0,777.4,855.6
45,冰雪大世界,20220214,742,165,577,776.0,774.4,831.5
46,冰雪大世界,20220215,842,161,681,742.0,780.2,818.2
47,冰雪大世界,20220216,631,121,510,842.0,747.6,787.5
48,冰雪大世界,20220217,627,154,473,631.0,723.6,758.4
49,冰雪大世界,20220218,647,151,496,627.0,697.8,737.6
50,冰雪大世界,20220219,604,99,505,647.0,670.2,722.3
51,冰雪大世界,20220220,633,93,540,604.0,628.4,704.3
52,冰雪大世界,20220221,544,137,407,633.0,611.0,679.3
53,冰雪大世界,20220222,553,139,414,544.0,596.2,659.9
54,冰雪大世界,20220223,573,123,450,553.0,581.4,639.6
55,冰雪大世界,20220224,623,133,490,573.0,585.2,627.7
56,冰雪大世界,20220225,576,118,458,623.0,573.8,601.1
57,冰雪大世界,20220226,572,83,489,576.0,579.4,595.2
58,冰雪大世界,20220227,531,83,448,572.0,575.0,585.6
59,冰雪大世界,20220228,430,99,331,531.0,546.4,563.9
60,冰雪大世界,20220301,356,120,236,430.0,493.0,539.1
61,冰雪大世界,20220302,314,99,215,356.0,440.6,507.2
62,冰雪大世界,20220303,295,87,208,314.0,385.2,482.3
63,冰雪大世界,20220304,287,95,192,295.0,336.4,455.7
64,冰雪大世界,20220305,312,93,219,287.0,312.8,429.6
65,冰雪大世界,20220306,300,68,232,312.0,301.6,397.3
66,冰雪大世界,20220307,290,95,195,300.0,296.8,368.7
67,冰雪大世界,20220308,296,91,205,290.0,297.0,341.1
68,冰雪大世界,20220309,278,97,181,296.0,295.2,315.8
69,冰雪大世界,20220310,271,87,184,278.0,287.0,299.9
70,冰雪大世界,20220311,285,104,181,271.0,284.0,292.8
71,冰雪大世界,20220312,259,76,183,285.0,277.8,287.3
72,冰雪大世界,20220313,265,70,195,259.0,271.6,284.3
73,冰雪大世界,20220314,241,83,158,265.0,264.2,279.7
74,冰雪大世界,20220315,282,102,180,241.0,266.4,276.7
75,冰雪大世界,20220316,243,91,152,282.0,258.0,271.0
76,冰雪大世界,20220317,291,102,189,243.0,264.4,271.1
77,冰雪大世界,20220318,272,99,173,291.0,265.8,268.7
78,冰雪大世界,20220319,264,87,177,272.0,270.4,267.3
79,冰雪大世界,20220320,244,76,168,264.0,262.8,264.6
80,冰雪大世界,20220321,248,80,168,244.0,263.8,260.9
81,冰雪大世界,20220322,276,91,185,248.0,260.8,262.6
82,冰雪大世界,20220323,271,74,197,276.0,260.6,263.2
83,冰雪大世界,20220324,246,85,161,271.0,257.0,263.7
84,冰雪大世界,20220325,254,91,163,246.0,259.0,260.9
85,冰雪大世界,20220326,254,83,171,254.0,260.2,262.0
86,冰雪大世界,20220327,261,78,183,254.0,257.2,259.0
87,冰雪大世界,20220328,233,82,151,261.0,249.6,255.1
88,冰雪大世界,20220329,236,93,143,233.0,247.6,252.3
89,冰雪大世界,20220330,248,78,170,236.0,246.4,252.7
90,冰雪大世界,20220331,246,89,157,248.0,244.8,252.5
91,冰雪大世界,20220401,225,76,149,246.0,237.6,247.4
92,冰雪大世界,20220402,198,64,134,225.0,230.6,240.1
93,冰雪大世界,20220403,217,72,145,198.0,226.8,237.2
94,冰雪大世界,20220404,226,66,160,217.0,222.4,234.4
95,冰雪大世界,20220405,224,70,154,226.0,218.0,231.4
96,冰雪大世界,20220406,241,82,159,224.0,221.2,229.4
97,冰雪大世界,20220407,242,87,155,241.0,230.0,230.3
98,冰雪大世界,20220408,227,72,155,242.0,232.0,229.4
99,冰雪大世界,20220409,250,74,176,227.0,236.8,229.6
100,冰雪大世界,20220410,252,70,182,250.0,242.4,230.2
101,冰雪大世界,20220411,224,76,148,252.0,239.0,230.1
102,冰雪大世界,20220412,240,80,160,224.0,238.6,234.3
103,冰雪大世界,20220413,225,74,151,240.0,238.2,235.1
104,冰雪大世界,20220414,235,68,167,225.0,235.2,236.0
105,冰雪大世界,20220415,229,70,159,235.0,230.6,236.5
106,冰雪大世界,20220416,257,74,183,229.0,237.2,238.1
107,冰雪大世界,20220417,255,70,185,257.0,240.2,239.4
108,冰雪大世界,20220418,236,72,164,255.0,242.4,240.3
109,冰雪大世界,20220419,247,89,158,236.0,244.8,240.0
110,冰雪大世界,20220420,253,102,151,247.0,249.6,240.1
111,冰雪大世界,20220421,254,80,174,253.0,249.0,243.1
112,冰雪大世界,20220422,260,93,167,254.0,250.0,245.1
113,冰雪大世界,20220423,240,66,174,260.0,250.8,246.6
114,冰雪大世界,20220424,248,78,170,240.0,251.0,247.9
115,冰雪大世界,20220425,238,83,155,248.0,248.0,248.8
116,冰雪大世界,20220426,263,83,180,238.0,249.8,249.4
117,冰雪大世界,20220427,254,80,174,263.0,248.6,249.3
118,冰雪大世界,20220428,236,63,173,254.0,247.8,249.3
119,冰雪大世界,20220429,223,72,151,236.0,242.8,246.9
120,冰雪大世界,20220430,234,63,171,223.0,242.0,245.0
121,冰雪大世界,20220501,231,63,168,234.0,235.6,242.7
122,冰雪大世界,20220502,247,68,179,231.0,234.2,241.4
123,冰雪大世界,20220503,236,66,170,247.0,234.2,241.0
124,冰雪大世界,20220504,263,74,189,236.0,242.2,242.5
125,冰雪大世界,20220505,206,74,132,263.0,236.6,239.3
126,冰雪大世界,20220506,223,74,149,206.0,235.0,235.3
127,冰雪大世界,20220507,221,72,149,223.0,229.8,232.0
128,冰雪大世界,20220508,228,63,165,221.0,228.2,231.2
129,冰雪大世界,20220509,255,101,154,228.0,226.6,234.4
130,冰雪大世界,20220510,243,85,158,255.0,234.0,235.3
131,冰雪大世界,20220511,240,82,158,243.0,237.4,236.2
132,冰雪大世界,20220512,238,87,151,240.0,240.8,235.3
133,冰雪大世界,20220513,241,82,159,238.0,243.4,235.8
134,冰雪大世界,20220514,261,76,185,241.0,244.6,235.6
135,冰雪大世界,20220515,240,66,174,261.0,244.0,239.0
136,冰雪大世界,20220516,235,80,155,240.0,243.0,240.2
137,冰雪大世界,20220517,242,87,155,235.0,243.8,242.3
138,冰雪大世界,20220518,247,80,167,242.0,245.0,244.2
139,冰雪大世界,20220519,219,78,141,247.0,236.6,240.6
140,冰雪大世界,20220520,222,70,152,219.0,233.0,238.5
141,冰雪大世界,20220521,215,68,147,222.0,229.0,236.0
142,冰雪大世界,20220522,258,74,184,215.0,232.2,238.0
143,冰雪大世界,20220523,245,78,167,258.0,231.8,238.4
144,冰雪大世界,20220524,244,83,161,245.0,236.8,236.7
145,冰雪大世界,20220525,253,76,177,244.0,243.0,238.0
146,冰雪大世界,20220526,258,95,163,253.0,251.6,240.3
147,冰雪大世界,20220527,229,78,151,258.0,245.8,239.0
148,冰雪大世界,20220528,231,72,159,229.0,243.0,237.4
149,冰雪大世界,20220529,242,74,168,231.0,242.6,239.7
150,冰雪大世界,20220530,249,85,164,242.0,241.8,242.4
151,冰雪大世界,20220531,231,76,155,249.0,236.4,244.0
152,冰雪大世界,20220601,259,89,170,231.0,242.4,244.1
153,冰雪大世界,20220602,225,74,151,259.0,241.2,242.1
154,冰雪大世界,20220603,257,72,185,225.0,244.2,243.4
155,冰雪大世界,20220604,259,72,187,257.0,246.2,244.0
156,冰雪大世界,20220605,258,80,178,259.0,251.6,244.0
157,冰雪大世界,20220606,227,83,144,258.0,245.2,243.8
158,冰雪大世界,20220607,264,97,167,227.0,253.0,247.1
159,冰雪大世界,20220608,268,83,185,264.0,255.2,249.7
160,冰雪大世界,20220609,8154,2423,5731,268.0,1834.2,1040.2
161,冰雪大世界,20220610,2467,831,1636,8154.0,2276.0,1263.8
162,冰雪大世界,20220611,685,108,577,2467.0,2367.6,1306.4
163,冰雪大世界,20220612,390,89,301,685.0,2392.8,1322.9
164,冰雪大世界,20220613,465,131,334,390.0,2432.2,1343.7
165,冰雪大世界,20220614,365,101,264,465.0,874.4,1354.3
166,冰雪大世界,20220615,281,83,198,365.0,437.2,1356.6
167,冰雪大世界,20220616,288,95,193,281.0,357.8,1362.7
168,冰雪大世界,20220617,288,99,189,288.0,337.4,1365.1
169,冰雪大世界,20220618,281,63,218,288.0,300.6,1366.4
170,冰雪大世界,20220619,282,70,212,281.0,284.0,579.2
171,冰雪大世界,20220620,253,83,170,282.0,278.4,357.8
172,冰雪大世界,20220621,283,83,200,253.0,277.4,317.6
173,冰雪大世界,20220622,272,85,187,283.0,274.2,305.8
174,冰雪大世界,20220623,284,78,206,272.0,274.8,287.7
175,冰雪大世界,20220624,265,80,185,284.0,271.4,277.7
176,冰雪大世界,20220625,238,64,174,265.0,268.4,273.4
177,冰雪大世界,20220626,235,78,157,238.0,258.8,268.1
178,冰雪大世界,20220627,280,102,178,235.0,260.4,267.3
179,冰雪大世界,20220628,282,93,189,280.0,260.0,267.4
180,冰雪大世界,20220629,279,112,167,282.0,262.8,267.1
181,冰雪大世界,20220630,253,82,171,279.0,265.8,267.1
182,冰雪大世界,20220701,284,89,195,253.0,275.6,267.2
183,冰雪大世界,20220702,259,70,189,284.0,271.4,265.9
184,冰雪大世界,20220703,290,85,205,259.0,273.0,266.5
185,冰雪大世界,20220704,264,87,177,290.0,270.0,266.4
186,冰雪大世界,20220705,268,101,167,264.0,273.0,269.4
187,冰雪大世界,20220706,253,76,177,268.0,266.8,271.2
188,冰雪大世界,20220707,270,97,173,253.0,269.0,270.2
189,冰雪大世界,20220708,259,85,174,270.0,262.8,267.9
190,冰雪大世界,20220709,270,70,200,259.0,264.0,267.0
191,冰雪大世界,20220710,263,64,199,270.0,263.0,268.0
192,冰雪大世界,20220711,266,82,184,263.0,265.6,266.2
193,冰雪大世界,20220712,284,95,189,266.0,268.4,268.7
194,冰雪大世界,20220713,267,87,180,284.0,270.0,266.4
195,冰雪大世界,20220714,272,87,185,267.0,270.4,267.2
196,冰雪大世界,20220715,262,72,190,272.0,270.2,266.6
197,冰雪大世界,20220716,251,80,171,262.0,267.2,266.4
198,冰雪大世界,20220717,286,80,206,251.0,267.6,268.0
199,冰雪大世界,20220718,284,104,180,286.0,271.0,270.5
200,冰雪大世界,20220719,282,89,193,284.0,273.0,271.7
201,冰雪大世界,20220720,269,85,184,282.0,274.4,272.3
202,冰雪大世界,20220721,297,101,196,269.0,283.6,275.4
203,冰雪大世界,20220722,295,87,208,297.0,285.4,276.5
204,冰雪大世界,20220723,289,64,225,295.0,286.4,278.7
205,冰雪大世界,20220724,307,76,231,289.0,291.4,282.2
206,冰雪大世界,20220725,294,89,205,307.0,296.4,285.4
207,冰雪大世界,20220726,274,68,206,294.0,291.8,287.7
208,冰雪大世界,20220727,281,82,199,274.0,289.0,287.2
209,冰雪大世界,20220728,268,76,192,281.0,284.8,285.6
210,冰雪大世界,20220729,275,78,197,268.0,278.4,284.9
211,冰雪大世界,20220730,314,66,248,275.0,282.4,289.4
212,冰雪大世界,20220731,304,80,224,314.0,288.4,290.1
213,冰雪大世界,20220801,263,74,189,304.0,284.8,286.9
214,冰雪大世界,20220802,282,85,197,263.0,287.6,286.2
215,冰雪大世界,20220803,300,97,203,282.0,292.6,285.5
216,冰雪大世界,20220804,301,97,204,300.0,290.0,286.2
217,冰雪大世界,20220805,302,97,205,301.0,289.6,289.0
218,冰雪大世界,20220806,276,61,215,302.0,292.2,288.5
219,冰雪大世界,20220807,283,61,222,276.0,292.4,290.0
220,冰雪大世界,20220808,296,97,199,283.0,291.6,292.1
221,冰雪大世界,20220809,333,85,248,296.0,298.0,294.0
222,冰雪大世界,20220810,310,89,221,333.0,299.6,294.6
223,冰雪大世界,20220811,309,95,214,310.0,306.2,299.2
224,冰雪大世界,20220812,292,91,201,309.0,308.0,300.2
225,冰雪大世界,20220813,293,66,227,292.0,307.4,299.5
226,冰雪大世界,20220814,301,63,238,293.0,301.0,299.5
227,冰雪大世界,20220815,302,87,215,301.0,299.4,299.5
228,冰雪大世界,20220816,297,80,217,302.0,297.0,301.6
229,冰雪大世界,20220817,292,80,212,297.0,297.0,302.5
230,冰雪大世界,20220818,292,83,209,292.0,296.8,302.1
231,冰雪大世界,20220819,329,101,228,292.0,302.4,301.7
232,冰雪大世界,20220820,275,76,199,329.0,297.0,298.2
233,冰雪大世界,20220821,281,70,211,275.0,293.8,295.4
234,冰雪大世界,20220822,299,91,208,281.0,295.2,296.1
235,冰雪大世界,20220823,296,101,195,299.0,296.0,296.4
236,冰雪大世界,20220824,306,87,219,296.0,291.4,296.9
237,冰雪大世界,20220825,320,116,204,306.0,300.4,298.7
238,冰雪大世界,20220826,297,85,212,320.0,303.6,298.7
239,冰雪大世界,20220827,267,66,201,297.0,297.2,296.2
240,冰雪大世界,20220828,267,66,201,267.0,291.4,293.7
241,冰雪大世界,20220829,297,89,208,267.0,289.6,290.5
242,冰雪大世界,20220830,261,99,162,297.0,277.8,289.1
243,冰雪大世界,20220831,265,80,185,261.0,271.4,287.5
244,冰雪大世界,20220901,259,80,179,265.0,269.8,283.5
245,冰雪大世界,20220902,247,85,162,259.0,265.8,278.6
246,冰雪大世界,20220903,252,78,174,247.0,256.8,273.2
247,冰雪大世界,20220904,241,76,165,252.0,252.8,265.3
248,冰雪大世界,20220905,268,89,179,241.0,253.4,262.4
249,冰雪大世界,20220906,258,76,182,268.0,253.2,261.5
250,冰雪大世界,20220907,301,82,219,258.0,264.0,264.9
251,冰雪大世界,20220908,283,106,177,301.0,270.2,263.5
252,冰雪大世界,20220909,278,74,204,283.0,277.6,265.2
253,冰雪大世界,20220910,274,63,211,278.0,278.8,266.1
254,冰雪大世界,20220911,317,74,243,274.0,290.6,271.9
255,冰雪大世界,20220912,307,76,231,317.0,291.8,277.9
256,冰雪大世界,20220913,302,97,205,307.0,295.6,282.9
257,冰雪大世界,20220914,332,104,228,302.0,306.4,292.0
258,冰雪大世界,20220915,312,101,211,332.0,314.0,296.4
259,冰雪大世界,20220916,291,87,204,312.0,308.8,299.7
260,冰雪大世界,20220917,261,72,189,291.0,299.6,295.7
261,冰雪大世界,20220918,356,76,280,261.0,310.4,303.0
262,冰雪大世界,20220919,315,97,218,356.0,307.0,306.7
263,冰雪大世界,20220920,307,95,212,315.0,306.0,310.0
264,冰雪大世界,20220921,300,102,198,307.0,307.8,308.3
265,冰雪大世界,20220922,274,97,177,300.0,310.4,305.0
266,冰雪大世界,20220923,297,95,202,274.0,298.6,304.5
267,冰雪大世界,20220924,291,82,209,297.0,293.8,300.4
268,冰雪大世界,20220925,274,74,200,291.0,287.2,296.6
269,冰雪大世界,20220926,289,91,198,274.0,285.0,296.4
270,冰雪大世界,20220927,302,104,198,289.0,290.6,300.5
271,冰雪大世界,20220928,283,82,201,302.0,287.8,293.2
272,冰雪大世界,20220929,273,80,193,283.0,284.2,289.0
273,冰雪大世界,20220930,298,99,199,273.0,289.0,288.1
274,冰雪大世界,20221001,297,80,217,298.0,290.6,287.8
275,冰雪大世界,20221002,306,74,232,297.0,291.4,291.0
276,冰雪大世界,20221003,312,70,242,306.0,297.2,292.5
277,冰雪大世界,20221004,305,70,235,312.0,303.6,293.9
278,冰雪大世界,20221005,325,83,242,305.0,309.0,299.0
279,冰雪大世界,20221006,345,95,250,325.0,318.6,304.6
280,冰雪大世界,20221007,326,83,243,345.0,322.6,307.0
281,冰雪大世界,20221008,318,97,221,326.0,323.8,310.5
282,冰雪大世界,20221009,330,101,229,318.0,328.8,316.2
283,冰雪大世界,20221010,326,104,222,330.0,329.0,319.0
284,冰雪大世界,20221011,333,116,217,326.0,326.6,322.6
285,冰雪大世界,20221012,311,106,205,333.0,323.6,323.1
286,冰雪大世界,20221013,321,97,224,311.0,324.2,324.0
287,冰雪大世界,20221014,319,101,218,321.0,322.0,325.4
288,冰雪大世界,20221015,290,91,199,319.0,314.8,321.9
289,冰雪大世界,20221016,312,80,232,290.0,310.6,318.6
290,冰雪大世界,20221017,378,116,262,312.0,324.0,323.8
291,冰雪大世界,20221018,388,127,261,378.0,337.4,330.8
292,冰雪大世界,20221019,342,118,224,388.0,342.0,332.0
293,冰雪大世界,20221020,347,120,227,342.0,353.4,334.1
294,冰雪大世界,20221021,364,116,248,347.0,363.8,337.2
295,冰雪大世界,20221022,335,82,253,364.0,355.2,339.6
296,冰雪大世界,20221023,340,83,257,335.0,345.6,341.5
297,冰雪大世界,20221024,318,104,214,340.0,340.8,341.4
298,冰雪大世界,20221025,330,116,214,318.0,337.4,345.4
299,冰雪大世界,20221026,368,104,264,330.0,338.2,351.0
300,冰雪大世界,20221027,374,142,232,368.0,346.0,350.6
301,冰雪大世界,20221028,342,97,245,374.0,346.4,346.0
302,冰雪大世界,20221029,317,85,232,342.0,346.2,343.5
303,冰雪大世界,20221030,303,64,239,317.0,340.8,339.1
304,冰雪大世界,20221031,340,99,241,303.0,335.2,336.7
305,冰雪大世界,20221101,315,87,228,340.0,323.4,334.7
306,冰雪大世界,20221102,376,112,264,315.0,330.2,338.3
307,冰雪大世界,20221103,356,104,252,376.0,338.0,342.1
308,冰雪大世界,20221104,343,129,214,356.0,346.0,343.4
309,冰雪大世界,20221105,333,74,259,343.0,344.6,339.9
310,冰雪大世界,20221106,343,95,248,333.0,350.2,336.8
311,冰雪大世界,20221107,336,83,253,343.0,342.2,336.2
312,冰雪大世界,20221108,359,106,253,336.0,342.8,340.4
313,冰雪大世界,20221109,431,121,310,359.0,360.4,353.2
314,冰雪大世界,20221110,578,183,395,431.0,409.4,377.0
315,冰雪大世界,20221111,416,118,298,578.0,424.0,387.1
316,冰雪大世界,20221112,466,101,365,416.0,450.0,396.1
317,冰雪大世界,20221113,459,78,381,466.0,470.0,406.4
318,冰雪大世界,20221114,432,127,305,459.0,470.2,415.3
319,冰雪大世界,20221115,428,125,303,432.0,440.2,424.8
320,冰雪大世界,20221116,452,125,327,428.0,447.4,435.7
321,冰雪大世界,20221117,481,127,354,452.0,450.4,450.2
322,冰雪大世界,20221118,493,131,362,481.0,457.2,463.6
323,冰雪大世界,20221119,395,83,312,493.0,449.8,460.0
324,冰雪大世界,20221120,395,76,319,395.0,443.2,441.7
325,冰雪大世界,20221121,435,114,321,395.0,439.8,443.6
326,冰雪大世界,20221122,514,148,366,435.0,446.4,448.4
327,冰雪大世界,20221123,461,144,317,514.0,440.0,448.6
328,冰雪大世界,20221124,457,104,353,461.0,452.4,451.1
329,冰雪大世界,20221125,473,120,353,457.0,468.0,455.6
330,冰雪大世界,20221126,457,83,374,473.0,472.4,456.1
331,冰雪大世界,20221127,456,97,359,457.0,460.8,453.6
332,冰雪大世界,20221128,567,123,444,456.0,482.0,461.0
333,冰雪大世界,20221129,661,140,521,567.0,522.8,487.6
334,冰雪大世界,20221130,653,170,483,661.0,558.8,513.4
335,冰雪大世界,20221201,669,168,501,653.0,601.2,536.8
336,冰雪大世界,20221202,582,152,430,669.0,626.4,543.6
337,冰雪大世界,20221203,617,121,496,582.0,636.4,559.2
338,冰雪大世界,20221204,655,104,551,617.0,635.2,579.0
339,冰雪大世界,20221205,813,182,631,655.0,667.2,613.0
340,冰雪大世界,20221206,771,158,613,813.0,687.6,644.4
341,冰雪大世界,20221207,906,242,664,771.0,752.4,689.4
342,冰雪大世界,20221208,1108,253,855,906.0,850.6,743.5
343,冰雪大世界,20221209,947,213,734,1108.0,909.0,772.1
344,冰雪大世界,20221210,813,142,671,947.0,909.0,788.1
345,冰雪大世界,20221211,949,146,803,813.0,944.6,816.1
346,冰雪大世界,20221212,893,220,673,949.0,942.0,847.2
347,冰雪大世界,20221213,767,186,581,893.0,873.8,862.2
348,冰雪大世界,20221214,850,198,652,767.0,854.4,881.7
349,冰雪大世界,20221215,864,194,670,850.0,864.6,886.8
350,冰雪大世界,20221216,829,179,650,864.0,840.6,892.6
351,冰雪大世界,20221217,1021,179,842,829.0,866.2,904.1
352,冰雪大世界,20221218,811,151,660,1021.0,875.0,874.4
353,冰雪大世界,20221219,772,201,571,811.0,859.4,856.9
354,冰雪大世界,20221220,729,175,554,772.0,832.4,848.5
355,冰雪大世界,20221221,765,161,604,729.0,819.6,830.1
356,冰雪大世界,20221222,782,162,620,765.0,771.8,819.0
357,冰雪大世界,20221223,789,187,602,782.0,767.4,821.2
358,冰雪大世界,20221224,782,127,655,789.0,769.4,814.4
359,冰雪大世界,20221225,858,148,710,782.0,795.2,813.8
360,冰雪大世界,20221226,947,205,742,858.0,831.6,825.6
361,冰雪大世界,20221227,976,233,743,947.0,870.4,821.1
362,冰雪大世界,20221228,1062,218,844,976.0,925.0,846.2
363,冰雪大世界,20221229,1056,226,830,1062.0,979.8,874.6
364,冰雪大世界,20221230,1096,233,863,1056.0,1027.4,911.3
365,冰雪大世界,20221231,1068,159,909,1096.0,1051.6,941.6
366,冰雪大世界,20230101,1013,152,861,1068.0,1059.0,964.7
367,冰雪大世界,20230102,996,180,816,1013.0,1045.8,985.4
368,冰雪大世界,20230103,1118,268,850,996.0,1058.2,1019.0
369,冰雪大世界,20230104,1143,290,853,1118.0,1067.6,1047.5
370,冰雪大世界,20230105,1206,316,890,1143.0,1095.2,1073.4
371,冰雪大世界,20230106,1142,287,855,1206.0,1121.0,1090.0
372,冰雪大世界,20230107,1041,182,859,1142.0,1130.0,1087.9
373,冰雪大世界,20230108,1029,168,861,1041.0,1112.2,1085.2
374,冰雪大世界,20230109,1134,270,864,1029.0,1110.4,1089.0
375,冰雪大世界,20230110,1161,274,887,1134.0,1101.4,1098.3
376,冰雪大世界,20230111,1161,264,897,1161.0,1105.2,1113.1
377,冰雪大世界,20230112,1192,271,921,1161.0,1135.4,1132.7
378,冰雪大世界,20230113,1153,256,897,1192.0,1160.2,1136.2
379,冰雪大世界,20230114,1090,179,911,1153.0,1151.4,1130.9
380,冰雪大世界,20230115,1091,163,928,1090.0,1137.4,1119.4
381,冰雪大世界,20230116,1196,276,920,1091.0,1144.4,1124.8
382,冰雪大世界,20230117,1160,256,904,1196.0,1138.0,1136.7
383,冰雪大世界,20230118,1130,212,918,1160.0,1133.4,1146.8
384,冰雪大世界,20230119,1080,193,887,1130.0,1131.4,1141.4
385,冰雪大世界,20230120,1050,166,884,1080.0,1123.2,1130.3
386,冰雪大世界,20230121,941,99,842,1050.0,1072.2,1108.3
387,冰雪大世界,20230122,1050,102,948,941.0,1050.2,1094.1
388,冰雪大世界,20230123,1099,137,962,1050.0,1044.0,1088.7
389,冰雪大世界,20230124,1126,142,984,1099.0,1053.2,1092.3
390,冰雪大世界,20230125,1163,121,1042,1126.0,1075.8,1099.5
391,冰雪大世界,20230126,1109,95,1014,1163.0,1109.4,1090.8
392,冰雪大世界,20230127,1076,114,962,1109.0,1114.6,1082.4
393,冰雪大世界,20230128,1186,233,953,1076.0,1132.0,1088.0
394,冰雪大世界,20230129,1143,229,914,1186.0,1135.4,1094.3
395,冰雪大世界,20230130,1129,229,900,1143.0,1128.6,1102.2
396,冰雪大世界,20230131,1143,234,909,1129.0,1135.4,1122.4
397,冰雪大世界,20230201,1105,218,887,1143.0,1141.2,1127.9
398,冰雪大世界,20230202,1079,200,879,1105.0,1119.8,1125.9
399,冰雪大世界,20230203,1101,197,904,1079.0,1111.4,1123.4
400,冰雪大世界,20230204,1082,190,892,1101.0,1102.0,1115.3
401,冰雪大世界,20230205,1028,137,891,1082.0,1079.0,1107.2
402,冰雪大世界,20230206,1026,183,843,1028.0,1063.2,1102.2
403,冰雪大世界,20230207,1042,201,841,1026.0,1055.8,1087.8
404,冰雪大世界,20230208,978,212,766,1042.0,1031.2,1071.3
405,冰雪大世界,20230209,1057,215,842,978.0,1026.2,1064.1
406,冰雪大世界,20230210,1034,176,858,1057.0,1027.4,1053.2
407,冰雪大世界,20230211,979,139,840,1034.0,1018.0,1040.6
408,冰雪大世界,20230212,889,154,735,979.0,987.4,1021.6
409,冰雪大世界,20230213,853,175,678,889.0,962.4,996.8
410,冰雪大世界,20230214,779,166,613,853.0,906.8,966.5
411,冰雪大世界,20230215,773,155,618,779.0,854.6,941.0
412,冰雪大世界,20230216,806,175,631,773.0,820.0,919.0
413,冰雪大世界,20230217,820,175,645,806.0,806.2,896.8
414,冰雪大世界,20230218,776,89,687,820.0,790.8,876.6
415,冰雪大世界,20230219,740,112,628,776.0,783.0,844.9
416,冰雪大世界,20230220,686,154,532,740.0,765.6,810.1
417,冰雪大世界,20230221,664,152,512,686.0,737.2,778.6
418,冰雪大世界,20230222,636,137,499,664.0,700.4,753.3
419,冰雪大世界,20230223,679,155,524,636.0,681.0,735.9
420,冰雪大世界,20230224,674,146,528,679.0,667.8,725.4
421,冰雪大世界,20230225,660,93,567,674.0,662.6,714.1
422,冰雪大世界,20230226,535,123,412,660.0,636.8,687.0
423,冰雪大世界,20230227,408,110,298,535.0,591.2,645.8
424,冰雪大世界,20230228,415,146,269,408.0,538.4,609.7
425,冰雪大世界,20230301,388,131,257,415.0,481.2,574.5
426,冰雪大世界,20230302,361,114,247,388.0,421.4,542.0
427,冰雪大世界,20230303,369,121,248,361.0,388.2,512.5
428,冰雪大世界,20230304,370,89,281,369.0,380.6,485.9
429,冰雪大世界,20230305,354,87,267,370.0,368.4,453.4
430,冰雪大世界,20230306,330,125,205,354.0,356.8,419.0
431,冰雪大世界,20230307,331,114,217,330.0,350.8,386.1
432,冰雪大世界,20230308,323,91,232,331.0,341.6,364.9
433,冰雪大世界,20230309,269,85,184,323.0,321.4,351.0
434,冰雪大世界,20230310,275,83,192,269.0,305.6,337.0
435,冰雪大世界,20230311,297,82,215,275.0,299.0,327.9
436,冰雪大世界,20230312,315,91,224,297.0,295.8,323.3
437,冰雪大世界,20230313,323,104,219,315.0,295.8,318.7
438,冰雪大世界,20230314,307,95,212,323.0,303.4,312.4
439,冰雪大世界,20230315,295,108,187,307.0,307.4,306.5
440,冰雪大世界,20230316,310,99,211,295.0,310.0,304.5
441,冰雪大世界,20230317,278,83,195,310.0,302.6,299.2
442,冰雪大世界,20230318,271,78,193,278.0,292.2,294.0
443,冰雪大世界,20230319,300,82,218,271.0,290.8,297.1
444,冰雪大世界,20230320,282,97,185,300.0,288.2,297.8
445,冰雪大世界,20230321,301,131,170,282.0,286.4,298.2
446,冰雪大世界,20230322,307,120,187,301.0,292.2,297.4
447,冰雪大世界,20230323,259,85,174,307.0,289.8,291.0
448,冰雪大世界,20230324,256,82,174,259.0,281.0,285.9
449,冰雪大世界,20230325,291,85,206,256.0,282.8,285.5
450,冰雪大世界,20230326,281,80,201,291.0,278.8,282.6
451,冰雪大世界,20230327,283,85,198,281.0,274.0,283.1
452,冰雪大世界,20230328,286,93,193,283.0,279.4,284.6
453,冰雪大世界,20230329,273,89,184,286.0,282.8,281.9
454,冰雪大世界,20230330,276,99,177,273.0,279.8,281.3
455,冰雪大世界,20230331,259,85,174,276.0,275.4,277.1
456,冰雪大世界,20230401,244,74,170,259.0,267.6,270.8
457,冰雪大世界,20230402,268,83,185,244.0,264.0,271.7
458,冰雪大世界,20230403,282,102,180,268.0,265.8,274.3
459,冰雪大世界,20230404,306,101,205,282.0,271.8,275.8
460,冰雪大世界,20230405,280,80,200,306.0,276.0,275.7
461,冰雪大世界,20230406,284,95,189,280.0,284.0,275.8
462,冰雪大世界,20230407,320,140,180,284.0,294.4,279.2
463,冰雪大世界,20230408,281,70,211,320.0,294.2,280.0
464,冰雪大世界,20230409,289,70,219,281.0,290.8,281.3
465,冰雪大世界,20230410,256,85,171,289.0,286.0,281.0
466,冰雪大世界,20230411,270,87,183,256.0,283.2,283.6
467,冰雪大世界,20230412,274,89,185,270.0,274.0,284.2
468,冰雪大世界,20230413,255,76,179,274.0,268.8,281.5
469,冰雪大世界,20230414,286,89,197,255.0,268.2,279.5
470,冰雪大世界,20230415,245,63,182,286.0,266.0,276.0
471,冰雪大世界,20230416,256,66,190,245.0,263.2,273.2
472,冰雪大世界,20230417,288,80,208,256.0,266.0,270.0
473,冰雪大世界,20230418,282,93,189,288.0,271.4,270.1
474,冰雪大世界,20230419,321,97,224,282.0,278.4,273.3
475,冰雪大世界,20230420,286,97,189,321.0,286.6,276.3
476,冰雪大世界,20230421,314,93,221,286.0,298.2,280.7
477,冰雪大世界,20230422,325,76,249,314.0,305.6,285.8
478,冰雪大世界,20230423,317,102,215,325.0,312.6,292.0
479,冰雪大世界,20230424,278,80,198,317.0,304.0,291.2
480,冰雪大世界,20230425,279,83,196,278.0,302.6,294.6
481,冰雪大世界,20230426,297,89,208,279.0,299.2,298.7
482,冰雪大世界,20230427,269,83,186,297.0,288.0,296.8
483,冰雪大世界,20230428,274,87,187,269.0,279.4,296.0
484,冰雪大世界,20230429,295,66,229,274.0,282.8,293.4
485,冰雪大世界,20230430,312,64,248,295.0,289.4,296.0
486,冰雪大世界,20230501,273,59,214,312.0,284.6,291.9
487,冰雪大世界,20230502,296,64,232,273.0,290.0,289.0
488,冰雪大世界,20230503,267,72,195,296.0,288.6,284.0
489,冰雪大世界,20230504,267,85,182,267.0,283.0,282.9
490,冰雪大世界,20230505,263,87,176,267.0,273.2,281.3
491,冰雪大世界,20230506,248,80,168,263.0,268.2,276.4
492,冰雪大世界,20230507,244,64,180,248.0,257.8,273.9
493,冰雪大世界,20230508,273,97,176,244.0,259.0,273.8
494,冰雪大世界,20230509,289,97,192,273.0,263.4,273.2
495,冰雪大世界,20230510,300,97,203,289.0,270.8,272.0
496,冰雪大世界,20230511,313,102,211,300.0,283.8,276.0
497,冰雪大世界,20230512,260,99,161,313.0,287.0,272.4
498,冰雪大世界,20230513,220,61,159,260.0,276.4,267.7
499,冰雪大世界,20230514,258,68,190,220.0,270.2,266.8
500,冰雪大世界,20230515,243,78,165,258.0,258.8,264.8
501,冰雪大世界,20230516,245,87,158,243.0,245.2,264.5
502,冰雪大世界,20230517,253,83,170,245.0,243.8,265.4
503,冰雪大世界,20230518,241,74,167,253.0,248.0,262.2
504,冰雪大世界,20230519,254,93,161,241.0,247.2,258.7
505,冰雪大世界,20230520,233,66,167,254.0,245.2,252.0
506,冰雪大世界,20230521,244,70,174,233.0,245.0,245.1
507,冰雪大世界,20230522,243,78,165,244.0,243.0,243.4
508,冰雪大世界,20230523,248,74,174,243.0,244.4,246.2
509,冰雪大世界,20230524,253,104,149,248.0,244.2,245.7
510,冰雪大世界,20230525,241,87,154,253.0,245.8,245.5
511,冰雪大世界,20230526,241,97,144,241.0,245.2,245.1
512,冰雪大世界,20230527,237,76,161,241.0,244.0,243.5
513,冰雪大世界,20230528,269,76,193,237.0,248.2,246.3
514,冰雪大世界,20230529,277,99,178,269.0,253.0,248.6
515,冰雪大世界,20230530,271,91,180,277.0,259.0,252.4
516,冰雪大世界,20230531,242,74,168,271.0,259.2,252.2
517,冰雪大世界,20230601,268,104,164,242.0,265.4,254.7
518,冰雪大世界,20230602,257,93,164,268.0,263.0,255.6
519,冰雪大世界,20230603,243,72,171,257.0,256.2,254.6
520,冰雪大世界,20230604,246,66,180,243.0,251.2,255.1
521,冰雪大世界,20230605,248,78,170,246.0,252.4,255.8
522,冰雪大世界,20230606,233,95,138,248.0,245.4,255.4
523,冰雪大世界,20230607,265,95,170,233.0,247.0,255.0
524,冰雪大世界,20230608,256,82,174,265.0,249.6,252.9
525,冰雪大世界,20230609,268,102,166,256.0,254.0,252.6
526,冰雪大世界,20230610,243,78,165,268.0,253.0,252.7
527,冰雪大世界,20230611,255,68,187,243.0,257.4,251.4
528,冰雪大世界,20230612,265,89,176,255.0,257.4,252.2
529,冰雪大世界,20230613,268,101,167,265.0,259.8,254.7
530,冰雪大世界,20230614,244,76,168,268.0,255.0,254.5
531,冰雪大世界,20230615,248,78,170,244.0,256.0,254.5
532,冰雪大世界,20230616,268,82,186,248.0,258.6,258.0
533,冰雪大世界,20230617,246,70,176,268.0,254.8,256.1
534,冰雪大世界,20230618,244,68,176,246.0,250.0,254.9
535,冰雪大世界,20230619,250,76,174,244.0,251.2,253.1
536,冰雪大世界,20230620,309,120,189,250.0,263.4,259.7
537,冰雪大世界,20230621,275,99,176,309.0,264.8,261.7
538,冰雪大世界,20230622,270,72,198,275.0,269.6,262.2
539,冰雪大世界,20230623,252,74,178,270.0,271.2,260.6
540,冰雪大世界,20230624,257,61,196,252.0,272.6,261.9
541,冰雪大世界,20230625,259,78,181,257.0,262.6,263.0
542,冰雪大世界,20230626,265,87,178,259.0,260.6,262.7
543,冰雪大世界,20230627,262,83,179,265.0,259.0,264.3
544,冰雪大世界,20230628,286,97,189,262.0,265.8,268.5
545,冰雪大世界,20230629,262,97,165,286.0,266.8,269.7
546,冰雪大世界,20230630,248,78,170,262.0,264.6,263.6
547,冰雪大世界,20230701,252,72,180,248.0,262.0,261.3
548,冰雪大世界,20230702,267,74,193,252.0,263.0,261.0
549,冰雪大世界,20230703,264,72,192,267.0,258.6,262.2
550,冰雪大世界,20230704,275,85,190,264.0,261.2,264.0
551,冰雪大世界,20230705,256,95,161,275.0,262.8,263.7
552,冰雪大世界,20230706,284,80,204,256.0,269.2,265.6
553,冰雪大世界,20230707,262,85,177,284.0,268.2,265.6
554,冰雪大世界,20230708,284,76,208,262.0,272.2,265.4
555,冰雪大世界,20230709,271,63,208,284.0,271.4,266.3
556,冰雪大世界,20230710,295,87,208,271.0,279.2,271.0
557,冰雪大世界,20230711,281,95,186,295.0,278.6,273.9
558,冰雪大世界,20230712,294,80,214,281.0,285.0,276.6
559,冰雪大世界,20230713,308,91,217,294.0,289.8,281.0
560,冰雪大世界,20230714,263,80,183,308.0,288.2,279.8
561,冰雪大世界,20230715,265,66,199,263.0,282.2,280.7
562,冰雪大世界,20230716,264,66,198,265.0,278.8,278.7
563,冰雪大世界,20230717,268,72,196,264.0,273.6,279.3
564,冰雪大世界,20230718,290,89,201,268.0,270.0,279.9
565,冰雪大世界,20230719,301,95,206,290.0,277.6,282.9
566,冰雪大世界,20230720,345,74,271,301.0,293.6,287.9
567,冰雪大世界,20230721,352,93,259,345.0,311.2,295.0
568,冰雪大世界,20230722,303,76,227,352.0,318.2,295.9
569,冰雪大世界,20230723,306,68,238,303.0,321.4,295.7
570,冰雪大世界,20230724,308,93,215,306.0,322.8,300.2
571,冰雪大世界,20230725,327,95,232,308.0,319.2,306.4
572,冰雪大世界,20230726,308,93,215,327.0,310.4,310.8
573,冰雪大世界,20230727,295,89,206,308.0,308.8,313.5
574,冰雪大世界,20230728,286,80,206,295.0,304.8,313.1
575,冰雪大世界,20230729,297,68,229,286.0,302.6,312.7
576,冰雪大世界,20230730,304,66,238,297.0,298.0,308.6
577,冰雪大世界,20230731,302,91,211,304.0,296.8,303.6
578,冰雪大世界,20230801,274,82,192,302.0,292.6,300.7
579,冰雪大世界,20230802,280,82,198,274.0,291.4,298.1
580,冰雪大世界,20230803,297,91,206,280.0,291.4,297.0
581,冰雪大世界,20230804,336,93,243,297.0,297.8,297.9
582,冰雪大世界,20230805,325,78,247,336.0,302.4,299.6
583,冰雪大世界,20230806,311,80,231,325.0,309.8,301.2
584,冰雪大世界,20230807,301,76,225,311.0,314.0,302.7
585,冰雪大世界,20230808,288,82,206,301.0,312.2,301.8
586,冰雪大世界,20230809,295,80,215,288.0,304.0,300.9
587,冰雪大世界,20230810,288,82,206,295.0,296.6,299.5
588,冰雪大世界,20230811,309,89,220,288.0,296.2,303.0
589,冰雪大世界,20230812,314,72,242,309.0,298.8,306.4
590,冰雪大世界,20230813,309,64,245,314.0,303.0,307.6
591,冰雪大世界,20230814,306,78,228,309.0,305.2,304.6
592,冰雪大世界,20230815,324,112,212,306.0,312.4,304.5
593,冰雪大世界,20230816,332,91,241,324.0,317.0,306.6
594,冰雪大世界,20230817,338,106,232,332.0,321.8,310.3
595,冰雪大世界,20230818,313,85,228,338.0,322.6,312.8
596,冰雪大世界,20230819,329,70,259,313.0,327.2,316.2
597,冰雪大世界,20230820,309,74,235,329.0,324.2,318.3
598,冰雪大世界,20230821,303,91,212,309.0,318.4,317.7
599,冰雪大世界,20230822,277,74,203,303.0,306.2,314.0
600,冰雪大世界,20230823,300,97,203,277.0,303.6,313.1
601,冰雪大世界,20230824,312,83,229,300.0,300.2,313.7
602,冰雪大世界,20230825,336,93,243,312.0,305.6,314.9
603,冰雪大世界,20230826,294,70,224,336.0,303.8,311.1
604,冰雪大世界,20230827,291,70,221,294.0,306.6,306.4
605,冰雪大世界,20230828,297,80,217,291.0,306.0,304.8
606,冰雪大世界,20230829,319,99,220,297.0,307.4,303.8
607,冰雪大世界,20230830,313,95,218,319.0,302.8,304.2
608,冰雪大世界,20230831,320,102,218,313.0,308.0,305.9
609,冰雪大世界,20230901,272,74,198,320.0,304.2,305.4
610,冰雪大世界,20230902,264,80,184,272.0,297.6,301.8
611,冰雪大世界,20230903,288,76,212,264.0,291.4,299.4
612,冰雪大世界,20230904,272,85,187,288.0,283.2,293.0
613,冰雪大世界,20230905,284,87,197,272.0,276.0,292.0
614,冰雪大世界,20230906,297,99,198,284.0,281.0,292.6
615,冰雪大世界,20230907,275,83,192,297.0,283.2,290.4
616,冰雪大世界,20230908,288,102,186,275.0,283.2,287.3
617,冰雪大世界,20230909,319,72,247,288.0,292.6,287.9
618,冰雪大世界,20230910,358,74,284,319.0,307.4,291.7
619,冰雪大世界,20230911,309,97,212,358.0,309.8,295.4
620,冰雪大世界,20230912,346,118,228,309.0,324.0,303.6
621,冰雪大世界,20230913,354,106,248,346.0,337.2,310.2
622,冰雪大世界,20230914,380,110,270,354.0,349.4,321.0
623,冰雪大世界,20230915,363,106,257,380.0,350.4,328.9
624,冰雪大世界,20230916,379,74,305,363.0,364.4,337.1
625,冰雪大世界,20230917,412,82,330,379.0,377.6,350.8
626,冰雪大世界,20230918,338,99,239,412.0,374.4,355.8
627,冰雪大世界,20230919,329,93,236,338.0,364.2,356.8
628,冰雪大世界,20230920,356,135,221,329.0,362.8,356.6
629,冰雪大世界,20230921,337,106,231,356.0,354.4,359.4
630,冰雪大世界,20230922,307,93,214,337.0,333.4,355.5
631,冰雪大世界,20230923,301,70,231,307.0,326.0,350.2
632,冰雪大世界,20230924,343,83,260,301.0,328.8,346.5
633,冰雪大世界,20230925,348,101,247,343.0,327.2,345.0
634,冰雪大世界,20230926,298,97,201,348.0,319.4,336.9
635,冰雪大世界,20230927,348,110,238,298.0,327.6,330.5
636,冰雪大世界,20230928,361,116,245,348.0,339.6,332.8
637,冰雪大世界,20230929,327,61,266,361.0,336.4,332.6
638,冰雪大世界,20230930,365,70,295,327.0,339.8,333.5
639,冰雪大世界,20231001,358,76,282,365.0,351.8,335.6
640,冰雪大世界,20231002,395,85,310,358.0,361.2,344.4
641,冰雪大世界,20231003,414,76,338,395.0,371.8,355.7
642,冰雪大世界,20231004,484,87,397,414.0,403.2,369.8
643,冰雪大世界,20231005,406,83,323,484.0,411.4,375.6
644,冰雪大世界,20231006,406,93,313,406.0,421.0,386.4
645,冰雪大世界,20231007,482,152,330,406.0,438.4,399.8
646,冰雪大世界,20231008,521,184,337,482.0,459.8,415.8
647,冰雪大世界,20231009,502,172,330,521.0,463.4,433.3
648,冰雪大世界,20231010,527,161,366,502.0,487.6,449.5
649,冰雪大世界,20231011,586,154,432,527.0,523.6,472.3
650,冰雪大世界,20231012,777,205,572,586.0,582.6,510.5
651,冰雪大世界,20231013,1055,290,765,777.0,689.4,574.6
652,冰雪大世界,20231014,1002,150,852,1055.0,789.4,626.4
653,冰雪大世界,20231015,1081,155,926,1002.0,900.2,693.9
654,冰雪大世界,20231016,1480,554,926,1081.0,1079.0,801.3
655,冰雪大世界,20231017,1317,431,886,1480.0,1187.0,884.8
656,冰雪大世界,20231018,1228,380,848,1317.0,1221.6,955.5
657,冰雪大世界,20231019,1158,319,839,1228.0,1252.8,1021.1
658,冰雪大世界,20231020,1137,332,805,1158.0,1264.0,1082.1
659,冰雪大世界,20231021,852,165,687,1137.0,1138.4,1108.7
660,冰雪大世界,20231022,850,146,704,852.0,1045.0,1116.0
661,冰雪大世界,20231023,1047,369,678,850.0,1008.8,1115.2
662,冰雪大世界,20231024,913,332,581,1047.0,959.8,1106.3
663,冰雪大世界,20231025,1070,456,614,913.0,946.4,1105.2
664,冰雪大世界,20231026,888,341,547,1070.0,953.6,1046.0
665,冰雪大世界,20231027,940,298,642,888.0,971.6,1008.3
666,冰雪大世界,20231028,854,173,681,940.0,933.0,970.9
667,冰雪大世界,20231029,807,157,650,854.0,911.8,935.8
668,冰雪大世界,20231030,1046,349,697,807.0,907.0,926.7
669,冰雪大世界,20231031,940,298,642,1046.0,917.4,935.5
670,冰雪大世界,20231101,1228,344,884,940.0,975.0,973.3
671,冰雪大世界,20231102,1024,357,667,1228.0,1009.0,971.0
672,冰雪大世界,20231103,1043,288,755,1024.0,1056.2,984.0
673,冰雪大世界,20231104,938,173,765,1043.0,1034.6,970.8
674,冰雪大世界,20231105,1045,197,848,938.0,1055.6,986.5
675,冰雪大世界,20231106,1698,720,978,1045.0,1149.6,1062.3
676,冰雪大世界,20231107,1446,533,913,1698.0,1234.0,1121.5
677,冰雪大世界,20231108,1434,513,921,1446.0,1312.2,1184.2
678,冰雪大世界,20231109,1422,524,898,1434.0,1409.0,1221.8
679,冰雪大世界,20231110,1347,422,925,1422.0,1469.4,1262.5
680,冰雪大世界,20231111,1088,204,884,1347.0,1347.4,1248.5
681,冰雪大世界,20231112,1122,218,904,1088.0,1282.6,1258.3
682,冰雪大世界,20231113,1471,549,922,1122.0,1290.0,1301.1
683,冰雪大世界,20231114,1541,577,964,1471.0,1313.8,1361.4
684,冰雪大世界,20231115,1463,561,902,1541.0,1337.0,1403.2
685,冰雪大世界,20231116,1455,549,906,1463.0,1410.4,1378.9
686,冰雪大世界,20231117,1434,499,935,1455.0,1472.8,1377.7
687,冰雪大世界,20231118,1132,220,912,1434.0,1405.0,1347.5
688,冰雪大世界,20231119,1215,257,958,1132.0,1339.8,1326.8
689,冰雪大世界,20231120,1786,656,1130,1215.0,1404.4,1370.7
690,冰雪大世界,20231121,1706,606,1100,1786.0,1454.6,1432.5
691,冰雪大世界,20231122,1772,620,1152,1706.0,1522.2,1497.5
692,冰雪大世界,20231123,1546,549,997,1772.0,1605.0,1505.0
693,冰雪大世界,20231124,1622,521,1101,1546.0,1686.4,1513.1
694,冰雪大世界,20231125,1268,257,1011,1622.0,1582.8,1493.6
695,冰雪大世界,20231126,1346,259,1087,1268.0,1510.8,1482.7
696,冰雪大世界,20231127,1935,791,1144,1346.0,1543.4,1532.8
697,冰雪大世界,20231128,1659,692,967,1935.0,1566.0,1585.5
698,冰雪大世界,20231129,1743,727,1016,1659.0,1590.2,1638.3
699,冰雪大世界,20231130,1761,772,989,1743.0,1688.8,1635.8
700,冰雪大世界,20231201,1838,709,1129,1761.0,1787.2,1649.0
701,冰雪大世界,20231202,1515,360,1155,1838.0,1703.2,1623.3
702,冰雪大世界,20231203,1541,285,1256,1515.0,1679.6,1622.8
703,冰雪大世界,20231204,1963,864,1099,1541.0,1723.6,1656.9
704,冰雪大世界,20231205,1976,760,1216,1963.0,1766.6,1727.7
705,冰雪大世界,20231206,1984,844,1140,1976.0,1795.8,1791.5
706,冰雪大世界,20231207,1802,768,1034,1984.0,1853.2,1778.2
707,冰雪大世界,20231208,1716,696,1020,1802.0,1888.2,1783.9
708,冰雪大世界,20231209,1284,309,975,1716.0,1752.4,1738.0
709,冰雪大世界,20231210,1484,307,1177,1284.0,1654.0,1710.3
710,冰雪大世界,20231211,1939,905,1034,1484.0,1645.0,1720.4
711,冰雪大世界,20231212,1774,851,923,1939.0,1639.4,1746.3
712,冰雪大世界,20231213,1914,810,1104,1774.0,1679.0,1783.6
713,冰雪大世界,20231214,2450,871,1579,1914.0,1912.2,1832.3
714,冰雪大世界,20231215,2475,864,1611,2450.0,2110.4,1882.2
715,冰雪大世界,20231216,2046,391,1655,2475.0,2131.8,1888.4
716,冰雪大世界,20231217,2237,420,1817,2046.0,2224.4,1931.9
717,冰雪大世界,20231218,3969,1040,2929,2237.0,2635.4,2157.2
718,冰雪大世界,20231219,4247,1193,3054,3969.0,2994.8,2453.5
719,冰雪大世界,20231220,5039,1404,3635,4247.0,3507.6,2809.0
720,冰雪大世界,20231221,5353,1285,4068,5039.0,4169.0,3150.4
721,冰雪大世界,20231222,4085,928,3157,5353.0,4538.6,3381.5
722,冰雪大世界,20231223,3250,516,2734,4085.0,4394.8,3515.1
723,冰雪大世界,20231224,2934,563,2371,3250.0,4132.2,3563.5
724,冰雪大世界,20231225,3236,941,2295,2934.0,3771.6,3639.6
725,冰雪大世界,20231226,3218,876,2342,3236.0,3344.6,3756.8
726,冰雪大世界,20231227,3052,855,2197,3218.0,3138.0,3838.3
727,冰雪大世界,20231228,3130,854,2276,3052.0,3114.0,3754.4
728,冰雪大世界,20231229,3467,849,2618,3130.0,3220.6,3676.4
729,冰雪大世界,20231230,3248,399,2849,3467.0,3223.0,3497.3
730,冰雪大世界,20231231,3495,532,2963,3248.0,3278.4,3311.5
731,冰雪大世界,20240101,3069,490,2579,3495.0,3281.8,3209.9
732,冰雪大世界,20240102,2829,914,1915,3069.0,3221.6,3167.8
733,冰雪大世界,20240103,3583,985,2598,2829.0,3244.8,3232.7
734,冰雪大世界,20240104,3927,1017,2910,3583.0,3380.6,3301.8
735,冰雪大世界,20240105,5494,1067,4427,3927.0,3780.4,3529.4
736,冰雪大世界,20240106,9699,704,8995,5494.0,5106.4,4194.1
737,冰雪大世界,20240107,6540,602,5938,9699.0,5848.6,4535.1
738,冰雪大世界,20240108,10539,986,9553,6540.0,7239.8,5242.3
739,冰雪大世界,20240109,8943,902,8041,10539.0,8243.0,5811.8
740,冰雪大世界,20240110,8537,875,7662,8943.0,8851.6,6316.0
741,冰雪大世界,20240111,7235,883,6352,8537.0,8358.8,6732.6
742,冰雪大世界,20240112,8274,822,7452,7235.0,8705.6,7277.1
743,冰雪大世界,20240113,7028,395,6633,8274.0,8003.4,7621.6
744,冰雪大世界,20240114,5234,436,4798,7028.0,7261.6,7752.3
745,冰雪大世界,20240115,8112,870,7242,5234.0,7176.6,8014.1
746,冰雪大世界,20240116,6507,794,5713,8112.0,7031.0,7694.9
747,冰雪大世界,20240117,7152,741,6411,6507.0,6806.6,7756.1
748,冰雪大世界,20240118,6943,575,6368,7152.0,6789.6,7396.5
749,冰雪大世界,20240119,7017,578,6439,6943.0,7146.2,7203.9
750,冰雪大世界,20240120,6494,332,6162,7017.0,6822.6,6999.6
751,冰雪大世界,20240121,4357,349,4008,6494.0,6392.6,6711.8
752,冰雪大世界,20240122,6527,582,5945,4357.0,6267.6,6537.1
753,冰雪大世界,20240123,5460,572,4888,6527.0,5971.0,6380.3
754,冰雪大世界,20240124,2491,478,2013,5460.0,5065.8,6106.0
755,冰雪大世界,20240125,2318,515,1803,2491.0,4230.6,5526.6
756,冰雪大世界,20240126,2122,403,1719,2318.0,3783.6,5088.1
757,冰雪大世界,20240127,1840,262,1578,2122.0,2846.2,4556.9
758,冰雪大世界,20240128,1753,247,1506,1840.0,2104.8,4037.9
759,冰雪大世界,20240129,1820,419,1401,1753.0,1970.6,3518.2
760,冰雪大世界,20240130,1785,433,1352,1820.0,1864.0,3047.3
761,冰雪大世界,20240131,1623,330,1293,1785.0,1764.2,2773.9
762,冰雪大世界,20240201,1578,386,1192,1623.0,1711.8,2279.0
763,冰雪大世界,20240202,1501,310,1191,1578.0,1661.4,1883.1
764,冰雪大世界,20240203,1438,209,1229,1501.0,1585.0,1777.8
765,冰雪大世界,20240204,1695,378,1317,1438.0,1567.0,1715.5
766,冰雪大世界,20240205,1556,318,1238,1695.0,1553.6,1658.9
767,冰雪大世界,20240206,1529,276,1253,1556.0,1543.8,1627.8
768,冰雪大世界,20240207,1447,251,1196,1529.0,1533.0,1597.2
769,冰雪大世界,20240208,1487,220,1267,1447.0,1542.8,1563.9
770,冰雪大世界,20240209,1184,157,1027,1487.0,1440.6,1503.8
771,冰雪大世界,20240210,1526,168,1358,1184.0,1434.6,1494.1
772,冰雪大世界,20240211,1891,146,1745,1526.0,1507.0,1525.4
773,冰雪大世界,20240212,1927,154,1773,1891.0,1603.0,1568.0
774,冰雪大世界,20240213,3253,307,2946,1927.0,1956.2,1749.5
775,冰雪大世界,20240214,3310,296,3014,3253.0,2381.4,1911.0
776,冰雪大世界,20240215,2417,315,2102,3310.0,2559.6,1997.1
777,冰雪大世界,20240216,1742,228,1514,2417.0,2529.8,2018.4
778,冰雪大世界,20240217,1416,225,1191,1742.0,2427.6,2015.3
779,冰雪大世界,20240218,1364,354,1010,1416.0,2049.8,2003.0
780,冰雪大世界,20240219,1353,383,970,1364.0,1658.4,2019.9
781,冰雪大世界,20240220,1216,288,928,1353.0,1418.2,1988.9
782,冰雪大世界,20240221,1180,271,909,1216.0,1305.8,1917.8
783,冰雪大世界,20240222,1152,248,904,1180.0,1253.0,1840.3
784,冰雪大世界,20240223,1156,274,882,1152.0,1211.4,1630.6
785,冰雪大世界,20240224,1045,159,886,1156.0,1149.8,1404.1
786,冰雪大世界,20240225,1075,188,887,1045.0,1121.6,1269.9
787,冰雪大世界,20240226,1059,248,811,1075.0,1097.4,1201.6
788,冰雪大世界,20240227,1022,226,796,1059.0,1071.4,1162.2
789,冰雪大世界,20240228,1001,228,773,1022.0,1040.4,1125.9
790,冰雪大世界,20240229,1072,257,815,1001.0,1045.8,1097.8
791,冰雪大世界,20240301,708,202,506,1072.0,972.4,1047.0
792,冰雪大世界,20240302,635,144,491,708.0,887.6,992.5
793,冰雪大世界,20240303,723,158,565,635.0,827.8,949.6
794,冰雪大世界,20240304,594,201,393,723.0,746.4,893.4
795,冰雪大世界,20240305,607,193,414,594.0,653.4,849.6
796,冰雪大世界,20240306,584,186,398,607.0,628.6,800.5
797,冰雪大世界,20240307,607,233,374,584.0,623.0,755.3
798,冰雪大世界,20240308,469,110,359,607.0,572.2,700.0
799,冰雪大世界,20240309,494,120,374,469.0,552.2,649.3
800,冰雪大世界,20240310,580,112,468,494.0,546.8,600.1
801,冰雪大世界,20240311,542,182,360,580.0,538.4,583.5
802,冰雪大世界,20240312,534,188,346,542.0,523.8,573.4
803,冰雪大世界,20240313,617,190,427,534.0,553.4,562.8
804,冰雪大世界,20240314,592,180,412,617.0,573.0,562.6
805,冰雪大世界,20240315,479,159,320,592.0,552.8,549.8
806,冰雪大世界,20240316,548,133,415,479.0,554.0,546.2
807,冰雪大世界,20240317,622,123,499,548.0,571.6,547.7
808,冰雪大世界,20240318,540,179,361,622.0,556.2,554.8
809,冰雪大世界,20240319,470,179,291,540.0,531.8,552.4
810,冰雪大世界,20240320,454,163,291,470.0,526.8,539.8
811,冰雪大世界,20240321,489,219,270,454.0,515.0,534.5
812,冰雪大世界,20240322,396,150,246,489.0,469.8,520.7
813,冰雪大世界,20240323,360,97,263,396.0,433.8,495.0
814,冰雪大世界,20240324,439,106,333,360.0,427.6,479.7
815,冰雪大世界,20240325,385,125,260,439.0,413.8,470.3
816,冰雪大世界,20240326,416,139,277,385.0,399.2,457.1
817,冰雪大世界,20240327,447,137,310,416.0,409.4,439.6
818,冰雪大世界,20240328,466,161,305,447.0,430.6,432.2
819,冰雪大世界,20240329,394,131,263,466.0,421.6,424.6
820,冰雪大世界,20240330,413,142,271,394.0,427.2,420.5
821,冰雪大世界,20240331,433,110,323,413.0,430.6,414.9
822,冰雪大世界,20240401,407,150,257,433.0,422.6,416.0
823,冰雪大世界,20240402,370,142,228,407.0,403.4,417.0
824,冰雪大世界,20240403,360,125,235,370.0,396.6,409.1
825,冰雪大世界,20240404,406,91,315,360.0,395.2,411.2
826,冰雪大世界,20240405,387,93,294,406.0,386.0,408.3
827,冰雪大世界,20240406,388,110,278,387.0,382.2,402.4
828,冰雪大世界,20240407,425,148,277,388.0,393.2,398.3
829,冰雪大世界,20240408,385,146,239,425.0,398.2,397.4
830,冰雪大世界,20240409,352,121,231,385.0,387.4,391.3
831,冰雪大世界,20240410,370,118,252,352.0,384.0,385.0
832,冰雪大世界,20240411,364,152,212,370.0,379.2,380.7
833,冰雪大世界,20240412,340,91,249,364.0,362.2,377.7
834,冰雪大世界,20240413,299,87,212,340.0,345.0,371.6
835,冰雪大世界,20240414,365,101,264,299.0,347.6,367.5
836,冰雪大世界,20240415,367,110,257,365.0,347.0,365.5
837,冰雪大世界,20240416,370,121,249,367.0,348.2,363.7
838,冰雪大世界,20240417,325,93,232,370.0,345.2,353.7
839,冰雪大世界,20240418,353,112,241,325.0,356.0,350.5
840,冰雪大世界,20240419,320,112,208,353.0,347.0,347.3
841,冰雪大世界,20240420,310,76,234,320.0,335.6,341.3
842,冰雪大世界,20240421,359,93,266,310.0,333.4,340.8
843,冰雪大世界,20240422,319,118,201,359.0,332.2,338.7
844,冰雪大世界,20240423,337,129,208,319.0,329.0,342.5
845,冰雪大世界,20240424,318,118,200,337.0,328.6,337.8
846,冰雪大世界,20240425,320,108,212,318.0,330.6,333.1
847,冰雪大世界,20240426,320,127,193,320.0,322.8,328.1
848,冰雪大世界,20240427,373,95,278,320.0,333.6,332.9
849,冰雪大世界,20240428,350,112,238,373.0,336.2,332.6
850,冰雪大世界,20240429,307,112,195,350.0,334.0,331.3
851,冰雪大世界,20240430,382,129,253,307.0,346.4,338.5
1,全部词条,20220101,1938,302,1636,382.0,670.0,496.4
2,全部词条,20220102,2023,397,1626,1938.0,1000.0,666.8
3,全部词条,20220103,2168,463,1705,2023.0,1363.6,849.9
4,全部词条,20220104,2157,619,1538,2168.0,1733.6,1033.8
5,全部词条,20220105,1963,537,1426,2157.0,2049.8,1198.1
6,全部词条,20220106,2019,516,1503,1963.0,2066.0,1368.0
7,全部词条,20220107,1975,627,1348,2019.0,2056.4,1528.2
8,全部词条,20220108,1813,285,1528,1975.0,1985.4,1674.5
9,全部词条,20220109,1889,431,1458,1813.0,1931.8,1832.7
10,全部词条,20220110,1727,459,1268,1889.0,1884.6,1967.2
11,全部词条,20220111,1764,472,1292,1727.0,1833.6,1949.8
12,全部词条,20220112,1852,505,1347,1764.0,1809.0,1932.7
13,全部词条,20220113,1993,628,1365,1852.0,1845.0,1915.2
14,全部词条,20220114,1893,578,1315,1993.0,1845.8,1888.8
15,全部词条,20220115,1833,434,1399,1893.0,1867.0,1875.8
16,全部词条,20220116,1760,373,1387,1833.0,1866.2,1849.9
17,全部词条,20220117,1763,495,1268,1760.0,1848.4,1828.7
18,全部词条,20220118,1822,588,1234,1763.0,1814.2,1829.6
19,全部词条,20220119,1757,595,1162,1822.0,1787.0,1816.4
20,全部词条,20220120,1665,550,1115,1757.0,1753.4,1810.2
21,全部词条,20220121,1670,459,1211,1665.0,1735.4,1800.8
22,全部词条,20220122,1716,381,1335,1670.0,1726.0,1787.2
23,全部词条,20220123,1658,374,1284,1716.0,1693.2,1753.7
24,全部词条,20220124,1582,396,1186,1658.0,1658.2,1722.6
25,全部词条,20220125,1458,394,1064,1582.0,1616.8,1685.1
26,全部词条,20220126,1722,541,1181,1458.0,1627.2,1681.3
27,全部词条,20220127,1771,592,1179,1722.0,1638.2,1682.1
28,全部词条,20220128,1853,593,1260,1771.0,1677.2,1685.2
29,全部词条,20220129,1727,411,1316,1853.0,1706.2,1682.2
30,全部词条,20220130,1509,474,1035,1727.0,1716.4,1666.6
31,全部词条,20220131,1505,312,1193,1509.0,1673.0,1650.1
32,全部词条,20220201,2006,330,1676,1505.0,1720.0,1679.1
33,全部词条,20220202,2110,351,1759,2006.0,1771.4,1724.3
34,全部词条,20220203,2217,373,1844,2110.0,1869.4,1787.8
35,全部词条,20220204,2309,513,1796,2217.0,2029.4,1872.9
36,全部词条,20220205,2172,437,1735,2309.0,2162.8,1917.9
37,全部词条,20220206,2043,346,1697,2172.0,2170.2,1945.1
38,全部词条,20220207,1963,558,1405,2043.0,2140.8,1956.1
39,全部词条,20220208,2315,754,1561,1963.0,2160.4,2014.9
40,全部词条,20220209,2008,602,1406,2315.0,2100.2,2064.8
41,全部词条,20220210,2059,639,1420,2008.0,2077.6,2120.2
42,全部词条,20220211,1981,567,1414,2059.0,2065.2,2117.7
43,全部词条,20220212,2010,446,1564,1981.0,2074.6,2107.7
44,全部词条,20220213,2029,442,1587,2010.0,2017.4,2088.9
45,全部词条,20220214,1921,534,1387,2029.0,2000.0,2050.1
46,全部词条,20220215,2015,508,1507,1921.0,1991.2,2034.4
47,全部词条,20220216,1945,631,1314,2015.0,1984.0,2024.6
48,全部词条,20220217,1794,528,1266,1945.0,1940.8,2007.7
49,全部词条,20220218,1980,553,1427,1794.0,1931.0,1974.2
50,全部词条,20220219,2002,522,1480,1980.0,1947.2,1973.6
51,全部词条,20220220,1876,502,1374,2002.0,1919.4,1955.3
52,全部词条,20220221,1874,647,1227,1876.0,1905.2,1944.6
53,全部词条,20220222,1971,672,1299,1874.0,1940.6,1940.7
54,全部词条,20220223,1803,546,1257,1971.0,1905.2,1918.1
55,全部词条,20220224,1889,519,1370,1803.0,1882.6,1914.9
56,全部词条,20220225,1746,436,1310,1889.0,1856.6,1888.0
57,全部词条,20220226,1764,432,1332,1746.0,1834.6,1869.9
58,全部词条,20220227,1685,361,1324,1764.0,1777.4,1859.0
59,全部词条,20220228,1667,548,1119,1685.0,1750.2,1827.7
60,全部词条,20220301,1633,550,1083,1667.0,1699.0,1790.8
61,全部词条,20220302,1462,530,932,1633.0,1642.2,1749.4
62,全部词条,20220303,1416,456,960,1462.0,1572.6,1703.6
63,全部词条,20220304,1416,510,906,1416.0,1518.8,1648.1
64,全部词条,20220305,1342,374,968,1416.0,1453.8,1602.0
65,全部词条,20220306,1441,423,1018,1342.0,1415.4,1557.2
66,全部词条,20220307,1562,545,1017,1441.0,1435.4,1538.8
67,全部词条,20220308,1425,449,976,1562.0,1437.2,1504.9
68,全部词条,20220309,1562,605,957,1425.0,1466.4,1492.6
69,全部词条,20220310,1480,542,938,1562.0,1494.0,1473.9
70,全部词条,20220311,1387,427,960,1480.0,1483.2,1449.3
71,全部词条,20220312,1286,382,904,1387.0,1428.0,1431.7
72,全部词条,20220313,1303,441,862,1286.0,1403.6,1420.4
73,全部词条,20220314,1402,548,854,1303.0,1371.6,1419.0
74,全部词条,20220315,1405,585,820,1402.0,1356.6,1425.3
75,全部词条,20220316,1364,513,851,1405.0,1352.0,1417.6
76,全部词条,20220317,1202,393,809,1364.0,1335.2,1381.6
77,全部词条,20220318,1192,421,771,1202.0,1313.0,1358.3
78,全部词条,20220319,1169,369,800,1192.0,1266.4,1319.0
79,全部词条,20220320,1144,309,835,1169.0,1214.2,1285.4
80,全部词条,20220321,1423,548,875,1144.0,1226.0,1289.0
81,全部词条,20220322,1470,619,851,1423.0,1279.6,1307.4
82,全部词条,20220323,1304,437,867,1470.0,1302.0,1307.5
83,全部词条,20220324,1255,519,736,1304.0,1319.2,1292.8
84,全部词条,20220325,1347,491,856,1255.0,1359.8,1287.0
85,全部词条,20220326,1260,387,873,1347.0,1327.2,1276.6
86,全部词条,20220327,1192,326,866,1260.0,1271.6,1275.6
87,全部词条,20220328,1270,479,791,1192.0,1264.8,1283.4
88,全部词条,20220329,1432,613,819,1270.0,1300.2,1309.7
89,全部词条,20220330,1215,402,813,1432.0,1273.8,1316.8
90,全部词条,20220331,1254,407,847,1215.0,1272.6,1299.9
91,全部词条,20220401,1257,418,839,1254.0,1285.6,1278.6
92,全部词条,20220402,1220,423,797,1257.0,1275.6,1270.2
93,全部词条,20220403,1157,370,787,1220.0,1220.6,1260.4
94,全部词条,20220404,1187,311,876,1157.0,1215.0,1244.4
95,全部词条,20220405,1301,504,797,1187.0,1224.4,1248.5
96,全部词条,20220406,1230,465,765,1301.0,1219.0,1252.3
97,全部词条,20220407,1208,423,785,1230.0,1216.6,1246.1
98,全部词条,20220408,1171,474,697,1208.0,1219.4,1220.0
99,全部词条,20220409,1129,222,907,1171.0,1207.8,1211.4
100,全部词条,20220410,1334,414,920,1129.0,1214.4,1219.4
101,全部词条,20220411,1410,550,860,1334.0,1250.4,1234.7
102,全部词条,20220412,1472,595,877,1410.0,1303.2,1259.9
103,全部词条,20220413,1312,471,841,1472.0,1331.4,1275.4
104,全部词条,20220414,1448,571,877,1312.0,1395.2,1301.5
105,全部词条,20220415,1166,400,766,1448.0,1361.6,1288.0
106,全部词条,20220416,1140,328,812,1166.0,1307.6,1279.0
107,全部词条,20220417,1316,418,898,1140.0,1276.4,1289.8
108,全部词条,20220418,1225,454,771,1316.0,1259.0,1295.2
109,全部词条,20220419,1216,409,807,1225.0,1212.6,1303.9
110,全部词条,20220420,1172,389,783,1216.0,1213.8,1287.7
111,全部词条,20220421,1360,485,875,1172.0,1257.8,1282.7
112,全部词条,20220422,1359,547,812,1360.0,1266.4,1271.4
113,全部词条,20220423,1353,464,889,1359.0,1292.0,1275.5
114,全部词条,20220424,1111,334,777,1353.0,1271.0,1241.8
115,全部词条,20220425,1377,533,844,1111.0,1312.0,1262.9
116,全部词条,20220426,1294,415,879,1377.0,1298.8,1278.3
117,全部词条,20220427,1301,434,867,1294.0,1287.2,1276.8
118,全部词条,20220428,1331,423,908,1301.0,1282.8,1287.4
119,全部词条,20220429,1341,473,868,1331.0,1328.8,1299.9
120,全部词条,20220430,1274,349,925,1341.0,1308.2,1310.1
121,全部词条,20220501,1400,487,913,1274.0,1329.4,1314.1
122,全部词条,20220502,1416,501,915,1400.0,1352.4,1319.8
123,全部词条,20220503,1286,420,866,1416.0,1343.4,1313.1
124,全部词条,20220504,1393,448,945,1286.0,1353.8,1341.3
125,全部词条,20220505,1277,457,820,1393.0,1354.4,1331.3
126,全部词条,20220506,1290,498,792,1277.0,1332.4,1330.9
127,全部词条,20220507,1324,394,930,1290.0,1314.0,1333.2
128,全部词条,20220508,1207,228,979,1324.0,1298.2,1320.8
129,全部词条,20220509,1372,426,946,1207.0,1294.0,1323.9
130,全部词条,20220510,1269,394,875,1372.0,1292.4,1323.4
131,全部词条,20220511,1587,601,986,1269.0,1351.8,1342.1
132,全部词条,20220512,1583,531,1052,1587.0,1403.6,1358.8
133,全部词条,20220513,1603,583,1020,1583.0,1482.8,1390.5
134,全部词条,20220514,1638,554,1084,1603.0,1536.0,1415.0
135,全部词条,20220515,1385,368,1017,1638.0,1559.2,1425.8
136,全部词条,20220516,1519,575,944,1385.0,1545.6,1448.7
137,全部词条,20220517,1470,483,987,1519.0,1523.0,1463.3
138,全部词条,20220518,1532,520,1012,1470.0,1508.8,1495.8
139,全部词条,20220519,1589,575,1014,1532.0,1499.0,1517.5
140,全部词条,20220520,1600,522,1078,1589.0,1542.0,1550.6
141,全部词条,20220521,1637,482,1155,1600.0,1565.6,1555.6
142,全部词条,20220522,1745,435,1310,1637.0,1620.6,1571.8
143,全部词条,20220523,1606,510,1096,1745.0,1635.4,1572.1
144,全部词条,20220524,1481,437,1044,1606.0,1613.8,1556.4
145,全部词条,20220525,1570,519,1051,1481.0,1607.8,1574.9
146,全部词条,20220526,1697,655,1042,1570.0,1619.8,1592.7
147,全部词条,20220527,1568,459,1109,1697.0,1584.4,1602.5
148,全部词条,20220528,1579,380,1199,1568.0,1579.0,1607.2
149,全部词条,20220529,1608,458,1150,1579.0,1604.4,1609.1
150,全部词条,20220530,1662,592,1070,1608.0,1622.8,1615.3
151,全部词条,20220531,1689,467,1222,1662.0,1621.2,1620.5
152,全部词条,20220601,1937,587,1350,1689.0,1695.0,1639.7
153,全部词条,20220602,1870,493,1377,1937.0,1753.2,1666.1
154,全部词条,20220603,1910,250,1660,1870.0,1813.6,1709.0
155,全部词条,20220604,1937,493,1444,1910.0,1868.6,1745.7
156,全部词条,20220605,1617,433,1184,1937.0,1854.2,1737.7
157,全部词条,20220606,1801,644,1157,1617.0,1827.0,1761.0
158,全部词条,20220607,1731,590,1141,1801.0,1799.2,1776.2
159,全部词条,20220608,1702,492,1210,1731.0,1757.6,1785.6
160,全部词条,20220609,9866,3040,6826,1702.0,3343.4,2606.0
161,全部词条,20220610,3934,1292,2642,9866.0,3806.8,2830.5
162,全部词条,20220611,2124,486,1638,3934.0,3871.4,2849.2
163,全部词条,20220612,1885,507,1378,2124.0,3902.2,2850.7
164,全部词条,20220613,1953,638,1315,1885.0,3952.4,2855.0
165,全部词条,20220614,1872,626,1246,1953.0,2353.6,2848.5
166,全部词条,20220615,1680,562,1118,1872.0,1902.8,2854.8
167,全部词条,20220616,1741,596,1145,1680.0,1826.2,2848.8
168,全部词条,20220617,1885,623,1262,1741.0,1826.2,2864.2
169,全部词条,20220618,1822,442,1380,1885.0,1800.0,2876.2
170,全部词条,20220619,1739,384,1355,1822.0,1773.4,2063.5
171,全部词条,20220620,1639,477,1162,1739.0,1765.2,1834.0
172,全部词条,20220621,1731,511,1220,1639.0,1763.2,1794.7
173,全部词条,20220622,1808,616,1192,1731.0,1747.8,1787.0
174,全部词条,20220623,1708,440,1268,1808.0,1725.0,1762.5
175,全部词条,20220624,1804,517,1287,1708.0,1738.0,1755.7
176,全部词条,20220625,1654,384,1270,1804.0,1741.0,1753.1
177,全部词条,20220626,1691,409,1282,1654.0,1733.0,1748.1
178,全部词条,20220627,1935,653,1282,1691.0,1758.4,1753.1
179,全部词条,20220628,1969,627,1342,1935.0,1810.6,1767.8
180,全部词条,20220629,1993,617,1376,1969.0,1848.4,1793.2
181,全部词条,20220630,2102,676,1426,1993.0,1938.0,1839.5
182,全部词条,20220701,2050,631,1419,2102.0,2009.8,1871.4
183,全部词条,20220702,1852,413,1439,2050.0,1993.2,1875.8
184,全部词条,20220703,1926,412,1514,1852.0,1984.6,1897.6
185,全部词条,20220704,2029,658,1371,1926.0,1991.8,1920.1
186,全部词条,20220705,2096,675,1421,2029.0,1990.6,1964.3
187,全部词条,20220706,2104,653,1451,2096.0,2001.4,2005.6
188,全部词条,20220707,2085,604,1481,2104.0,2048.0,2020.6
189,全部词条,20220708,2110,603,1507,2085.0,2084.8,2034.7
190,全部词条,20220709,2135,400,1735,2110.0,2106.0,2048.9
191,全部词条,20220710,2123,379,1744,2135.0,2111.4,2051.0
192,全部词条,20220711,2286,668,1618,2123.0,2147.8,2074.6
193,全部词条,20220712,2388,560,1828,2286.0,2208.4,2128.2
194,全部词条,20220713,2386,688,1698,2388.0,2263.6,2174.2
195,全部词条,20220714,2473,640,1833,2386.0,2331.2,2218.6
196,全部词条,20220715,2413,608,1805,2473.0,2389.2,2250.3
197,全部词条,20220716,2262,500,1762,2413.0,2384.4,2266.1
198,全部词条,20220717,2321,423,1898,2262.0,2371.0,2289.7
199,全部词条,20220718,2284,709,1575,2321.0,2350.6,2307.1
200,全部词条,20220719,2320,680,1640,2284.0,2320.0,2325.6
201,全部词条,20220720,2353,660,1693,2320.0,2308.0,2348.6
202,全部词条,20220721,2408,642,1766,2353.0,2337.2,2360.8
203,全部词条,20220722,2477,641,1836,2408.0,2368.4,2369.7
204,全部词条,20220723,2491,537,1954,2477.0,2409.8,2380.2
205,全部词条,20220724,2442,533,1909,2491.0,2434.2,2377.1
206,全部词条,20220725,2596,718,1878,2442.0,2482.8,2395.4
207,全部词条,20220726,2406,599,1807,2596.0,2482.4,2409.8
208,全部词条,20220727,2508,614,1894,2406.0,2488.6,2428.5
209,全部词条,20220728,2565,701,1864,2508.0,2503.4,2456.6
210,全部词条,20220729,2571,683,1888,2565.0,2529.2,2481.7
211,全部词条,20220730,2729,566,2163,2571.0,2555.8,2519.3
212,全部词条,20220731,2606,497,2109,2729.0,2595.8,2539.1
213,全部词条,20220801,2680,695,1985,2606.0,2630.2,2559.4
214,全部词条,20220802,2635,634,2001,2680.0,2644.2,2573.8
215,全部词条,20220803,2498,604,1894,2635.0,2629.6,2579.4
216,全部词条,20220804,2781,716,2065,2498.0,2640.0,2597.9
217,全部词条,20220805,2804,661,2143,2781.0,2679.6,2637.7
218,全部词条,20220806,2753,531,2222,2804.0,2694.2,2662.2
219,全部词条,20220807,2546,446,2100,2753.0,2676.4,2660.3
220,全部词条,20220808,2711,725,1986,2546.0,2719.0,2674.3
221,全部词条,20220809,2329,611,1718,2711.0,2628.6,2634.3
222,全部词条,20220810,2286,676,1610,2329.0,2525.0,2602.3
223,全部词条,20220811,2227,593,1634,2286.0,2419.8,2557.0
224,全部词条,20220812,2221,606,1615,2227.0,2354.8,2515.6
225,全部词条,20220813,2342,580,1762,2221.0,2281.0,2500.0
226,全部词条,20220814,2138,401,1737,2342.0,2242.8,2435.7
227,全部词条,20220815,2172,537,1635,2138.0,2220.0,2372.5
228,全部词条,20220816,2181,523,1658,2172.0,2210.8,2315.3
229,全部词条,20220817,2297,667,1630,2181.0,2226.0,2290.4
230,全部词条,20220818,2134,590,1544,2297.0,2184.4,2232.7
231,全部词条,20220819,2057,555,1502,2134.0,2168.2,2205.5
232,全部词条,20220820,2127,504,1623,2057.0,2159.2,2189.6
233,全部词条,20220821,1838,390,1448,2127.0,2090.6,2150.7
234,全部词条,20220822,1886,576,1310,1838.0,2008.4,2117.2
235,全部词条,20220823,1969,630,1339,1886.0,1975.4,2079.9
236,全部词条,20220824,1942,507,1435,1969.0,1952.4,2060.3
237,全部词条,20220825,1895,587,1308,1942.0,1906.0,2032.6
238,全部词条,20220826,1996,569,1427,1895.0,1937.6,2014.1
239,全部词条,20220827,1808,399,1409,1996.0,1922.0,1965.2
240,全部词条,20220828,1509,315,1194,1808.0,1830.0,1902.7
241,全部词条,20220829,1440,433,1007,1509.0,1729.6,1841.0
242,全部词条,20220830,1380,454,926,1440.0,1626.6,1766.3
243,全部词条,20220831,1299,417,882,1380.0,1487.2,1712.4
244,全部词条,20220901,1268,483,785,1299.0,1379.2,1650.6
245,全部词条,20220902,1300,422,878,1268.0,1337.4,1583.7
246,全部词条,20220903,1295,384,911,1300.0,1308.4,1519.0
247,全部词条,20220904,1272,331,941,1295.0,1286.8,1456.7
248,全部词条,20220905,1262,412,850,1272.0,1279.4,1383.3
249,全部词条,20220906,1437,531,906,1262.0,1313.2,1346.2
250,全部词条,20220907,1530,533,997,1437.0,1359.2,1348.3
251,全部词条,20220908,1515,521,994,1530.0,1403.2,1355.8
252,全部词条,20220909,1647,540,1107,1515.0,1478.2,1382.5
253,全部词条,20220910,1517,340,1177,1647.0,1529.2,1404.3
254,全部词条,20220911,1799,465,1334,1517.0,1601.6,1457.4
255,全部词条,20220912,1580,346,1234,1799.0,1611.6,1485.4
256,全部词条,20220913,1653,591,1062,1580.0,1639.2,1521.2
257,全部词条,20220914,1587,508,1079,1653.0,1627.2,1552.7
258,全部词条,20220915,1511,447,1064,1587.0,1626.0,1577.6
259,全部词条,20220916,1580,500,1080,1511.0,1582.2,1591.9
260,全部词条,20220917,1540,330,1210,1580.0,1574.2,1592.9
261,全部词条,20220918,1588,362,1226,1540.0,1561.2,1600.2
262,全部词条,20220919,1546,519,1027,1588.0,1553.0,1590.1
263,全部词条,20220920,1486,455,1031,1546.0,1548.0,1587.0
264,全部词条,20220921,1487,526,961,1486.0,1529.4,1555.8
265,全部词条,20220922,1471,514,957,1487.0,1515.6,1544.9
266,全部词条,20220923,1542,576,966,1471.0,1506.4,1533.8
267,全部词条,20220924,1286,279,1007,1542.0,1454.4,1503.7
268,全部词条,20220925,1333,289,1044,1286.0,1423.8,1485.9
269,全部词条,20220926,1441,580,861,1333.0,1414.6,1472.0
270,全部词条,20220927,1442,481,961,1441.0,1408.8,1462.2
271,全部词条,20220928,1418,481,937,1442.0,1384.0,1445.2
272,全部词条,20220929,1490,473,1017,1418.0,1424.8,1439.6
273,全部词条,20220930,1690,530,1160,1490.0,1496.2,1460.0
274,全部词条,20221001,1510,264,1246,1690.0,1510.0,1462.3
275,全部词条,20221002,1562,270,1292,1510.0,1534.0,1471.4
276,全部词条,20221003,1517,392,1125,1562.0,1553.8,1468.9
277,全部词条,20221004,1430,261,1169,1517.0,1541.8,1483.3
278,全部词条,20221005,1358,269,1089,1430.0,1475.4,1485.8
279,全部词条,20221006,1468,355,1113,1358.0,1467.0,1488.5
280,全部词条,20221007,1547,419,1128,1468.0,1464.0,1499.0
281,全部词条,20221008,1448,465,983,1547.0,1450.2,1502.0
282,全部词条,20221009,1500,536,964,1448.0,1464.2,1503.0
283,全部词条,20221010,1516,536,980,1500.0,1495.8,1485.6
284,全部词条,20221011,1568,427,1141,1516.0,1515.8,1491.4
285,全部词条,20221012,1539,489,1050,1568.0,1514.2,1489.1
286,全部词条,20221013,1416,466,950,1539.0,1507.8,1479.0
287,全部词条,20221014,1353,519,834,1416.0,1478.4,1471.3
288,全部词条,20221015,1334,353,981,1353.0,1442.0,1468.9
289,全部词条,20221016,1222,238,984,1334.0,1372.8,1444.3
290,全部词条,20221017,1579,564,1015,1222.0,1380.8,1447.5
291,全部词条,20221018,1544,502,1042,1579.0,1406.4,1457.1
292,全部词条,20221019,1462,482,980,1544.0,1428.2,1453.3
293,全部词条,20221020,1532,569,963,1462.0,1467.8,1454.9
294,全部词条,20221021,1431,391,1040,1532.0,1509.6,1441.2
295,全部词条,20221022,1450,281,1169,1431.0,1483.8,1432.3
296,全部词条,20221023,1510,339,1171,1450.0,1477.0,1441.7
297,全部词条,20221024,1264,320,944,1510.0,1437.4,1432.8
298,全部词条,20221025,1373,408,965,1264.0,1405.6,1436.7
299,全部词条,20221026,1548,477,1071,1373.0,1429.0,1469.3
300,全部词条,20221027,1464,435,1029,1548.0,1431.8,1457.8
301,全部词条,20221028,1443,503,940,1464.0,1418.4,1447.7
302,全部词条,20221029,1441,345,1096,1443.0,1453.8,1445.6
303,全部词条,20221030,1126,123,1003,1441.0,1404.4,1405.0
304,全部词条,20221031,1341,426,915,1126.0,1363.0,1396.0
305,全部词条,20221101,1340,361,979,1341.0,1338.2,1385.0
306,全部词条,20221102,1443,455,988,1340.0,1338.2,1378.3
307,全部词条,20221103,1448,488,960,1443.0,1339.6,1396.7
308,全部词条,20221104,1456,531,925,1448.0,1405.6,1405.0
309,全部词条,20221105,1276,257,1019,1456.0,1392.6,1377.8
310,全部词条,20221106,1331,401,930,1276.0,1390.8,1364.5
311,全部词条,20221107,1432,516,916,1331.0,1388.6,1363.4
312,全部词条,20221108,1399,441,958,1432.0,1378.8,1359.2
313,全部词条,20221109,1582,519,1063,1399.0,1404.0,1404.8
314,全部词条,20221110,1646,529,1117,1582.0,1478.0,1435.3
315,全部词条,20221111,1382,397,985,1646.0,1488.2,1439.5
316,全部词条,20221112,1546,405,1141,1382.0,1511.0,1449.8
317,全部词条,20221113,1576,393,1183,1546.0,1546.4,1462.6
318,全部词条,20221114,1438,424,1014,1576.0,1517.6,1460.8
319,全部词条,20221115,1341,487,854,1438.0,1456.6,1467.3
320,全部词条,20221116,1479,477,1002,1341.0,1476.0,1482.1
321,全部词条,20221117,1647,500,1147,1479.0,1496.2,1503.6
322,全部词条,20221118,1558,544,1014,1647.0,1492.6,1519.5
323,全部词条,20221119,1524,422,1102,1558.0,1509.8,1513.7
324,全部词条,20221120,1406,399,1007,1524.0,1522.8,1489.7
325,全部词条,20221121,1567,468,1099,1406.0,1540.4,1508.2
326,全部词条,20221122,1603,499,1104,1567.0,1531.6,1513.9
327,全部词条,20221123,1431,485,946,1603.0,1506.2,1499.4
328,全部词条,20221124,1448,384,1064,1431.0,1491.0,1500.4
329,全部词条,20221125,1495,530,965,1448.0,1508.8,1515.8
330,全部词条,20221126,1321,402,919,1495.0,1459.6,1500.0
331,全部词条,20221127,1405,345,1060,1321.0,1420.0,1475.8
332,全部词条,20221128,1434,414,1020,1405.0,1420.6,1463.4
333,全部词条,20221129,1719,528,1191,1434.0,1474.8,1482.9
334,全部词条,20221130,1602,507,1095,1719.0,1496.2,1502.5
335,全部词条,20221201,1587,496,1091,1602.0,1549.4,1504.5
336,全部词条,20221202,1554,435,1119,1587.0,1579.2,1499.6
337,全部词条,20221203,1471,269,1202,1554.0,1586.6,1503.6
338,全部词条,20221204,1503,368,1135,1471.0,1543.4,1509.1
339,全部词条,20221205,1831,537,1294,1503.0,1589.2,1542.7
340,全部词条,20221206,1937,591,1346,1831.0,1659.2,1604.3
341,全部词条,20221207,2012,629,1383,1937.0,1750.8,1665.0
342,全部词条,20221208,2287,602,1685,2012.0,1914.0,1750.3
343,全部词条,20221209,2143,598,1545,2287.0,2042.0,1792.7
344,全部词条,20221210,1785,424,1361,2143.0,2032.8,1811.0
345,全部词条,20221211,1997,486,1511,1785.0,2044.8,1852.0
346,全部词条,20221212,1948,537,1411,1997.0,2032.0,1891.4
347,全部词条,20221213,1813,550,1263,1948.0,1937.2,1925.6
348,全部词条,20221214,2068,680,1388,1813.0,1922.2,1982.1
349,全部词条,20221215,1872,523,1349,2068.0,1939.6,1986.2
350,全部词条,20221216,1933,530,1403,1872.0,1926.8,1985.8
351,全部词条,20221217,1943,391,1552,1933.0,1925.8,1978.9
352,全部词条,20221218,1733,417,1316,1943.0,1909.8,1923.5
353,全部词条,20221219,1954,682,1272,1733.0,1887.0,1904.6
354,全部词条,20221220,1655,527,1128,1954.0,1843.6,1891.6
355,全部词条,20221221,1862,641,1221,1655.0,1829.4,1878.1
356,全部词条,20221222,1717,464,1253,1862.0,1784.2,1855.0
357,全部词条,20221223,1744,474,1270,1717.0,1786.4,1848.1
358,全部词条,20221224,1736,400,1336,1744.0,1742.8,1814.9
359,全部词条,20221225,2016,477,1539,1736.0,1815.0,1829.3
360,全部词条,20221226,2158,659,1499,2016.0,1874.2,1851.8
361,全部词条,20221227,2280,697,1583,2158.0,1986.8,1885.5
362,全部词条,20221228,2303,611,1692,2280.0,2098.6,1942.5
363,全部词条,20221229,2259,655,1604,2303.0,2203.2,1973.0
364,全部词条,20221230,2290,618,1672,2259.0,2258.0,2036.5
365,全部词条,20221231,2255,492,1763,2290.0,2277.4,2075.8
366,全部词条,20230101,2127,433,1694,2255.0,2246.8,2116.8
367,全部词条,20230102,2312,526,1786,2127.0,2248.6,2173.6
368,全部词条,20230103,2547,736,1811,2312.0,2306.2,2254.7
369,全部词条,20230104,2675,875,1800,2547.0,2383.2,2320.6
370,全部词条,20230105,2816,876,1940,2675.0,2495.4,2386.4
371,全部词条,20230106,2763,848,1915,2816.0,2622.6,2434.7
372,全部词条,20230107,2762,592,2170,2763.0,2712.6,2480.6
373,全部词条,20230108,2610,487,2123,2762.0,2725.2,2515.7
374,全部词条,20230109,2764,819,1945,2610.0,2743.0,2563.1
375,全部词条,20230110,2961,927,2034,2764.0,2772.0,2633.7
376,全部词条,20230111,2974,817,2157,2961.0,2814.2,2718.4
377,全部词条,20230112,2999,847,2152,2974.0,2861.6,2787.1
378,全部词条,20230113,2956,742,2214,2999.0,2930.8,2828.0
379,全部词条,20230114,2801,547,2254,2956.0,2938.2,2840.6
380,全部词条,20230115,2890,472,2418,2801.0,2924.0,2848.0
381,全部词条,20230116,2971,731,2240,2890.0,2923.4,2868.8
382,全部词条,20230117,2941,713,2228,2971.0,2911.8,2886.7
383,全部词条,20230118,3143,650,2493,2941.0,2949.2,2940.0
384,全部词条,20230119,2817,652,2165,3143.0,2952.4,2945.3
385,全部词条,20230120,2530,516,2014,2817.0,2880.4,2902.2
386,全部词条,20230121,2016,304,1712,2530.0,2689.4,2806.4
387,全部词条,20230122,3271,434,2837,2016.0,2755.4,2833.6
388,全部词条,20230123,3118,467,2651,3271.0,2750.4,2849.8
389,全部词条,20230124,3000,376,2624,3118.0,2787.0,2869.7
390,全部词条,20230125,3091,524,2567,3000.0,2899.2,2889.8
391,全部词条,20230126,3091,431,2660,3091.0,3114.2,2901.8
392,全部词条,20230127,2849,475,2374,3091.0,3029.8,2892.6
393,全部词条,20230128,3080,594,2486,2849.0,3022.2,2886.3
394,全部词条,20230129,2981,643,2338,3080.0,3018.4,2902.7
395,全部词条,20230130,2957,706,2251,2981.0,2991.6,2945.4
396,全部词条,20230131,3080,778,2302,2957.0,2989.4,3051.8
397,全部词条,20230201,2989,693,2296,3080.0,3017.4,3023.6
398,全部词条,20230202,2869,718,2151,2989.0,2975.2,2998.7
399,全部词条,20230203,2914,666,2248,2869.0,2961.8,2990.1
400,全部词条,20230204,2788,519,2269,2914.0,2928.0,2959.8
401,全部词条,20230205,2732,576,2156,2788.0,2858.4,2923.9
402,全部词条,20230206,2612,598,2014,2732.0,2783.0,2900.2
403,全部词条,20230207,2787,782,2005,2612.0,2766.6,2870.9
404,全部词条,20230208,2694,645,2049,2787.0,2722.6,2842.2
405,全部词条,20230209,2773,649,2124,2694.0,2719.6,2823.8
406,全部词条,20230210,2783,590,2193,2773.0,2729.8,2794.1
407,全部词条,20230211,2709,535,2174,2783.0,2749.2,2766.1
408,全部词条,20230212,2509,475,2034,2709.0,2693.6,2730.1
409,全部词条,20230213,2478,594,1884,2509.0,2650.4,2686.5
410,全部词条,20230214,2280,578,1702,2478.0,2551.8,2635.7
411,全部词条,20230215,2259,576,1683,2280.0,2447.0,2588.4
412,全部词条,20230216,2321,542,1779,2259.0,2369.4,2559.3
413,全部词条,20230217,2410,668,1742,2321.0,2349.6,2521.6
414,全部词条,20230218,2296,356,1940,2410.0,2313.2,2481.8
415,全部词条,20230219,2426,485,1941,2296.0,2342.4,2447.1
416,全部词条,20230220,2148,562,1586,2426.0,2320.2,2383.6
417,全部词条,20230221,2603,586,2017,2148.0,2376.6,2373.0
418,全部词条,20230222,2470,620,1850,2603.0,2388.6,2369.1
419,全部词条,20230223,2784,640,2144,2470.0,2486.2,2399.7
420,全部词条,20230224,2254,615,1639,2784.0,2451.8,2397.1
421,全部词条,20230225,2237,540,1697,2254.0,2469.6,2394.9
422,全部词条,20230226,1944,464,1480,2237.0,2337.8,2357.2
423,全部词条,20230227,2007,657,1350,1944.0,2245.2,2316.9
424,全部词条,20230228,1757,502,1255,2007.0,2039.8,2263.0
425,全部词条,20230301,1926,534,1392,1757.0,1974.2,2213.0
426,全部词条,20230302,1820,587,1233,1926.0,1890.8,2180.2
427,全部词条,20230303,1763,564,1199,1820.0,1854.6,2096.2
428,全部词条,20230304,1939,477,1462,1763.0,1841.0,2043.1
429,全部词条,20230305,1809,461,1348,1939.0,1851.4,1945.6
430,全部词条,20230306,1712,548,1164,1809.0,1808.6,1891.4
431,全部词条,20230307,1713,537,1176,1712.0,1787.2,1839.0
432,全部词条,20230308,1728,500,1228,1713.0,1780.2,1817.4
433,全部词条,20230309,1661,551,1110,1728.0,1724.6,1782.8
434,全部词条,20230310,1656,410,1246,1661.0,1694.0,1772.7
435,全部词条,20230311,1930,348,1582,1656.0,1737.6,1773.1
436,全部词条,20230312,1971,362,1609,1930.0,1789.2,1788.2
437,全部词条,20230313,1825,482,1343,1971.0,1808.6,1794.4
438,全部词条,20230314,1706,430,1276,1825.0,1817.6,1771.1
439,全部词条,20230315,1814,551,1263,1706.0,1849.2,1771.6
440,全部词条,20230316,1727,465,1262,1814.0,1808.6,1773.1
441,全部词条,20230317,1690,374,1316,1727.0,1752.4,1770.8
442,全部词条,20230318,1842,395,1447,1690.0,1755.8,1782.2
443,全部词条,20230319,1894,489,1405,1842.0,1793.4,1805.5
444,全部词条,20230320,1740,514,1226,1894.0,1778.6,1813.9
445,全部词条,20230321,1781,576,1205,1740.0,1789.4,1799.0
446,全部词条,20230322,1814,620,1194,1781.0,1814.2,1783.3
447,全部词条,20230323,1700,533,1167,1814.0,1785.8,1770.8
448,全部词条,20230324,1797,516,1281,1700.0,1766.4,1779.9
449,全部词条,20230325,1783,410,1373,1797.0,1775.0,1776.8
450,全部词条,20230326,1678,353,1325,1783.0,1754.4,1771.9
451,全部词条,20230327,1935,649,1286,1678.0,1778.6,1796.4
452,全部词条,20230328,1773,542,1231,1935.0,1793.2,1789.5
453,全部词条,20230329,1909,667,1242,1773.0,1815.6,1791.0
454,全部词条,20230330,2001,694,1307,1909.0,1859.2,1817.1
455,全部词条,20230331,1971,663,1308,2001.0,1917.8,1836.1
456,全部词条,20230401,1837,390,1447,1971.0,1898.2,1838.4
457,全部词条,20230402,1987,526,1461,1837.0,1941.0,1867.1
458,全部词条,20230403,1969,675,1294,1987.0,1953.0,1884.3
459,全部词条,20230404,2098,613,1485,1969.0,1972.4,1915.8
460,全部词条,20230405,1894,366,1528,2098.0,1957.0,1937.4
461,全部词条,20230406,1903,643,1260,1894.0,1970.2,1934.2
462,全部词条,20230407,1892,609,1283,1903.0,1951.2,1946.1
463,全部词条,20230408,1914,466,1448,1892.0,1940.2,1946.6
464,全部词条,20230409,1901,413,1488,1914.0,1900.8,1936.6
465,全部词条,20230410,1898,668,1230,1901.0,1901.6,1929.3
466,全部词条,20230411,1888,633,1255,1898.0,1898.6,1934.4
467,全部词条,20230412,1893,650,1243,1888.0,1898.8,1925.0
468,全部词条,20230413,1944,637,1307,1893.0,1904.8,1922.5
469,全部词条,20230414,2050,613,1437,1944.0,1934.6,1917.7
470,全部词条,20230415,2059,524,1535,2050.0,1966.8,1934.2
471,全部词条,20230416,1905,338,1567,2059.0,1970.2,1934.4
472,全部词条,20230417,2102,697,1405,1905.0,2012.0,1955.4
473,全部词条,20230418,1939,552,1387,2102.0,2011.0,1957.9
474,全部词条,20230419,2146,681,1465,1939.0,2030.2,1982.4
475,全部词条,20230420,2211,763,1448,2146.0,2060.6,2013.7
476,全部词条,20230421,2286,704,1582,2211.0,2136.8,2053.5
477,全部词条,20230422,2158,499,1659,2286.0,2148.0,2080.0
478,全部词条,20230423,2297,730,1567,2158.0,2219.6,2115.3
479,全部词条,20230424,2218,634,1584,2297.0,2234.0,2132.1
480,全部词条,20230425,2460,705,1755,2218.0,2283.8,2172.2
481,全部词条,20230426,2435,723,1712,2460.0,2313.6,2225.2
482,全部词条,20230427,2576,691,1885,2435.0,2397.2,2272.6
483,全部词条,20230428,3001,653,2348,2576.0,2538.0,2378.8
484,全部词条,20230429,3535,421,3114,3001.0,2801.4,2517.7
485,全部词条,20230430,4272,563,3709,3535.0,3163.8,2723.8
486,全部词条,20230501,4594,535,4059,4272.0,3595.6,2954.6
487,全部词条,20230502,3343,382,2961,4594.0,3749.0,3073.1
488,全部词条,20230503,2513,487,2026,3343.0,3651.4,3094.7
489,全部词条,20230504,2088,678,1410,2513.0,3362.0,3081.7
490,全部词条,20230505,1910,530,1380,2088.0,2889.6,3026.7
491,全部词条,20230506,1829,524,1305,1910.0,2336.6,2966.1
492,全部词条,20230507,1873,441,1432,1829.0,2042.6,2895.8
493,全部词条,20230508,1806,599,1207,1873.0,1901.2,2776.3
494,全部词条,20230509,1831,575,1256,1806.0,1849.8,2605.9
495,全部词条,20230510,1864,550,1314,1831.0,1840.6,2365.1
496,全部词条,20230511,1862,615,1247,1864.0,1847.2,2091.9
497,全部词条,20230512,1819,607,1212,1862.0,1836.4,1939.5
498,全部词条,20230513,1709,384,1325,1819.0,1817.0,1859.1
499,全部词条,20230514,1783,394,1389,1709.0,1807.4,1828.6
500,全部词条,20230515,1844,582,1262,1783.0,1803.4,1822.0
501,全部词条,20230516,1766,561,1205,1844.0,1784.2,1815.7
502,全部词条,20230517,1856,557,1299,1766.0,1791.6,1814.0
503,全部词条,20230518,1943,663,1280,1856.0,1838.4,1827.7
504,全部词条,20230519,1792,560,1232,1943.0,1840.2,1823.8
505,全部词条,20230520,1777,441,1336,1792.0,1826.8,1815.1
506,全部词条,20230521,1636,319,1317,1777.0,1800.8,1792.5
507,全部词条,20230522,1681,478,1203,1636.0,1765.8,1778.7
508,全部词条,20230523,1645,396,1249,1681.0,1706.2,1772.3
509,全部词条,20230524,1861,611,1250,1645.0,1720.0,1780.1
510,全部词条,20230525,1928,635,1293,1861.0,1750.2,1788.5
511,全部词条,20230526,1861,620,1241,1928.0,1795.2,1798.0
512,全部词条,20230527,1890,521,1369,1861.0,1837.0,1801.4
513,全部词条,20230528,1821,398,1423,1890.0,1872.2,1789.2
514,全部词条,20230529,1979,615,1364,1821.0,1895.8,1807.9
515,全部词条,20230530,1939,597,1342,1979.0,1898.0,1824.1
516,全部词条,20230531,1863,524,1339,1939.0,1898.4,1846.8
517,全部词条,20230601,1874,531,1343,1863.0,1895.2,1866.1
518,全部词条,20230602,1857,558,1299,1874.0,1902.4,1887.3
519,全部词条,20230603,1840,399,1441,1857.0,1874.6,1885.2
520,全部词条,20230604,1834,388,1446,1840.0,1853.6,1875.8
521,全部词条,20230605,1885,537,1348,1834.0,1858.0,1878.2
522,全部词条,20230606,1740,483,1257,1885.0,1831.2,1863.2
523,全部词条,20230607,2035,681,1354,1740.0,1866.8,1884.6
524,全部词条,20230608,1937,630,1307,2035.0,1886.2,1880.4
525,全部词条,20230609,1858,567,1291,1937.0,1891.0,1872.3
526,全部词条,20230610,1740,348,1392,1858.0,1862.0,1860.0
527,全部词条,20230611,1906,406,1500,1740.0,1895.2,1863.2
528,全部词条,20230612,1851,505,1346,1906.0,1858.4,1862.6
529,全部词条,20230613,2050,670,1380,1851.0,1881.0,1883.6
530,全部词条,20230614,1982,638,1344,2050.0,1905.8,1898.4
531,全部词条,20230615,1799,543,1256,1982.0,1917.6,1889.8
532,全部词条,20230616,1964,659,1305,1799.0,1929.2,1912.2
533,全部词条,20230617,1910,472,1438,1964.0,1941.0,1899.7
534,全部词条,20230618,1922,343,1579,1910.0,1915.4,1898.2
535,全部词条,20230619,1952,621,1331,1922.0,1909.4,1907.6
536,全部词条,20230620,2023,606,1417,1952.0,1954.2,1935.9
537,全部词条,20230621,2153,631,1522,2023.0,1992.0,1960.6
538,全部词条,20230622,2254,421,1833,2153.0,2060.8,2000.9
539,全部词条,20230623,2140,400,1740,2254.0,2104.4,2009.9
540,全部词条,20230624,2036,462,1574,2140.0,2121.2,2015.3
541,全部词条,20230625,2166,714,1452,2036.0,2149.8,2052.0
542,全部词条,20230626,2109,708,1401,2166.0,2141.0,2066.5
543,全部词条,20230627,2146,672,1474,2109.0,2119.4,2090.1
544,全部词条,20230628,2101,668,1433,2146.0,2111.6,2108.0
545,全部词条,20230629,1976,514,1462,2101.0,2099.6,2110.4
546,全部词条,20230630,2004,551,1453,1976.0,2067.2,2108.5
547,全部词条,20230701,2127,541,1586,2004.0,2070.8,2105.9
548,全部词条,20230702,2124,518,1606,2127.0,2066.4,2092.9
549,全部词条,20230703,2121,580,1541,2124.0,2070.4,2091.0
550,全部词条,20230704,2102,602,1500,2121.0,2095.6,2097.6
551,全部词条,20230705,2196,652,1544,2102.0,2134.0,2100.6
552,全部词条,20230706,2229,693,1536,2196.0,2154.4,2112.6
553,全部词条,20230707,2282,612,1670,2229.0,2186.0,2126.2
554,全部词条,20230708,2346,509,1837,2282.0,2231.0,2150.7
555,全部词条,20230709,2279,495,1784,2346.0,2266.4,2181.0
556,全部词条,20230710,2502,738,1764,2279.0,2327.6,2230.8
557,全部词条,20230711,2430,608,1822,2502.0,2367.8,2261.1
558,全部词条,20230712,2499,731,1768,2430.0,2411.2,2298.6
559,全部词条,20230713,2528,720,1808,2499.0,2447.6,2339.3
560,全部词条,20230714,2277,583,1694,2528.0,2447.2,2356.8
561,全部词条,20230715,2555,571,1984,2277.0,2457.8,2392.7
562,全部词条,20230716,2473,507,1966,2555.0,2466.4,2417.1
563,全部词条,20230717,2548,681,1867,2473.0,2476.2,2443.7
564,全部词条,20230718,2622,664,1958,2548.0,2495.0,2471.3
565,全部词条,20230719,2639,720,1919,2622.0,2567.4,2507.3
566,全部词条,20230720,2631,715,1916,2639.0,2582.6,2520.2
567,全部词条,20230721,2755,702,2053,2631.0,2639.0,2552.7
568,全部词条,20230722,2583,507,2076,2755.0,2646.0,2561.1
569,全部词条,20230723,2621,559,2062,2583.0,2645.8,2570.4
570,全部词条,20230724,2667,690,1977,2621.0,2651.4,2609.4
571,全部词条,20230725,2767,725,2042,2667.0,2678.6,2630.6
572,全部词条,20230726,2857,679,2178,2767.0,2699.0,2669.0
573,全部词条,20230727,2720,667,2053,2857.0,2726.4,2686.2
574,全部词条,20230728,2809,715,2094,2720.0,2764.0,2704.9
575,全部词条,20230729,3059,502,2557,2809.0,2842.4,2746.9
576,全部词条,20230730,3146,542,2604,3059.0,2918.2,2798.4
577,全部词条,20230731,3169,672,2497,3146.0,2980.6,2839.8
578,全部词条,20230801,2909,672,2237,3169.0,3018.4,2872.4
579,全部词条,20230802,2416,618,1798,2909.0,2939.8,2851.9
580,全部词条,20230803,2754,652,2102,2416.0,2878.8,2860.6
581,全部词条,20230804,2888,650,2238,2754.0,2827.2,2872.7
582,全部词条,20230805,2759,603,2156,2888.0,2745.2,2862.9
583,全部词条,20230806,2730,491,2239,2759.0,2709.4,2863.9
584,全部词条,20230807,2717,602,2115,2730.0,2769.6,2854.7
585,全部词条,20230808,2480,556,1924,2717.0,2714.8,2796.8
586,全部词条,20230809,2518,550,1968,2480.0,2640.8,2734.0
587,全部词条,20230810,2528,579,1949,2518.0,2594.6,2669.9
588,全部词条,20230811,2370,559,1811,2528.0,2522.6,2616.0
589,全部词条,20230812,2309,498,1811,2370.0,2441.0,2605.3
590,全部词条,20230813,2285,409,1876,2309.0,2402.0,2558.4
591,全部词条,20230814,2598,590,2008,2285.0,2418.0,2529.4
592,全部词条,20230815,2611,661,1950,2598.0,2434.6,2514.6
593,全部词条,20230816,2536,590,1946,2611.0,2467.8,2495.2
594,全部词条,20230817,2573,636,1937,2536.0,2520.6,2480.8
595,全部词条,20230818,2531,583,1948,2573.0,2569.8,2485.9
596,全部词条,20230819,2468,484,1984,2531.0,2543.8,2480.9
597,全部词条,20230820,2241,408,1833,2468.0,2469.8,2452.2
598,全部词条,20230821,2348,657,1691,2241.0,2432.2,2450.0
599,全部词条,20230822,2198,585,1613,2348.0,2357.2,2438.9
600,全部词条,20230823,2226,599,1627,2198.0,2296.2,2433.0
601,全部词条,20230824,2246,600,1646,2226.0,2251.8,2397.8
602,全部词条,20230825,2267,613,1654,2246.0,2257.0,2363.4
603,全部词条,20230826,2220,465,1755,2267.0,2231.4,2331.8
604,全部词条,20230827,2093,415,1678,2220.0,2210.4,2283.8
605,全部词条,20230828,2242,652,1590,2093.0,2213.6,2254.9
606,全部词条,20230829,2560,568,1992,2242.0,2276.4,2264.1
607,全部词条,20230830,2072,614,1458,2560.0,2237.4,2247.2
608,全部词条,20230831,2114,546,1568,2072.0,2216.2,2223.8
609,全部词条,20230901,1954,558,1396,2114.0,2188.4,2199.4
610,全部词条,20230902,1898,529,1369,1954.0,2119.6,2166.6
611,全部词条,20230903,1760,398,1362,1898.0,1959.6,2118.0
612,全部词条,20230904,1772,562,1210,1760.0,1899.6,2068.5
613,全部词条,20230905,1758,546,1212,1772.0,1828.4,2022.3
614,全部词条,20230906,1664,472,1192,1758.0,1770.4,1979.4
615,全部词条,20230907,1733,568,1165,1664.0,1737.4,1928.5
616,全部词条,20230908,1854,559,1295,1733.0,1756.2,1857.9
617,全部词条,20230909,1989,465,1524,1854.0,1799.6,1849.6
618,全部词条,20230910,2014,483,1531,1989.0,1850.8,1839.6
619,全部词条,20230911,1793,533,1260,2014.0,1876.6,1823.5
620,全部词条,20230912,1900,617,1283,1793.0,1910.0,1823.7
621,全部词条,20230913,1977,648,1329,1900.0,1934.6,1845.4
622,全部词条,20230914,2043,686,1357,1977.0,1945.4,1872.5
623,全部词条,20230915,2030,643,1387,2043.0,1948.6,1899.7
624,全部词条,20230916,2000,547,1453,2030.0,1990.0,1933.3
625,全部词条,20230917,1937,355,1582,2000.0,1997.4,1953.7
626,全部词条,20230918,1878,601,1277,1937.0,1977.6,1956.1
627,全部词条,20230919,1834,606,1228,1878.0,1935.8,1940.6
628,全部词条,20230920,1866,601,1265,1834.0,1903.0,1925.8
629,全部词条,20230921,1908,662,1246,1866.0,1884.6,1937.3
630,全部词条,20230922,1903,646,1257,1908.0,1877.8,1937.6
631,全部词条,20230923,1786,397,1389,1903.0,1859.4,1918.5
632,全部词条,20230924,1842,481,1361,1786.0,1861.0,1898.4
633,全部词条,20230925,1946,680,1266,1842.0,1877.0,1890.0
634,全部词条,20230926,1881,591,1290,1946.0,1871.6,1878.1
635,全部词条,20230927,2030,621,1409,1881.0,1897.0,1887.4
636,全部词条,20230928,2318,774,1544,2030.0,2003.4,1931.4
637,全部词条,20230929,2150,320,1830,2318.0,2065.0,1963.0
638,全部词条,20230930,2659,422,2237,2150.0,2207.6,2042.3
639,全部词条,20231001,3780,662,3118,2659.0,2587.4,2229.5
640,全部词条,20231002,3739,540,3199,3780.0,2929.2,2413.1
641,全部词条,20231003,3669,722,2947,3739.0,3199.4,2601.4
642,全部词条,20231004,3499,632,2867,3669.0,3469.2,2767.1
643,全部词条,20231005,3097,620,2477,3499.0,3556.8,2882.2
644,全部词条,20231006,3156,768,2388,3097.0,3432.0,3009.7
645,全部词条,20231007,2979,892,2087,3156.0,3280.0,3104.6
646,全部词条,20231008,3017,951,2066,2979.0,3149.6,3174.5
647,全部词条,20231009,3018,1001,2017,3017.0,3053.4,3261.3
648,全部词条,20231010,2978,875,2103,3018.0,3029.6,3293.2
649,全部词条,20231011,3093,873,2220,2978.0,3017.0,3224.5
650,全部词条,20231012,3728,1014,2714,3093.0,3166.8,3223.4
651,全部词条,20231013,3608,1036,2572,3728.0,3285.0,3217.3
652,全部词条,20231014,3538,701,2837,3608.0,3389.0,3221.2
653,全部词条,20231015,3745,774,2971,3538.0,3542.4,3286.0
654,全部词条,20231016,4112,1287,2825,3745.0,3746.2,3381.6
655,全部词条,20231017,4099,1363,2736,4112.0,3820.4,3493.6
656,全部词条,20231018,3948,1237,2711,4099.0,3888.4,3586.7
657,全部词条,20231019,3787,1127,2660,3948.0,3938.2,3663.6
658,全部词条,20231020,3474,1054,2420,3787.0,3884.0,3713.2
659,全部词条,20231021,3346,710,2636,3474.0,3730.8,3738.5
660,全部词条,20231022,3429,828,2601,3346.0,3596.8,3708.6
661,全部词条,20231023,3593,1167,2426,3429.0,3525.8,3707.1
662,全部词条,20231024,3312,1009,2303,3593.0,3430.8,3684.5
663,全部词条,20231025,3480,1256,2224,3312.0,3432.0,3658.0
664,全部词条,20231026,3267,1049,2218,3480.0,3416.2,3573.5
665,全部词条,20231027,3575,1094,2481,3267.0,3445.4,3521.1
666,全部词条,20231028,3529,695,2834,3575.0,3432.6,3479.2
667,全部词条,20231029,3408,738,2670,3529.0,3451.8,3441.3
668,全部词条,20231030,3624,1096,2528,3408.0,3480.6,3456.3
669,全部词条,20231031,3716,1165,2551,3624.0,3570.4,3493.3
670,全部词条,20231101,4162,1156,3006,3716.0,3687.8,3566.6
671,全部词条,20231102,3624,1206,2418,4162.0,3706.8,3569.7
672,全部词条,20231103,3882,1117,2765,3624.0,3801.6,3626.7
673,全部词条,20231104,3656,824,2832,3882.0,3808.0,3644.3
674,全部词条,20231105,3665,828,2837,3656.0,3797.8,3684.1
675,全部词条,20231106,4684,1631,3053,3665.0,3902.2,3795.0
676,全部词条,20231107,4322,1409,2913,4684.0,4041.8,3874.3
677,全部词条,20231108,4627,1407,3220,4322.0,4190.8,3996.2
678,全部词条,20231109,4563,1365,3198,4627.0,4372.2,4090.1
679,全部词条,20231110,4537,1259,3278,4563.0,4546.6,4172.2
680,全部词条,20231111,3941,835,3106,4537.0,4398.0,4150.1
681,全部词条,20231112,4421,801,3620,3941.0,4417.8,4229.8
682,全部词条,20231113,4833,1653,3180,4421.0,4459.0,4324.9
683,全部词条,20231114,5170,1515,3655,4833.0,4580.4,4476.3
684,全部词条,20231115,4759,1556,3203,5170.0,4624.8,4585.7
685,全部词条,20231116,4723,1472,3251,4759.0,4781.2,4589.6
686,全部词条,20231117,5292,1443,3849,4723.0,4955.4,4686.6
687,全部词条,20231118,4485,816,3669,5292.0,4885.8,4672.4
688,全部词条,20231119,5063,851,4212,4485.0,4864.4,4722.4
689,全部词条,20231120,5908,1667,4241,5063.0,5094.2,4859.5
690,全部词条,20231121,5666,1624,4042,5908.0,5282.8,5032.0
691,全部词条,20231122,5622,1584,4038,5666.0,5348.8,5152.1
692,全部词条,20231123,5133,1509,3624,5622.0,5478.4,5182.1
693,全部词条,20231124,5575,1447,4128,5133.0,5580.8,5222.6
694,全部词条,20231125,5184,923,4261,5575.0,5436.0,5265.1
695,全部词条,20231126,5631,1054,4577,5184.0,5429.0,5355.9
696,全部词条,20231127,6129,1838,4291,5631.0,5530.4,5439.6
697,全部词条,20231128,5443,1743,3700,6129.0,5592.4,5535.4
698,全部词条,20231129,5970,1729,4241,5443.0,5671.4,5626.1
699,全部词条,20231130,6019,1714,4305,5970.0,5838.4,5637.2
700,全部词条,20231201,5966,1708,4258,6019.0,5905.4,5667.2
701,全部词条,20231202,5577,1025,4552,5966.0,5795.0,5662.7
702,全部词条,20231203,5783,942,4841,5577.0,5863.0,5727.7
703,全部词条,20231204,6056,1893,4163,5783.0,5880.2,5775.8
704,全部词条,20231205,6071,1651,4420,6056.0,5890.6,5864.5
705,全部词条,20231206,6337,1883,4454,6071.0,5964.8,5935.1
706,全部词条,20231207,5907,1775,4132,6337.0,6030.8,5912.9
707,全部词条,20231208,5740,1647,4093,5907.0,6022.2,5942.6
708,全部词条,20231209,5427,1054,4373,5740.0,5896.4,5888.3
709,全部词条,20231210,5698,981,4717,5427.0,5821.8,5856.2
710,全部词条,20231211,5377,2008,3369,5698.0,5629.8,5797.3
711,全部词条,20231212,4889,1953,2936,5377.0,5426.2,5728.5
712,全部词条,20231213,5604,1800,3804,4889.0,5399.0,5710.6
713,全部词条,20231214,6591,1895,4696,5604.0,5631.8,5764.1
714,全部词条,20231215,13389,1805,11584,6591.0,7170.0,6495.9
715,全部词条,20231216,6046,1043,5003,13389.0,7303.8,6466.8
716,全部词条,20231217,6117,1179,4938,6046.0,7549.4,6487.8
717,全部词条,20231218,8303,2260,6043,6117.0,8089.2,6744.1
718,全部词条,20231219,8278,2326,5952,8303.0,8426.6,7029.2
719,全部词条,20231220,9123,2485,6638,8278.0,7573.4,7371.7
720,全部词条,20231221,9855,2409,7446,9123.0,8335.2,7819.5
721,全部词条,20231222,8153,1878,6275,9855.0,8742.4,8145.9
722,全部词条,20231223,7319,1252,6067,8153.0,8545.6,8317.4
723,全部词条,20231224,7265,1372,5893,7319.0,8343.0,8384.8
724,全部词条,20231225,8075,2086,5989,7265.0,8133.4,7853.4
725,全部词条,20231226,8244,2137,6107,8075.0,7811.2,8073.2
726,全部词条,20231227,8450,2215,6235,8244.0,7870.6,8306.5
727,全部词条,20231228,8880,2336,6544,8450.0,8182.8,8364.2
728,全部词条,20231229,9260,2365,6895,8880.0,8581.8,8462.4
729,全部词条,20231230,9078,1474,7604,9260.0,8782.4,8457.9
730,全部词条,20231231,9409,1557,7852,9078.0,9015.4,8413.3
731,全部词条,20240101,9709,1825,7884,9409.0,9267.2,8568.9
732,全部词条,20240102,10186,3600,6586,9709.0,9528.4,8855.6
733,全部词条,20240103,16287,6761,9526,10186.0,10933.8,9757.8
734,全部词条,20240104,17865,5898,11967,16287.0,12691.2,10736.8
735,全部词条,20240105,21981,6235,15746,17865.0,15205.6,12110.5
736,全部词条,20240106,21491,3125,18366,21981.0,17562.0,13414.6
737,全部词条,20240107,19748,2942,16806,21491.0,19474.4,14501.4
738,全部词条,20240108,22920,4305,18615,19748.0,20801.0,15867.4
739,全部词条,20240109,22878,4311,18567,22920.0,21803.6,17247.4
740,全部词条,20240110,18435,4113,14322,22878.0,21094.4,18150.0
741,全部词条,20240111,16782,4404,12378,18435.0,20152.6,18857.3
742,全部词条,20240112,18609,3933,14676,16782.0,19924.8,19699.6
743,全部词条,20240113,15941,2314,13627,18609.0,18529.0,19665.0
744,全部词条,20240114,13817,2040,11777,15941.0,16716.8,19260.2
745,全部词条,20240115,16740,3267,13473,13817.0,16377.8,18736.1
746,全部词条,20240116,18060,3488,14572,16740.0,16633.4,18393.0
747,全部词条,20240117,18088,2959,15129,18060.0,16529.2,18227.0
748,全部词条,20240118,16902,2438,14464,18088.0,16721.4,17625.2
749,全部词条,20240119,16993,2452,14541,16902.0,17356.6,17036.7
750,全部词条,20240120,14842,1554,13288,16993.0,16977.0,16677.4
751,全部词条,20240121,14109,1717,12392,14842.0,16186.8,16410.1
752,全部词条,20240122,16232,2642,13590,14109.0,15815.6,16172.4
753,全部词条,20240123,16476,2424,14052,16232.0,15730.4,16225.9
754,全部词条,20240124,14208,2178,12030,16476.0,15173.4,16265.0
755,全部词条,20240125,16368,2102,14266,14208.0,15478.6,16227.8
756,全部词条,20240126,16154,1850,14304,16368.0,15887.6,16037.2
757,全部词条,20240127,14153,1688,12465,16154.0,15471.8,15643.7
758,全部词条,20240128,14188,1623,12565,14153.0,15014.2,15372.3
759,全部词条,20240129,15495,2207,13288,14188.0,15271.6,15222.5
760,全部词条,20240130,20239,1931,18308,15495.0,16045.8,15762.2
761,全部词条,20240131,20388,1845,18543,20239.0,16892.6,16390.1
762,全部词条,20240201,20202,1908,18294,20388.0,18102.4,16787.1
763,全部词条,20240202,24946,1656,23290,20202.0,20254.0,17634.1
764,全部词条,20240203,26240,1419,24821,24946.0,22403.0,18837.3
765,全部词条,20240204,28461,1947,26514,26240.0,24047.4,20046.6
766,全部词条,20240205,27849,1529,26320,28461.0,25539.6,21216.1
767,全部词条,20240206,25105,1411,23694,27849.0,26520.2,22311.3
768,全部词条,20240207,24845,1383,23462,25105.0,26500.0,23377.0
769,全部词条,20240208,22755,1160,21595,24845.0,25803.0,24103.0
770,全部词条,20240209,21551,813,20738,22755.0,24421.0,24234.2
771,全部词条,20240210,20459,751,19708,21551.0,22943.0,24241.3
772,全部词条,20240211,22663,894,21769,20459.0,22454.6,24487.4
773,全部词条,20240212,23378,801,22577,22663.0,22161.2,24330.6
774,全部词条,20240213,26136,1003,25133,23378.0,22837.4,24320.2
775,全部词条,20240214,26381,1068,25313,26136.0,23803.4,24112.2
776,全部词条,20240215,21986,1154,20832,26381.0,24108.8,23525.9
777,全部词条,20240216,24230,1064,23166,21986.0,24422.2,23438.4
778,全部词条,20240217,20662,1088,19574,24230.0,23879.0,23020.1
779,全部词条,20240218,20915,1542,19373,20662.0,22834.8,22836.1
780,全部词条,20240219,18200,1621,16579,20915.0,21198.6,22501.0
781,全部词条,20240220,19932,1357,18575,18200.0,20787.8,22448.3
782,全部词条,20240221,17715,1374,16341,19932.0,19484.8,21953.5
783,全部词条,20240222,18478,1461,17017,17715.0,19048.0,21463.5
784,全部词条,20240223,16814,1381,15433,18478.0,18227.8,20531.3
785,全部词条,20240224,14771,947,13824,16814.0,17542.0,19370.3
786,全部词条,20240225,9926,1027,8899,14771.0,15540.8,18164.3
787,全部词条,20240226,9937,1616,8321,9926.0,13985.2,16735.0
788,全部词条,20240227,8359,1422,6937,9937.0,11961.4,15504.7
789,全部词条,20240228,8103,1327,6776,8359.0,10219.2,14223.5
790,全部词条,20240229,7564,1247,6317,8103.0,8777.8,13159.9
791,全部词条,20240301,7402,1159,6243,7564.0,8273.0,11906.9
792,全部词条,20240302,8474,797,7677,7402.0,7980.4,10982.8
793,全部词条,20240303,8621,907,7714,8474.0,8032.8,9997.1
794,全部词条,20240304,6668,1166,5502,8621.0,7745.8,8982.5
795,全部词条,20240305,6384,1136,5248,6668.0,7509.8,8143.8
796,全部词条,20240306,6762,1116,5646,6384.0,7381.8,7827.4
797,全部词条,20240307,7320,1184,6136,6762.0,7151.0,7565.7
798,全部词条,20240308,12446,947,11499,7320.0,7916.0,7974.4
799,全部词条,20240309,9690,903,8787,12446.0,8520.4,8133.1
800,全部词条,20240310,9997,886,9111,9690.0,9243.0,8376.4
801,全部词条,20240311,9629,1201,8428,9997.0,9816.4,8599.1
802,全部词条,20240312,9378,1146,8232,9629.0,10228.0,8689.5
803,全部词条,20240313,9184,1080,8104,9378.0,9575.6,8745.8
804,全部词条,20240314,8050,1192,6858,9184.0,9247.6,8884.0
805,全部词条,20240315,10324,904,9420,8050.0,9313.0,9278.0
806,全部词条,20240316,6784,841,5943,10324.0,8744.0,9280.2
807,全部词条,20240317,6024,750,5274,6784.0,8073.2,9150.6
808,全部词条,20240318,5527,936,4591,6024.0,7341.8,8458.7
809,全部词条,20240319,4906,1042,3864,5527.0,6713.0,7980.3
810,全部词条,20240320,4627,1044,3583,4906.0,5573.6,7443.3
811,全部词条,20240321,4763,1015,3748,4627.0,5169.4,6956.7
812,全部词条,20240322,8501,1026,7475,4763.0,5664.8,6869.0
813,全部词条,20240323,8186,863,7323,8501.0,6196.6,6769.2
814,全部词条,20240324,8578,828,7750,8186.0,6931.0,6822.0
815,全部词条,20240325,7412,1123,6289,8578.0,7488.0,6530.8
816,全部词条,20240326,7573,1013,6560,7412.0,8050.0,6609.7
817,全部词条,20240327,7751,1088,6663,7573.0,7900.0,6782.4
818,全部词条,20240328,7425,1103,6322,7751.0,7747.8,6972.2
819,全部词条,20240329,6115,997,5118,7425.0,7255.2,7093.1
820,全部词条,20240330,8438,787,7651,6115.0,7460.4,7474.2
821,全部词条,20240331,6886,655,6231,8438.0,7323.0,7686.5
822,全部词条,20240401,5440,1166,4274,6886.0,6860.8,7380.4
823,全部词条,20240402,4562,1115,3447,5440.0,6288.2,7018.0
824,全部词条,20240403,6302,1074,5228,4562.0,6325.6,6790.4
825,全部词条,20240404,7397,790,6607,6302.0,6117.4,6788.9
826,全部词条,20240405,5752,722,5030,7397.0,5890.6,6606.8
827,全部词条,20240406,4654,818,3836,5752.0,5733.4,6297.1
828,全部词条,20240407,4831,1048,3783,4654.0,5787.2,6037.7
829,全部词条,20240408,4269,1111,3158,4831.0,5380.6,5853.1
830,全部词条,20240409,4253,1008,3245,4269.0,4751.8,5434.6
831,全部词条,20240410,4173,889,3284,4253.0,4436.0,5163.3
832,全部词条,20240411,4083,1079,3004,4173.0,4321.8,5027.6
833,全部词条,20240412,5870,943,4927,4083.0,4529.6,5158.4
834,全部词条,20240413,4624,928,3696,5870.0,4600.6,4990.6
835,全部词条,20240414,4399,925,3474,4624.0,4629.8,4690.8
836,全部词条,20240415,4214,1001,3213,4399.0,4638.0,4537.0
837,全部词条,20240416,4254,1073,3181,4214.0,4672.2,4497.0
838,全部词条,20240417,4164,1036,3128,4254.0,4331.0,4430.3
839,全部词条,20240418,4259,1075,3184,4164.0,4258.0,4429.3
840,全部词条,20240419,4233,1014,3219,4259.0,4224.8,4427.3
841,全部词条,20240420,4186,862,3324,4233.0,4219.2,4428.6
842,全部词条,20240421,4353,817,3536,4186.0,4239.0,4455.6
843,全部词条,20240422,4074,1018,3056,4353.0,4221.0,4276.0
844,全部词条,20240423,4078,978,3100,4074.0,4184.8,4221.4
845,全部词条,20240424,4215,1008,3207,4078.0,4181.2,4203.0
846,全部词条,20240425,4268,985,3283,4215.0,4197.6,4208.4
847,全部词条,20240426,4191,1094,3097,4268.0,4165.2,4202.1
848,全部词条,20240427,4591,812,3779,4191.0,4268.6,4244.8
849,全部词条,20240428,4937,1199,3738,4591.0,4440.4,4312.6
850,全部词条,20240429,4226,1098,3128,4937.0,4442.6,4311.9
851,全部词条,20240430,4951,1154,3797,4226.0,4579.2,4388.4
