date,关键词,日期,省份,城市,PC+移动端,PC端,移动端
1,哈尔滨旅游,20220101,全国,全国,217,66,151
2,哈尔滨旅游,20220102,全国,全国,239,74,165
3,哈尔滨旅游,20220103,全国,全国,247,63,184
4,哈尔滨旅游,20220104,全国,全国,258,93,165
5,哈尔滨旅游,20220105,全国,全国,252,104,148
6,哈尔滨旅游,20220106,全国,全国,241,78,163
7,哈尔滨旅游,20220107,全国,全国,243,78,165
8,哈尔滨旅游,20220108,全国,全国,228,68,160
9,哈尔滨旅游,20220109,全国,全国,225,74,151
10,哈尔滨旅游,20220110,全国,全国,210,80,130
11,哈尔滨旅游,20220111,全国,全国,210,74,136
12,哈尔滨旅游,20220112,全国,全国,232,85,147
13,哈尔滨旅游,20220113,全国,全国,219,68,151
14,哈尔滨旅游,20220114,全国,全国,189,68,121
15,哈尔滨旅游,20220115,全国,全国,208,78,130
16,哈尔滨旅游,20220116,全国,全国,235,68,167
17,哈尔滨旅游,20220117,全国,全国,221,78,143
18,哈尔滨旅游,20220118,全国,全国,204,74,130
19,哈尔滨旅游,20220119,全国,全国,216,68,148
20,哈尔滨旅游,20220120,全国,全国,204,72,132
21,哈尔滨旅游,20220121,全国,全国,217,74,143
22,哈尔滨旅游,20220122,全国,全国,220,72,148
23,哈尔滨旅游,20220123,全国,全国,198,72,126
24,哈尔滨旅游,20220124,全国,全国,219,76,143
25,哈尔滨旅游,20220125,全国,全国,217,74,143
26,哈尔滨旅游,20220126,全国,全国,241,80,161
27,哈尔滨旅游,20220127,全国,全国,215,74,141
28,哈尔滨旅游,20220128,全国,全国,211,68,143
29,哈尔滨旅游,20220129,全国,全国,159,0,159
30,哈尔滨旅游,20220130,全国,全国,209,68,141
31,哈尔滨旅游,20220131,全国,全国,188,63,125
32,哈尔滨旅游,20220201,全国,全国,204,59,145
33,哈尔滨旅游,20220202,全国,全国,225,61,164
34,哈尔滨旅游,20220203,全国,全国,224,66,158
35,哈尔滨旅游,20220204,全国,全国,218,61,157
36,哈尔滨旅游,20220205,全国,全国,236,66,170
37,哈尔滨旅游,20220206,全国,全国,222,59,163
38,哈尔滨旅游,20220207,全国,全国,248,80,168
39,哈尔滨旅游,20220208,全国,全国,255,82,173
40,哈尔滨旅游,20220209,全国,全国,225,74,151
41,哈尔滨旅游,20220210,全国,全国,220,68,152
42,哈尔滨旅游,20220211,全国,全国,221,74,147
43,哈尔滨旅游,20220212,全国,全国,240,72,168
44,哈尔滨旅游,20220213,全国,全国,232,66,166
45,哈尔滨旅游,20220214,全国,全国,238,83,155
46,哈尔滨旅游,20220215,全国,全国,229,74,155
47,哈尔滨旅游,20220216,全国,全国,246,85,161
48,哈尔滨旅游,20220217,全国,全国,246,76,170
49,哈尔滨旅游,20220218,全国,全国,246,78,168
50,哈尔滨旅游,20220219,全国,全国,247,76,171
51,哈尔滨旅游,20220220,全国,全国,248,72,176
52,哈尔滨旅游,20220221,全国,全国,247,83,164
53,哈尔滨旅游,20220222,全国,全国,250,76,174
54,哈尔滨旅游,20220223,全国,全国,227,72,155
55,哈尔滨旅游,20220224,全国,全国,200,82,118
56,哈尔滨旅游,20220225,全国,全国,197,76,121
57,哈尔滨旅游,20220226,全国,全国,177,72,105
58,哈尔滨旅游,20220227,全国,全国,105,0,105
59,哈尔滨旅游,20220228,全国,全国,188,76,112
60,哈尔滨旅游,20220301,全国,全国,191,76,115
61,哈尔滨旅游,20220302,全国,全国,172,63,109
62,哈尔滨旅游,20220303,全国,全国,172,72,100
63,哈尔滨旅游,20220304,全国,全国,157,64,93
64,哈尔滨旅游,20220305,全国,全国,174,61,113
65,哈尔滨旅游,20220306,全国,全国,188,66,122
66,哈尔滨旅游,20220307,全国,全国,179,66,113
67,哈尔滨旅游,20220308,全国,全国,164,68,96
68,哈尔滨旅游,20220309,全国,全国,199,76,123
69,哈尔滨旅游,20220310,全国,全国,190,78,112
70,哈尔滨旅游,20220311,全国,全国,195,74,121
71,哈尔滨旅游,20220312,全国,全国,140,64,76
72,哈尔滨旅游,20220313,全国,全国,156,64,92
73,哈尔滨旅游,20220314,全国,全国,155,72,83
74,哈尔滨旅游,20220315,全国,全国,162,70,92
75,哈尔滨旅游,20220316,全国,全国,162,70,92
76,哈尔滨旅游,20220317,全国,全国,147,64,83
77,哈尔滨旅游,20220318,全国,全国,157,70,87
78,哈尔滨旅游,20220319,全国,全国,163,59,104
79,哈尔滨旅游,20220320,全国,全国,154,68,86
80,哈尔滨旅游,20220321,全国,全国,158,61,97
81,哈尔滨旅游,20220322,全国,全国,168,63,105
82,哈尔滨旅游,20220323,全国,全国,144,70,74
83,哈尔滨旅游,20220324,全国,全国,160,63,97
84,哈尔滨旅游,20220325,全国,全国,169,72,97
85,哈尔滨旅游,20220326,全国,全国,148,61,87
86,哈尔滨旅游,20220327,全国,全国,138,59,79
87,哈尔滨旅游,20220328,全国,全国,148,64,84
88,哈尔滨旅游,20220329,全国,全国,158,72,86
89,哈尔滨旅游,20220330,全国,全国,154,61,93
90,哈尔滨旅游,20220331,全国,全国,142,68,74
91,哈尔滨旅游,20220401,全国,全国,160,68,92
92,哈尔滨旅游,20220402,全国,全国,143,61,82
93,哈尔滨旅游,20220403,全国,全国,148,59,89
94,哈尔滨旅游,20220404,全国,全国,151,59,92
95,哈尔滨旅游,20220405,全国,全国,154,70,84
96,哈尔滨旅游,20220406,全国,全国,163,64,99
97,哈尔滨旅游,20220407,全国,全国,167,68,99
98,哈尔滨旅游,20220408,全国,全国,150,68,82
99,哈尔滨旅游,20220409,全国,全国,168,68,100
100,哈尔滨旅游,20220410,全国,全国,182,72,110
101,哈尔滨旅游,20220411,全国,全国,150,66,84
102,哈尔滨旅游,20220412,全国,全国,167,63,104
103,哈尔滨旅游,20220413,全国,全国,169,72,97
104,哈尔滨旅游,20220414,全国,全国,169,74,95
105,哈尔滨旅游,20220415,全国,全国,157,66,91
106,哈尔滨旅游,20220416,全国,全国,160,68,92
107,哈尔滨旅游,20220417,全国,全国,157,61,96
108,哈尔滨旅游,20220418,全国,全国,163,64,99
109,哈尔滨旅游,20220419,全国,全国,147,68,79
110,哈尔滨旅游,20220420,全国,全国,157,61,96
111,哈尔滨旅游,20220421,全国,全国,171,66,105
112,哈尔滨旅游,20220422,全国,全国,162,70,92
113,哈尔滨旅游,20220423,全国,全国,163,61,102
114,哈尔滨旅游,20220424,全国,全国,152,66,86
115,哈尔滨旅游,20220425,全国,全国,150,66,84
116,哈尔滨旅游,20220426,全国,全国,159,68,91
117,哈尔滨旅游,20220427,全国,全国,163,63,100
118,哈尔滨旅游,20220428,全国,全国,171,63,108
119,哈尔滨旅游,20220429,全国,全国,169,70,99
120,哈尔滨旅游,20220430,全国,全国,160,64,96
121,哈尔滨旅游,20220501,全国,全国,166,64,102
122,哈尔滨旅游,20220502,全国,全国,159,63,96
123,哈尔滨旅游,20220503,全国,全国,140,61,79
124,哈尔滨旅游,20220504,全国,全国,169,63,106
125,哈尔滨旅游,20220505,全国,全国,167,70,97
126,哈尔滨旅游,20220506,全国,全国,144,61,83
127,哈尔滨旅游,20220507,全国,全国,172,72,100
128,哈尔滨旅游,20220508,全国,全国,154,59,95
129,哈尔滨旅游,20220509,全国,全国,169,64,105
130,哈尔滨旅游,20220510,全国,全国,172,66,106
131,哈尔滨旅游,20220511,全国,全国,214,76,138
132,哈尔滨旅游,20220512,全国,全国,293,74,219
133,哈尔滨旅游,20220513,全国,全国,238,64,174
134,哈尔滨旅游,20220514,全国,全国,187,64,123
135,哈尔滨旅游,20220515,全国,全国,177,64,113
136,哈尔滨旅游,20220516,全国,全国,179,70,109
137,哈尔滨旅游,20220517,全国,全国,213,66,147
138,哈尔滨旅游,20220518,全国,全国,164,64,100
139,哈尔滨旅游,20220519,全国,全国,179,64,115
140,哈尔滨旅游,20220520,全国,全国,230,72,158
141,哈尔滨旅游,20220521,全国,全国,225,68,157
142,哈尔滨旅游,20220522,全国,全国,213,68,145
143,哈尔滨旅游,20220523,全国,全国,232,66,166
144,哈尔滨旅游,20220524,全国,全国,215,72,143
145,哈尔滨旅游,20220525,全国,全国,234,83,151
146,哈尔滨旅游,20220526,全国,全国,236,74,162
147,哈尔滨旅游,20220527,全国,全国,219,68,151
148,哈尔滨旅游,20220528,全国,全国,248,74,174
149,哈尔滨旅游,20220529,全国,全国,217,66,151
150,哈尔滨旅游,20220530,全国,全国,238,93,145
151,哈尔滨旅游,20220531,全国,全国,205,80,125
152,哈尔滨旅游,20220601,全国,全国,208,74,134
153,哈尔滨旅游,20220602,全国,全国,268,97,171
154,哈尔滨旅游,20220603,全国,全国,232,68,164
155,哈尔滨旅游,20220604,全国,全国,218,61,157
156,哈尔滨旅游,20220605,全国,全国,219,59,160
157,哈尔滨旅游,20220606,全国,全国,268,72,196
158,哈尔滨旅游,20220607,全国,全国,246,76,170
159,哈尔滨旅游,20220608,全国,全国,269,83,186
160,哈尔滨旅游,20220609,全国,全国,359,97,262
161,哈尔滨旅游,20220610,全国,全国,263,85,178
162,哈尔滨旅游,20220611,全国,全国,238,68,170
163,哈尔滨旅游,20220612,全国,全国,227,63,164
164,哈尔滨旅游,20220613,全国,全国,283,85,198
165,哈尔滨旅游,20220614,全国,全国,269,91,178
166,哈尔滨旅游,20220615,全国,全国,246,78,168
167,哈尔滨旅游,20220616,全国,全国,250,74,176
168,哈尔滨旅游,20220617,全国,全国,286,85,201
169,哈尔滨旅游,20220618,全国,全国,256,66,190
170,哈尔滨旅游,20220619,全国,全国,287,66,221
171,哈尔滨旅游,20220620,全国,全国,281,72,209
172,哈尔滨旅游,20220621,全国,全国,270,91,179
173,哈尔滨旅游,20220622,全国,全国,295,83,212
174,哈尔滨旅游,20220623,全国,全国,314,89,225
175,哈尔滨旅游,20220624,全国,全国,347,99,248
176,哈尔滨旅游,20220625,全国,全国,249,63,186
177,哈尔滨旅游,20220626,全国,全国,293,85,208
178,哈尔滨旅游,20220627,全国,全国,312,97,215
179,哈尔滨旅游,20220628,全国,全国,336,121,215
180,哈尔滨旅游,20220629,全国,全国,367,108,259
181,哈尔滨旅游,20220630,全国,全国,382,125,257
182,哈尔滨旅游,20220701,全国,全国,353,93,260
183,哈尔滨旅游,20220702,全国,全国,351,87,264
184,哈尔滨旅游,20220703,全国,全国,356,72,284
185,哈尔滨旅游,20220704,全国,全国,391,121,270
186,哈尔滨旅游,20220705,全国,全国,419,123,296
187,哈尔滨旅游,20220706,全国,全国,408,116,292
188,哈尔滨旅游,20220707,全国,全国,392,93,299
189,哈尔滨旅游,20220708,全国,全国,407,101,306
190,哈尔滨旅游,20220709,全国,全国,395,83,312
191,哈尔滨旅游,20220710,全国,全国,408,66,342
192,哈尔滨旅游,20220711,全国,全国,477,139,338
193,哈尔滨旅游,20220712,全国,全国,509,121,388
194,哈尔滨旅游,20220713,全国,全国,500,120,380
195,哈尔滨旅游,20220714,全国,全国,531,144,387
196,哈尔滨旅游,20220715,全国,全国,510,133,377
197,哈尔滨旅游,20220716,全国,全国,409,89,320
198,哈尔滨旅游,20220717,全国,全国,348,93,255
199,哈尔滨旅游,20220718,全国,全国,401,159,242
200,哈尔滨旅游,20220719,全国,全国,415,123,292
201,哈尔滨旅游,20220720,全国,全国,388,110,278
202,哈尔滨旅游,20220721,全国,全国,449,116,333
203,哈尔滨旅游,20220722,全国,全国,433,125,308
204,哈尔滨旅游,20220723,全国,全国,390,78,312
205,哈尔滨旅游,20220724,全国,全国,394,82,312
206,哈尔滨旅游,20220725,全国,全国,515,150,365
207,哈尔滨旅游,20220726,全国,全国,444,118,326
208,哈尔滨旅游,20220727,全国,全国,448,121,327
209,哈尔滨旅游,20220728,全国,全国,416,116,300
210,哈尔滨旅游,20220729,全国,全国,436,110,326
211,哈尔滨旅游,20220730,全国,全国,440,99,341
212,哈尔滨旅游,20220731,全国,全国,437,95,342
213,哈尔滨旅游,20220801,全国,全国,493,158,335
214,哈尔滨旅游,20220802,全国,全国,445,137,308
215,哈尔滨旅游,20220803,全国,全国,436,140,296
216,哈尔滨旅游,20220804,全国,全国,485,152,333
217,哈尔滨旅游,20220805,全国,全国,502,129,373
218,哈尔滨旅游,20220806,全国,全国,386,74,312
219,哈尔滨旅游,20220807,全国,全国,402,72,330
220,哈尔滨旅游,20220808,全国,全国,450,137,313
221,哈尔滨旅游,20220809,全国,全国,392,121,271
222,哈尔滨旅游,20220810,全国,全国,409,125,284
223,哈尔滨旅游,20220811,全国,全国,356,102,254
224,哈尔滨旅游,20220812,全国,全国,344,112,232
225,哈尔滨旅游,20220813,全国,全国,317,70,247
226,哈尔滨旅游,20220814,全国,全国,325,82,243
227,哈尔滨旅游,20220815,全国,全国,383,120,263
228,哈尔滨旅游,20220816,全国,全国,354,101,253
229,哈尔滨旅游,20220817,全国,全国,331,102,229
230,哈尔滨旅游,20220818,全国,全国,322,114,208
231,哈尔滨旅游,20220819,全国,全国,323,99,224
232,哈尔滨旅游,20220820,全国,全国,285,82,203
233,哈尔滨旅游,20220821,全国,全国,245,72,173
234,哈尔滨旅游,20220822,全国,全国,291,99,192
235,哈尔滨旅游,20220823,全国,全国,297,121,176
236,哈尔滨旅游,20220824,全国,全国,329,104,225
237,哈尔滨旅游,20220825,全国,全国,284,97,187
238,哈尔滨旅游,20220826,全国,全国,338,85,253
239,哈尔滨旅游,20220827,全国,全国,256,74,182
240,哈尔滨旅游,20220828,全国,全国,228,63,165
241,哈尔滨旅游,20220829,全国,全国,194,82,112
242,哈尔滨旅游,20220830,全国,全国,193,87,106
243,哈尔滨旅游,20220831,全国,全国,201,80,121
244,哈尔滨旅游,20220901,全国,全国,197,87,110
245,哈尔滨旅游,20220902,全国,全国,165,76,89
246,哈尔滨旅游,20220903,全国,全国,179,64,115
247,哈尔滨旅游,20220904,全国,全国,192,61,131
248,哈尔滨旅游,20220905,全国,全国,186,76,110
249,哈尔滨旅游,20220906,全国,全国,174,74,100
250,哈尔滨旅游,20220907,全国,全国,193,80,113
251,哈尔滨旅游,20220908,全国,全国,199,82,117
252,哈尔滨旅游,20220909,全国,全国,178,61,117
253,哈尔滨旅游,20220910,全国,全国,173,63,110
254,哈尔滨旅游,20220911,全国,全国,207,68,139
255,哈尔滨旅游,20220912,全国,全国,189,63,126
256,哈尔滨旅游,20220913,全国,全国,221,83,138
257,哈尔滨旅游,20220914,全国,全国,218,83,135
258,哈尔滨旅游,20220915,全国,全国,218,83,135
259,哈尔滨旅游,20220916,全国,全国,228,85,143
260,哈尔滨旅游,20220917,全国,全国,256,70,186
261,哈尔滨旅游,20220918,全国,全国,243,82,161
262,哈尔滨旅游,20220919,全国,全国,276,106,170
263,哈尔滨旅游,20220920,全国,全国,230,89,141
264,哈尔滨旅游,20220921,全国,全国,217,95,122
265,哈尔滨旅游,20220922,全国,全国,229,91,138
266,哈尔滨旅游,20220923,全国,全国,227,93,134
267,哈尔滨旅游,20220924,全国,全国,197,66,131
268,哈尔滨旅游,20220925,全国,全国,215,68,147
269,哈尔滨旅游,20220926,全国,全国,246,108,138
270,哈尔滨旅游,20220927,全国,全国,246,116,130
271,哈尔滨旅游,20220928,全国,全国,204,83,121
272,哈尔滨旅游,20220929,全国,全国,227,76,151
273,哈尔滨旅游,20220930,全国,全国,257,83,174
274,哈尔滨旅游,20221001,全国,全国,194,64,130
275,哈尔滨旅游,20221002,全国,全国,200,74,126
276,哈尔滨旅游,20221003,全国,全国,211,68,143
277,哈尔滨旅游,20221004,全国,全国,194,64,130
278,哈尔滨旅游,20221005,全国,全国,172,64,108
279,哈尔滨旅游,20221006,全国,全国,215,66,149
280,哈尔滨旅游,20221007,全国,全国,264,85,179
281,哈尔滨旅游,20221008,全国,全国,222,101,121
282,哈尔滨旅游,20221009,全国,全国,238,97,141
283,哈尔滨旅游,20221010,全国,全国,206,91,115
284,哈尔滨旅游,20221011,全国,全国,230,95,135
285,哈尔滨旅游,20221012,全国,全国,195,74,121
286,哈尔滨旅游,20221013,全国,全国,189,89,100
287,哈尔滨旅游,20221014,全国,全国,201,89,112
288,哈尔滨旅游,20221015,全国,全国,202,66,136
289,哈尔滨旅游,20221016,全国,全国,188,80,108
290,哈尔滨旅游,20221017,全国,全国,227,101,126
291,哈尔滨旅游,20221018,全国,全国,232,91,141
292,哈尔滨旅游,20221019,全国,全国,208,82,126
293,哈尔滨旅游,20221020,全国,全国,248,104,144
294,哈尔滨旅游,20221021,全国,全国,241,87,154
295,哈尔滨旅游,20221022,全国,全国,213,74,139
296,哈尔滨旅游,20221023,全国,全国,215,72,143
297,哈尔滨旅游,20221024,全国,全国,235,74,161
298,哈尔滨旅游,20221025,全国,全国,221,85,136
299,哈尔滨旅游,20221026,全国,全国,234,99,135
300,哈尔滨旅游,20221027,全国,全国,220,85,135
301,哈尔滨旅游,20221028,全国,全国,208,83,125
302,哈尔滨旅游,20221029,全国,全国,214,78,136
303,哈尔滨旅游,20221030,全国,全国,190,59,131
304,哈尔滨旅游,20221031,全国,全国,217,82,135
305,哈尔滨旅游,20221101,全国,全国,193,80,113
306,哈尔滨旅游,20221102,全国,全国,218,83,135
307,哈尔滨旅游,20221103,全国,全国,198,83,115
308,哈尔滨旅游,20221104,全国,全国,186,74,112
309,哈尔滨旅游,20221105,全国,全国,199,63,136
310,哈尔滨旅游,20221106,全国,全国,209,66,143
311,哈尔滨旅游,20221107,全国,全国,229,101,128
312,哈尔滨旅游,20221108,全国,全国,206,89,117
313,哈尔滨旅游,20221109,全国,全国,216,82,134
314,哈尔滨旅游,20221110,全国,全国,190,78,112
315,哈尔滨旅游,20221111,全国,全国,215,74,141
316,哈尔滨旅游,20221112,全国,全国,220,63,157
317,哈尔滨旅游,20221113,全国,全国,223,66,157
318,哈尔滨旅游,20221114,全国,全国,247,102,145
319,哈尔滨旅游,20221115,全国,全国,229,106,123
320,哈尔滨旅游,20221116,全国,全国,255,110,145
321,哈尔滨旅游,20221117,全国,全国,275,110,165
322,哈尔滨旅游,20221118,全国,全国,260,97,163
323,哈尔滨旅游,20221119,全国,全国,233,78,155
324,哈尔滨旅游,20221120,全国,全国,238,72,166
325,哈尔滨旅游,20221121,全国,全国,260,97,163
326,哈尔滨旅游,20221122,全国,全国,252,91,161
327,哈尔滨旅游,20221123,全国,全国,224,85,139
328,哈尔滨旅游,20221124,全国,全国,213,70,143
329,哈尔滨旅游,20221125,全国,全国,217,85,132
330,哈尔滨旅游,20221126,全国,全国,190,68,122
331,哈尔滨旅游,20221127,全国,全国,131,0,131
332,哈尔滨旅游,20221128,全国,全国,242,99,143
333,哈尔滨旅游,20221129,全国,全国,204,78,126
334,哈尔滨旅游,20221130,全国,全国,199,78,121
335,哈尔滨旅游,20221201,全国,全国,209,78,131
336,哈尔滨旅游,20221202,全国,全国,230,87,143
337,哈尔滨旅游,20221203,全国,全国,227,82,145
338,哈尔滨旅游,20221204,全国,全国,219,78,141
339,哈尔滨旅游,20221205,全国,全国,335,108,227
340,哈尔滨旅游,20221206,全国,全国,319,118,201
341,哈尔滨旅游,20221207,全国,全国,333,135,198
342,哈尔滨旅游,20221208,全国,全国,405,142,263
343,哈尔滨旅游,20221209,全国,全国,328,133,195
344,哈尔滨旅游,20221210,全国,全国,292,95,197
345,哈尔滨旅游,20221211,全国,全国,287,91,196
346,哈尔滨旅游,20221212,全国,全国,333,127,206
347,哈尔滨旅游,20221213,全国,全国,313,120,193
348,哈尔滨旅游,20221214,全国,全国,294,108,186
349,哈尔滨旅游,20221215,全国,全国,314,148,166
350,哈尔滨旅游,20221216,全国,全国,259,102,157
351,哈尔滨旅游,20221217,全国,全国,241,82,159
352,哈尔滨旅游,20221218,全国,全国,253,76,177
353,哈尔滨旅游,20221219,全国,全国,288,112,176
354,哈尔滨旅游,20221220,全国,全国,256,93,163
355,哈尔滨旅游,20221221,全国,全国,311,112,199
356,哈尔滨旅游,20221222,全国,全国,288,114,174
357,哈尔滨旅游,20221223,全国,全国,330,102,228
358,哈尔滨旅游,20221224,全国,全国,270,83,187
359,哈尔滨旅游,20221225,全国,全国,348,87,261
360,哈尔滨旅游,20221226,全国,全国,399,139,260
361,哈尔滨旅游,20221227,全国,全国,429,154,275
362,哈尔滨旅游,20221228,全国,全国,409,140,269
363,哈尔滨旅游,20221229,全国,全国,429,175,254
364,哈尔滨旅游,20221230,全国,全国,378,131,247
365,哈尔滨旅游,20221231,全国,全国,359,91,268
366,哈尔滨旅游,20230101,全国,全国,355,93,262
367,哈尔滨旅游,20230102,全国,全国,390,102,288
368,哈尔滨旅游,20230103,全国,全国,460,159,301
369,哈尔滨旅游,20230104,全国,全国,473,182,291
370,哈尔滨旅游,20230105,全国,全国,524,175,349
371,哈尔滨旅游,20230106,全国,全国,517,179,338
372,哈尔滨旅游,20230107,全国,全国,482,129,353
373,哈尔滨旅游,20230108,全国,全国,491,110,381
374,哈尔滨旅游,20230109,全国,全国,556,191,365
375,哈尔滨旅游,20230110,全国,全国,510,172,338
376,哈尔滨旅游,20230111,全国,全国,573,155,418
377,哈尔滨旅游,20230112,全国,全国,561,163,398
378,哈尔滨旅游,20230113,全国,全国,703,142,561
379,哈尔滨旅游,20230114,全国,全国,638,110,528
380,哈尔滨旅游,20230115,全国,全国,782,118,664
381,哈尔滨旅游,20230116,全国,全国,654,162,492
382,哈尔滨旅游,20230117,全国,全国,769,177,592
383,哈尔滨旅游,20230118,全国,全国,992,151,841
384,哈尔滨旅游,20230119,全国,全国,601,133,468
385,哈尔滨旅游,20230120,全国,全国,559,91,468
386,哈尔滨旅游,20230121,全国,全国,360,80,280
387,哈尔滨旅游,20230122,全国,全国,1071,87,984
388,哈尔滨旅游,20230123,全国,全国,735,78,657
389,哈尔滨旅游,20230124,全国,全国,725,112,613
390,哈尔滨旅游,20230125,全国,全国,561,89,472
391,哈尔滨旅游,20230126,全国,全国,566,87,479
392,哈尔滨旅游,20230127,全国,全国,595,91,504
393,哈尔滨旅游,20230128,全国,全国,644,157,487
394,哈尔滨旅游,20230129,全国,全国,620,162,458
395,哈尔滨旅游,20230130,全国,全国,574,144,430
396,哈尔滨旅游,20230131,全国,全国,544,112,432
397,哈尔滨旅游,20230201,全国,全国,560,123,437
398,哈尔滨旅游,20230202,全国,全国,485,116,369
399,哈尔滨旅游,20230203,全国,全国,482,112,370
400,哈尔滨旅游,20230204,全国,全国,548,76,472
401,哈尔滨旅游,20230205,全国,全国,511,74,437
402,哈尔滨旅游,20230206,全国,全国,442,112,330
403,哈尔滨旅游,20230207,全国,全国,494,110,384
404,哈尔滨旅游,20230208,全国,全国,451,82,369
405,哈尔滨旅游,20230209,全国,全国,443,102,341
406,哈尔滨旅游,20230210,全国,全国,451,89,362
407,哈尔滨旅游,20230211,全国,全国,482,74,408
408,哈尔滨旅游,20230212,全国,全国,372,76,296
409,哈尔滨旅游,20230213,全国,全国,398,91,307
410,哈尔滨旅游,20230214,全国,全国,418,80,338
411,哈尔滨旅游,20230215,全国,全国,391,93,298
412,哈尔滨旅游,20230216,全国,全国,352,85,267
413,哈尔滨旅游,20230217,全国,全国,382,87,295
414,哈尔滨旅游,20230218,全国,全国,421,72,349
415,哈尔滨旅游,20230219,全国,全国,519,76,443
416,哈尔滨旅游,20230220,全国,全国,430,85,345
417,哈尔滨旅游,20230221,全国,全国,902,104,798
418,哈尔滨旅游,20230222,全国,全国,679,101,578
419,哈尔滨旅游,20230223,全国,全国,967,87,880
420,哈尔滨旅游,20230224,全国,全国,396,83,313
421,哈尔滨旅游,20230225,全国,全国,314,66,248
422,哈尔滨旅游,20230226,全国,全国,263,74,189
423,哈尔滨旅游,20230227,全国,全国,374,80,294
424,哈尔滨旅游,20230228,全国,全国,368,97,271
425,哈尔滨旅游,20230301,全国,全国,457,76,381
426,哈尔滨旅游,20230302,全国,全国,328,74,254
427,哈尔滨旅游,20230303,全国,全国,263,89,174
428,哈尔滨旅游,20230304,全国,全国,234,80,154
429,哈尔滨旅游,20230305,全国,全国,227,63,164
430,哈尔滨旅游,20230306,全国,全国,240,83,157
431,哈尔滨旅游,20230307,全国,全国,230,85,145
432,哈尔滨旅游,20230308,全国,全国,217,72,145
433,哈尔滨旅游,20230309,全国,全国,236,82,154
434,哈尔滨旅游,20230310,全国,全国,221,66,155
435,哈尔滨旅游,20230311,全国,全国,211,64,147
436,哈尔滨旅游,20230312,全国,全国,265,66,199
437,哈尔滨旅游,20230313,全国,全国,258,85,173
438,哈尔滨旅游,20230314,全国,全国,248,85,163
439,哈尔滨旅游,20230315,全国,全国,258,85,173
440,哈尔滨旅游,20230316,全国,全国,275,101,174
441,哈尔滨旅游,20230317,全国,全国,269,89,180
442,哈尔滨旅游,20230318,全国,全国,261,64,197
443,哈尔滨旅游,20230319,全国,全国,232,70,162
444,哈尔滨旅游,20230320,全国,全国,281,95,186
445,哈尔滨旅游,20230321,全国,全国,286,101,185
446,哈尔滨旅游,20230322,全国,全国,268,95,173
447,哈尔滨旅游,20230323,全国,全国,262,102,160
448,哈尔滨旅游,20230324,全国,全国,280,99,181
449,哈尔滨旅游,20230325,全国,全国,248,78,170
450,哈尔滨旅游,20230326,全国,全国,275,85,190
451,哈尔滨旅游,20230327,全国,全国,288,104,184
452,哈尔滨旅游,20230328,全国,全国,288,108,180
453,哈尔滨旅游,20230329,全国,全国,317,125,192
454,哈尔滨旅游,20230330,全国,全国,311,135,176
455,哈尔滨旅游,20230331,全国,全国,299,112,187
456,哈尔滨旅游,20230401,全国,全国,272,76,196
457,哈尔滨旅游,20230402,全国,全国,265,68,197
458,哈尔滨旅游,20230403,全国,全国,325,121,204
459,哈尔滨旅游,20230404,全国,全国,343,104,239
460,哈尔滨旅游,20230405,全国,全国,289,83,206
461,哈尔滨旅游,20230406,全国,全国,309,104,205
462,哈尔滨旅游,20230407,全国,全国,312,133,179
463,哈尔滨旅游,20230408,全国,全国,283,85,198
464,哈尔滨旅游,20230409,全国,全国,282,70,212
465,哈尔滨旅游,20230410,全国,全国,343,125,218
466,哈尔滨旅游,20230411,全国,全国,313,120,193
467,哈尔滨旅游,20230412,全国,全国,322,129,193
468,哈尔滨旅游,20230413,全国,全国,321,129,192
469,哈尔滨旅游,20230414,全国,全国,350,116,234
470,哈尔滨旅游,20230415,全国,全国,292,87,205
471,哈尔滨旅游,20230416,全国,全国,317,82,235
472,哈尔滨旅游,20230417,全国,全国,364,137,227
473,哈尔滨旅游,20230418,全国,全国,335,118,217
474,哈尔滨旅游,20230419,全国,全国,343,118,225
475,哈尔滨旅游,20230420,全国,全国,375,137,238
476,哈尔滨旅游,20230421,全国,全国,356,118,238
477,哈尔滨旅游,20230422,全国,全国,341,95,246
478,哈尔滨旅游,20230423,全国,全国,346,121,225
479,哈尔滨旅游,20230424,全国,全国,340,120,220
480,哈尔滨旅游,20230425,全国,全国,538,116,422
481,哈尔滨旅游,20230426,全国,全国,380,127,253
482,哈尔滨旅游,20230427,全国,全国,402,135,267
483,哈尔滨旅游,20230428,全国,全国,433,110,323
484,哈尔滨旅游,20230429,全国,全国,451,74,377
485,哈尔滨旅游,20230430,全国,全国,489,83,406
486,哈尔滨旅游,20230501,全国,全国,504,72,432
487,哈尔滨旅游,20230502,全国,全国,324,68,256
488,哈尔滨旅游,20230503,全国,全国,291,74,217
489,哈尔滨旅游,20230504,全国,全国,307,121,186
490,哈尔滨旅游,20230505,全国,全国,280,110,170
491,哈尔滨旅游,20230506,全国,全国,258,99,159
492,哈尔滨旅游,20230507,全国,全国,263,80,183
493,哈尔滨旅游,20230508,全国,全国,275,101,174
494,哈尔滨旅游,20230509,全国,全国,271,89,182
495,哈尔滨旅游,20230510,全国,全国,289,112,177
496,哈尔滨旅游,20230511,全国,全国,254,99,155
497,哈尔滨旅游,20230512,全国,全国,270,102,168
498,哈尔滨旅游,20230513,全国,全国,262,78,184
499,哈尔滨旅游,20230514,全国,全国,284,76,208
500,哈尔滨旅游,20230515,全国,全国,289,102,187
501,哈尔滨旅游,20230516,全国,全国,260,89,171
502,哈尔滨旅游,20230517,全国,全国,266,85,181
503,哈尔滨旅游,20230518,全国,全国,283,110,173
504,哈尔滨旅游,20230519,全国,全国,259,89,170
505,哈尔滨旅游,20230520,全国,全国,261,72,189
506,哈尔滨旅游,20230521,全国,全国,234,61,173
507,哈尔滨旅游,20230522,全国,全国,246,85,161
508,哈尔滨旅游,20230523,全国,全国,279,82,197
509,哈尔滨旅游,20230524,全国,全国,295,106,189
510,哈尔滨旅游,20230525,全国,全国,254,83,171
511,哈尔滨旅游,20230526,全国,全国,238,83,155
512,哈尔滨旅游,20230527,全国,全国,267,74,193
513,哈尔滨旅游,20230528,全国,全国,288,74,214
514,哈尔滨旅游,20230529,全国,全国,320,125,195
515,哈尔滨旅游,20230530,全国,全国,270,97,173
516,哈尔滨旅游,20230531,全国,全国,281,99,182
517,哈尔滨旅游,20230601,全国,全国,244,93,151
518,哈尔滨旅游,20230602,全国,全国,317,106,211
519,哈尔滨旅游,20230603,全国,全国,278,85,193
520,哈尔滨旅游,20230604,全国,全国,273,72,201
521,哈尔滨旅游,20230605,全国,全国,311,116,195
522,哈尔滨旅游,20230606,全国,全国,311,121,190
523,哈尔滨旅游,20230607,全国,全国,331,123,208
524,哈尔滨旅游,20230608,全国,全国,344,139,205
525,哈尔滨旅游,20230609,全国,全国,330,129,201
526,哈尔滨旅游,20230610,全国,全国,272,76,196
527,哈尔滨旅游,20230611,全国,全国,344,80,264
528,哈尔滨旅游,20230612,全国,全国,340,118,222
529,哈尔滨旅游,20230613,全国,全国,389,155,234
530,哈尔滨旅游,20230614,全国,全国,367,140,227
531,哈尔滨旅游,20230615,全国,全国,349,125,224
532,哈尔滨旅游,20230616,全国,全国,342,108,234
533,哈尔滨旅游,20230617,全国,全国,334,95,239
534,哈尔滨旅游,20230618,全国,全国,359,91,268
535,哈尔滨旅游,20230619,全国,全国,358,140,218
536,哈尔滨旅游,20230620,全国,全国,389,144,245
537,哈尔滨旅游,20230621,全国,全国,421,125,296
538,哈尔滨旅游,20230622,全国,全国,384,78,306
539,哈尔滨旅游,20230623,全国,全国,345,76,269
540,哈尔滨旅游,20230624,全国,全国,391,93,298
541,哈尔滨旅游,20230625,全国,全国,432,154,278
542,哈尔滨旅游,20230626,全国,全国,405,148,257
543,哈尔滨旅游,20230627,全国,全国,465,158,307
544,哈尔滨旅游,20230628,全国,全国,445,161,284
545,哈尔滨旅游,20230629,全国,全国,466,135,331
546,哈尔滨旅游,20230630,全国,全国,435,129,306
547,哈尔滨旅游,20230701,全国,全国,457,87,370
548,哈尔滨旅游,20230702,全国,全国,415,78,337
549,哈尔滨旅游,20230703,全国,全国,526,157,369
550,哈尔滨旅游,20230704,全国,全国,502,161,341
551,哈尔滨旅游,20230705,全国,全国,544,177,367
552,哈尔滨旅游,20230706,全国,全国,442,133,309
553,哈尔滨旅游,20230707,全国,全国,551,175,376
554,哈尔滨旅游,20230708,全国,全国,469,99,370
555,哈尔滨旅游,20230709,全国,全国,514,110,404
556,哈尔滨旅游,20230710,全国,全国,673,216,457
557,哈尔滨旅游,20230711,全国,全国,570,159,411
558,哈尔滨旅游,20230712,全国,全国,575,170,405
559,哈尔滨旅游,20230713,全国,全国,525,169,356
560,哈尔滨旅游,20230714,全国,全国,551,168,383
561,哈尔滨旅游,20230715,全国,全国,709,114,595
562,哈尔滨旅游,20230716,全国,全国,651,101,550
563,哈尔滨旅游,20230717,全国,全国,623,175,448
564,哈尔滨旅游,20230718,全国,全国,658,180,478
565,哈尔滨旅游,20230719,全国,全国,568,142,426
566,哈尔滨旅游,20230720,全国,全国,588,158,430
567,哈尔滨旅游,20230721,全国,全国,609,159,450
568,哈尔滨旅游,20230722,全国,全国,538,101,437
569,哈尔滨旅游,20230723,全国,全国,543,106,437
570,哈尔滨旅游,20230724,全国,全国,648,197,451
571,哈尔滨旅游,20230725,全国,全国,626,197,429
572,哈尔滨旅游,20230726,全国,全国,621,163,458
573,哈尔滨旅游,20230727,全国,全国,585,159,426
574,哈尔滨旅游,20230728,全国,全国,614,154,460
575,哈尔滨旅游,20230729,全国,全国,799,101,698
576,哈尔滨旅游,20230730,全国,全国,731,93,638
577,哈尔滨旅游,20230731,全国,全国,853,157,696
578,哈尔滨旅游,20230801,全国,全国,674,162,512
579,哈尔滨旅游,20230802,全国,全国,511,159,352
580,哈尔滨旅游,20230803,全国,全国,743,179,564
581,哈尔滨旅游,20230804,全国,全国,835,146,689
582,哈尔滨旅游,20230805,全国,全国,572,82,490
583,哈尔滨旅游,20230806,全国,全国,544,76,468
584,哈尔滨旅游,20230807,全国,全国,606,133,473
585,哈尔滨旅游,20230808,全国,全国,602,123,479
586,哈尔滨旅游,20230809,全国,全国,589,121,468
587,哈尔滨旅游,20230810,全国,全国,627,106,521
588,哈尔滨旅游,20230811,全国,全国,541,127,414
589,哈尔滨旅游,20230812,全国,全国,475,91,384
590,哈尔滨旅游,20230813,全国,全国,515,85,430
591,哈尔滨旅游,20230814,全国,全国,629,157,472
592,哈尔滨旅游,20230815,全国,全国,546,139,407
593,哈尔滨旅游,20230816,全国,全国,519,131,388
594,哈尔滨旅游,20230817,全国,全国,607,131,476
595,哈尔滨旅游,20230818,全国,全国,574,131,443
596,哈尔滨旅游,20230819,全国,全国,405,82,323
597,哈尔滨旅游,20230820,全国,全国,445,83,362
598,哈尔滨旅游,20230821,全国,全国,479,123,356
599,哈尔滨旅游,20230822,全国,全国,437,114,323
600,哈尔滨旅游,20230823,全国,全国,465,116,349
601,哈尔滨旅游,20230824,全国,全国,412,116,296
602,哈尔滨旅游,20230825,全国,全国,428,120,308
603,哈尔滨旅游,20230826,全国,全国,458,74,384
604,哈尔滨旅游,20230827,全国,全国,423,83,340
605,哈尔滨旅游,20230828,全国,全国,496,127,369
606,哈尔滨旅游,20230829,全国,全国,952,110,842
607,哈尔滨旅游,20230830,全国,全国,428,114,314
608,哈尔滨旅游,20230831,全国,全国,548,114,434
609,哈尔滨旅游,20230901,全国,全国,406,101,305
610,哈尔滨旅游,20230902,全国,全国,295,74,221
611,哈尔滨旅游,20230903,全国,全国,294,80,214
612,哈尔滨旅游,20230904,全国,全国,359,137,222
613,哈尔滨旅游,20230905,全国,全国,376,121,255
614,哈尔滨旅游,20230906,全国,全国,312,104,208
615,哈尔滨旅游,20230907,全国,全国,304,133,171
616,哈尔滨旅游,20230908,全国,全国,320,120,200
617,哈尔滨旅游,20230909,全国,全国,336,87,249
618,哈尔滨旅游,20230910,全国,全国,288,85,203
619,哈尔滨旅游,20230911,全国,全国,357,139,218
620,哈尔滨旅游,20230912,全国,全国,356,142,214
621,哈尔滨旅游,20230913,全国,全国,348,137,211
622,哈尔滨旅游,20230914,全国,全国,394,169,225
623,哈尔滨旅游,20230915,全国,全国,362,127,235
624,哈尔滨旅游,20230916,全国,全国,292,93,199
625,哈尔滨旅游,20230917,全国,全国,348,89,259
626,哈尔滨旅游,20230918,全国,全国,383,159,224
627,哈尔滨旅游,20230919,全国,全国,375,144,231
628,哈尔滨旅游,20230920,全国,全国,333,121,212
629,哈尔滨旅游,20230921,全国,全国,397,137,260
630,哈尔滨旅游,20230922,全国,全国,350,123,227
631,哈尔滨旅游,20230923,全国,全国,324,76,248
632,哈尔滨旅游,20230924,全国,全国,307,80,227
633,哈尔滨旅游,20230925,全国,全国,362,162,200
634,哈尔滨旅游,20230926,全国,全国,358,152,206
635,哈尔滨旅游,20230927,全国,全国,407,161,246
636,哈尔滨旅游,20230928,全国,全国,427,173,254
637,哈尔滨旅游,20230929,全国,全国,365,76,289
638,哈尔滨旅游,20230930,全国,全国,456,93,363
639,哈尔滨旅游,20231001,全国,全国,455,89,366
640,哈尔滨旅游,20231002,全国,全国,436,70,366
641,哈尔滨旅游,20231003,全国,全国,383,82,301
642,哈尔滨旅游,20231004,全国,全国,346,80,266
643,哈尔滨旅游,20231005,全国,全国,308,76,232
644,哈尔滨旅游,20231006,全国,全国,313,93,220
645,哈尔滨旅游,20231007,全国,全国,393,173,220
646,哈尔滨旅游,20231008,全国,全国,407,180,227
647,哈尔滨旅游,20231009,全国,全国,386,175,211
648,哈尔滨旅游,20231010,全国,全国,347,139,208
649,哈尔滨旅游,20231011,全国,全国,343,137,206
650,哈尔滨旅游,20231012,全国,全国,720,146,574
651,哈尔滨旅游,20231013,全国,全国,460,159,301
652,哈尔滨旅游,20231014,全国,全国,388,93,295
653,哈尔滨旅游,20231015,全国,全国,369,82,287
654,哈尔滨旅游,20231016,全国,全国,470,209,261
655,哈尔滨旅游,20231017,全国,全国,492,166,326
656,哈尔滨旅游,20231018,全国,全国,520,180,340
657,哈尔滨旅游,20231019,全国,全国,504,183,321
658,哈尔滨旅游,20231020,全国,全国,394,175,219
659,哈尔滨旅游,20231021,全国,全国,340,102,238
660,哈尔滨旅游,20231022,全国,全国,311,87,224
661,哈尔滨旅游,20231023,全国,全国,394,180,214
662,哈尔滨旅游,20231024,全国,全国,451,166,285
663,哈尔滨旅游,20231025,全国,全国,456,187,269
664,哈尔滨旅游,20231026,全国,全国,478,168,310
665,哈尔滨旅游,20231027,全国,全国,500,183,317
666,哈尔滨旅游,20231028,全国,全国,505,104,401
667,哈尔滨旅游,20231029,全国,全国,423,106,317
668,哈尔滨旅游,20231030,全国,全国,545,183,362
669,哈尔滨旅游,20231031,全国,全国,576,204,372
670,哈尔滨旅游,20231101,全国,全国,538,158,380
671,哈尔滨旅游,20231102,全国,全国,574,194,380
672,哈尔滨旅游,20231103,全国,全国,575,176,399
673,哈尔滨旅游,20231104,全国,全国,414,102,312
674,哈尔滨旅游,20231105,全国,全国,469,114,355
675,哈尔滨旅游,20231106,全国,全国,682,243,439
676,哈尔滨旅游,20231107,全国,全国,624,229,395
677,哈尔滨旅游,20231108,全国,全国,742,234,508
678,哈尔滨旅游,20231109,全国,全国,755,212,543
679,哈尔滨旅游,20231110,全国,全国,873,207,666
680,哈尔滨旅游,20231111,全国,全国,580,108,472
681,哈尔滨旅游,20231112,全国,全国,682,131,551
682,哈尔滨旅游,20231113,全国,全国,871,346,525
683,哈尔滨旅游,20231114,全国,全国,863,273,590
684,哈尔滨旅游,20231115,全国,全国,726,234,492
685,哈尔滨旅游,20231116,全国,全国,733,211,522
686,哈尔滨旅游,20231117,全国,全国,910,166,744
687,哈尔滨旅游,20231118,全国,全国,710,97,613
688,哈尔滨旅游,20231119,全国,全国,677,106,571
689,哈尔滨旅游,20231120,全国,全国,867,240,627
690,哈尔滨旅游,20231121,全国,全国,846,216,630
691,哈尔滨旅游,20231122,全国,全国,842,247,595
692,哈尔滨旅游,20231123,全国,全国,710,223,487
693,哈尔滨旅游,20231124,全国,全国,827,207,620
694,哈尔滨旅游,20231125,全国,全国,705,110,595
695,哈尔滨旅游,20231126,全国,全国,822,99,723
696,哈尔滨旅游,20231127,全国,全国,884,245,639
697,哈尔滨旅游,20231128,全国,全国,728,209,519
698,哈尔滨旅游,20231129,全国,全国,892,225,667
699,哈尔滨旅游,20231130,全国,全国,1083,234,849
700,哈尔滨旅游,20231201,全国,全国,852,172,680
701,哈尔滨旅游,20231202,全国,全国,853,108,745
702,哈尔滨旅游,20231203,全国,全国,848,114,734
703,哈尔滨旅游,20231204,全国,全国,953,245,708
704,哈尔滨旅游,20231205,全国,全国,956,229,727
705,哈尔滨旅游,20231206,全国,全国,883,226,657
706,哈尔滨旅游,20231207,全国,全国,959,211,748
707,哈尔滨旅游,20231208,全国,全国,780,163,617
708,哈尔滨旅游,20231209,全国,全国,896,106,790
709,哈尔滨旅游,20231210,全国,全国,778,108,670
710,哈尔滨旅游,20231211,全国,全国,769,223,546
711,哈尔滨旅游,20231212,全国,全国,724,233,491
712,哈尔滨旅游,20231213,全国,全国,837,212,625
713,哈尔滨旅游,20231214,全国,全国,1060,239,821
714,哈尔滨旅游,20231215,全国,全国,7887,198,7689
715,哈尔滨旅游,20231216,全国,全国,1069,102,967
716,哈尔滨旅游,20231217,全国,全国,772,120,652
717,哈尔滨旅游,20231218,全国,全国,814,216,598
718,哈尔滨旅游,20231219,全国,全国,735,213,522
719,哈尔滨旅游,20231220,全国,全国,744,215,529
720,哈尔滨旅游,20231221,全国,全国,890,180,710
721,哈尔滨旅游,20231222,全国,全国,731,161,570
722,哈尔滨旅游,20231223,全国,全国,738,106,632
723,哈尔滨旅游,20231224,全国,全国,695,121,574
724,哈尔滨旅游,20231225,全国,全国,1070,251,819
725,哈尔滨旅游,20231226,全国,全国,946,257,689
726,哈尔滨旅游,20231227,全国,全国,1086,228,858
727,哈尔滨旅游,20231228,全国,全国,1022,218,804
728,哈尔滨旅游,20231229,全国,全国,943,180,763
729,哈尔滨旅游,20231230,全国,全国,911,184,727
730,哈尔滨旅游,20231231,全国,全国,998,148,850
731,哈尔滨旅游,20240101,全国,全国,1069,175,894
732,哈尔滨旅游,20240102,全国,全国,1696,806,890
733,哈尔滨旅游,20240103,全国,全国,1788,846,942
734,哈尔滨旅游,20240104,全国,全国,2282,860,1422
735,哈尔滨旅游,20240105,全国,全国,1990,774,1216
736,哈尔滨旅游,20240106,全国,全国,1521,377,1144
737,哈尔滨旅游,20240107,全国,全国,2017,408,1609
738,哈尔滨旅游,20240108,全国,全国,2301,735,1566
739,哈尔滨旅游,20240109,全国,全国,5600,628,4972
740,哈尔滨旅游,20240110,全国,全国,1796,537,1259
741,哈尔滨旅游,20240111,全国,全国,1599,523,1076
742,哈尔滨旅游,20240112,全国,全国,2033,425,1608
743,哈尔滨旅游,20240113,全国,全国,1589,250,1339
744,哈尔滨旅游,20240114,全国,全国,2015,260,1755
745,哈尔滨旅游,20240115,全国,全国,1739,439,1300
746,哈尔滨旅游,20240116,全国,全国,4328,430,3898
747,哈尔滨旅游,20240117,全国,全国,3744,402,3342
748,哈尔滨旅游,20240118,全国,全国,3235,287,2948
749,哈尔滨旅游,20240119,全国,全国,2879,330,2549
750,哈尔滨旅游,20240120,全国,全国,1628,188,1440
751,哈尔滨旅游,20240121,全国,全国,2117,228,1889
752,哈尔滨旅游,20240122,全国,全国,1999,318,1681
753,哈尔滨旅游,20240123,全国,全国,3233,330,2903
754,哈尔滨旅游,20240124,全国,全国,3939,279,3660
755,哈尔滨旅游,20240125,全国,全国,6261,213,6048
756,哈尔滨旅游,20240126,全国,全国,6288,208,6080
757,哈尔滨旅游,20240127,全国,全国,4100,169,3931
758,哈尔滨旅游,20240128,全国,全国,3448,168,3280
759,哈尔滨旅游,20240129,全国,全国,5510,288,5222
760,哈尔滨旅游,20240130,全国,全国,10508,237,10271
761,哈尔滨旅游,20240131,全国,全国,10790,281,10509
762,哈尔滨旅游,20240201,全国,全国,10885,212,10673
763,哈尔滨旅游,20240202,全国,全国,15226,301,14925
764,哈尔滨旅游,20240203,全国,全国,16510,168,16342
765,哈尔滨旅游,20240204,全国,全国,18819,364,18455
766,哈尔滨旅游,20240205,全国,全国,18387,225,18162
767,哈尔滨旅游,20240206,全国,全国,15836,169,15667
768,哈尔滨旅游,20240207,全国,全国,15827,144,15683
769,哈尔滨旅游,20240208,全国,全国,13612,148,13464
770,哈尔滨旅游,20240209,全国,全国,12813,110,12703
771,哈尔滨旅游,20240210,全国,全国,11200,85,11115
772,哈尔滨旅游,20240211,全国,全国,12552,102,12450
773,哈尔滨旅游,20240212,全国,全国,13834,123,13711
774,哈尔滨旅游,20240213,全国,全国,14821,133,14688
775,哈尔滨旅游,20240214,全国,全国,15336,93,15243
776,哈尔滨旅游,20240215,全国,全国,12299,112,12187
777,哈尔滨旅游,20240216,全国,全国,15472,140,15332
778,哈尔滨旅游,20240217,全国,全国,12518,157,12361
779,哈尔滨旅游,20240218,全国,全国,13038,231,12807
780,哈尔滨旅游,20240219,全国,全国,10905,256,10649
781,哈尔滨旅游,20240220,全国,全国,12758,231,12527
782,哈尔滨旅游,20240221,全国,全国,10762,175,10587
783,哈尔滨旅游,20240222,全国,全国,11286,195,11091
784,哈尔滨旅游,20240223,全国,全国,10271,182,10089
785,哈尔滨旅游,20240224,全国,全国,7887,120,7767
786,哈尔滨旅游,20240225,全国,全国,3808,159,3649
787,哈尔滨旅游,20240226,全国,全国,3340,190,3150
788,哈尔滨旅游,20240227,全国,全国,2739,184,2555
789,哈尔滨旅游,20240228,全国,全国,2579,190,2389
790,哈尔滨旅游,20240229,全国,全国,2380,165,2215
791,哈尔滨旅游,20240301,全国,全国,2703,151,2552
792,哈尔滨旅游,20240302,全国,全国,3523,110,3413
793,哈尔滨旅游,20240303,全国,全国,3661,118,3543
794,哈尔滨旅游,20240304,全国,全国,2300,150,2150
795,哈尔滨旅游,20240305,全国,全国,2010,131,1879
796,哈尔滨旅游,20240306,全国,全国,2848,176,2672
797,哈尔滨旅游,20240307,全国,全国,2964,144,2820
798,哈尔滨旅游,20240308,全国,全国,8394,125,8269
799,哈尔滨旅游,20240309,全国,全国,5411,99,5312
800,哈尔滨旅游,20240310,全国,全国,5451,97,5354
801,哈尔滨旅游,20240311,全国,全国,5771,163,5608
802,哈尔滨旅游,20240312,全国,全国,5470,120,5350
803,哈尔滨旅游,20240313,全国,全国,5460,139,5321
804,哈尔滨旅游,20240314,全国,全国,4121,139,3982
805,哈尔滨旅游,20240315,全国,全国,6609,135,6474
806,哈尔滨旅游,20240316,全国,全国,2622,87,2535
807,哈尔滨旅游,20240317,全国,全国,1971,106,1865
808,哈尔滨旅游,20240318,全国,全国,2113,129,1984
809,哈尔滨旅游,20240319,全国,全国,1422,152,1270
810,哈尔滨旅游,20240320,全国,全国,1254,139,1115
811,哈尔滨旅游,20240321,全国,全国,1248,133,1115
812,哈尔滨旅游,20240322,全国,全国,5322,155,5167
813,哈尔滨旅游,20240323,全国,全国,4457,85,4372
814,哈尔滨旅游,20240324,全国,全国,4703,106,4597
815,哈尔滨旅游,20240325,全国,全国,4133,137,3996
816,哈尔滨旅游,20240326,全国,全国,4361,146,4215
817,哈尔滨旅游,20240327,全国,全国,4309,139,4170
818,哈尔滨旅游,20240328,全国,全国,4044,142,3902
819,哈尔滨旅游,20240329,全国,全国,2826,104,2722
820,哈尔滨旅游,20240330,全国,全国,5000,76,4924
821,哈尔滨旅游,20240331,全国,全国,3510,106,3404
822,哈尔滨旅游,20240401,全国,全国,2050,161,1889
823,哈尔滨旅游,20240402,全国,全国,1224,131,1093
824,哈尔滨旅游,20240403,全国,全国,2778,146,2632
825,哈尔滨旅游,20240404,全国,全国,3308,78,3230
826,哈尔滨旅游,20240405,全国,全国,1730,91,1639
827,哈尔滨旅游,20240406,全国,全国,1086,97,989
828,哈尔滨旅游,20240407,全国,全国,1538,162,1376
829,哈尔滨旅游,20240408,全国,全国,1067,150,917
830,哈尔滨旅游,20240409,全国,全国,1098,137,961
831,哈尔滨旅游,20240410,全国,全国,1106,131,975
832,哈尔滨旅游,20240411,全国,全国,1059,144,915
833,哈尔滨旅游,20240412,全国,全国,2653,123,2530
834,哈尔滨旅游,20240413,全国,全国,1085,97,988
835,哈尔滨旅游,20240414,全国,全国,934,85,849
836,哈尔滨旅游,20240415,全国,全国,1048,169,879
837,哈尔滨旅游,20240416,全国,全国,1016,154,862
838,哈尔滨旅游,20240417,全国,全国,958,140,818
839,哈尔滨旅游,20240418,全国,全国,986,135,851
840,哈尔滨旅游,20240419,全国,全国,983,116,867
841,哈尔滨旅游,20240420,全国,全国,934,76,858
842,哈尔滨旅游,20240421,全国,全国,1045,97,948
843,哈尔滨旅游,20240422,全国,全国,890,127,763
844,哈尔滨旅游,20240423,全国,全国,974,123,851
845,哈尔滨旅游,20240424,全国,全国,1048,146,902
846,哈尔滨旅游,20240425,全国,全国,1068,142,926
847,哈尔滨旅游,20240426,全国,全国,920,140,780
848,哈尔滨旅游,20240427,全国,全国,1093,89,1004
849,哈尔滨旅游,20240428,全国,全国,1453,172,1281
850,哈尔滨旅游,20240429,全国,全国,1049,186,863
851,哈尔滨旅游,20240430,全国,全国,1067,182,885
1,龙塔,20220101,全国,全国,154,0,154
2,龙塔,20220102,全国,全国,226,72,154
3,龙塔,20220103,全国,全国,246,66,180
4,龙塔,20220104,全国,全国,224,80,144
5,龙塔,20220105,全国,全国,219,74,145
6,龙塔,20220106,全国,全国,218,70,148
7,龙塔,20220107,全国,全国,208,76,132
8,龙塔,20220108,全国,全国,210,59,151
9,龙塔,20220109,全国,全国,213,64,149
10,龙塔,20220110,全国,全国,208,74,134
11,龙塔,20220111,全国,全国,198,66,132
12,龙塔,20220112,全国,全国,204,66,138
13,龙塔,20220113,全国,全国,222,68,154
14,龙塔,20220114,全国,全国,202,76,126
15,龙塔,20220115,全国,全国,186,68,118
16,龙塔,20220116,全国,全国,211,59,152
17,龙塔,20220117,全国,全国,216,59,157
18,龙塔,20220118,全国,全国,215,70,145
19,龙塔,20220119,全国,全国,237,80,157
20,龙塔,20220120,全国,全国,217,70,147
21,龙塔,20220121,全国,全国,214,70,144
22,龙塔,20220122,全国,全国,224,66,158
23,龙塔,20220123,全国,全国,210,76,134
24,龙塔,20220124,全国,全国,204,66,138
25,龙塔,20220125,全国,全国,246,85,161
26,龙塔,20220126,全国,全国,257,87,170
27,龙塔,20220127,全国,全国,297,131,166
28,龙塔,20220128,全国,全国,283,118,165
29,龙塔,20220129,全国,全国,265,104,161
30,龙塔,20220130,全国,全国,284,127,157
31,龙塔,20220131,全国,全国,260,116,144
32,龙塔,20220201,全国,全国,289,108,181
33,龙塔,20220202,全国,全国,279,116,163
34,龙塔,20220203,全国,全国,251,93,158
35,龙塔,20220204,全国,全国,327,118,209
36,龙塔,20220205,全国,全国,307,131,176
37,龙塔,20220206,全国,全国,301,131,170
38,龙塔,20220207,全国,全国,280,121,159
39,龙塔,20220208,全国,全国,304,139,165
40,龙塔,20220209,全国,全国,303,133,170
41,龙塔,20220210,全国,全国,287,139,148
42,龙塔,20220211,全国,全国,326,150,176
43,龙塔,20220212,全国,全国,318,139,179
44,龙塔,20220213,全国,全国,344,148,196
45,龙塔,20220214,全国,全国,338,155,183
46,龙塔,20220215,全国,全国,321,144,177
47,龙塔,20220216,全国,全国,306,152,154
48,龙塔,20220217,全国,全国,317,154,163
49,龙塔,20220218,全国,全国,364,180,184
50,龙塔,20220219,全国,全国,337,157,180
51,龙塔,20220220,全国,全国,340,154,186
52,龙塔,20220221,全国,全国,336,163,173
53,龙塔,20220222,全国,全国,381,184,197
54,龙塔,20220223,全国,全国,280,101,179
55,龙塔,20220224,全国,全国,309,116,193
56,龙塔,20220225,全国,全国,304,104,200
57,龙塔,20220226,全国,全国,292,89,203
58,龙塔,20220227,全国,全国,303,97,206
59,龙塔,20220228,全国,全国,309,106,203
60,龙塔,20220301,全国,全国,358,99,259
61,龙塔,20220302,全国,全国,318,110,208
62,龙塔,20220303,全国,全国,292,91,201
63,龙塔,20220304,全国,全国,280,102,178
64,龙塔,20220305,全国,全国,294,93,201
65,龙塔,20220306,全国,全国,286,99,187
66,龙塔,20220307,全国,全国,298,137,161
67,龙塔,20220308,全国,全国,307,104,203
68,龙塔,20220309,全国,全国,289,127,162
69,龙塔,20220310,全国,全国,299,125,174
70,龙塔,20220311,全国,全国,278,116,162
71,龙塔,20220312,全国,全国,282,120,162
72,龙塔,20220313,全国,全国,296,123,173
73,龙塔,20220314,全国,全国,329,152,177
74,龙塔,20220315,全国,全国,275,110,165
75,龙塔,20220316,全国,全国,261,106,155
76,龙塔,20220317,全国,全国,271,101,170
77,龙塔,20220318,全国,全国,286,129,157
78,龙塔,20220319,全国,全国,258,99,159
79,龙塔,20220320,全国,全国,283,102,181
80,龙塔,20220321,全国,全国,290,106,184
81,龙塔,20220322,全国,全国,327,146,181
82,龙塔,20220323,全国,全国,292,110,182
83,龙塔,20220324,全国,全国,303,114,189
84,龙塔,20220325,全国,全国,301,131,170
85,龙塔,20220326,全国,全国,308,123,185
86,龙塔,20220327,全国,全国,307,125,182
87,龙塔,20220328,全国,全国,321,148,173
88,龙塔,20220329,全国,全国,318,142,176
89,龙塔,20220330,全国,全国,306,139,167
90,龙塔,20220331,全国,全国,278,123,155
91,龙塔,20220401,全国,全国,325,152,173
92,龙塔,20220402,全国,全国,272,121,151
93,龙塔,20220403,全国,全国,310,121,189
94,龙塔,20220404,全国,全国,313,127,186
95,龙塔,20220405,全国,全国,296,120,176
96,龙塔,20220406,全国,全国,305,131,174
97,龙塔,20220407,全国,全国,304,139,165
98,龙塔,20220408,全国,全国,313,148,165
99,龙塔,20220409,全国,全国,263,80,183
100,龙塔,20220410,全国,全国,249,85,164
101,龙塔,20220411,全国,全国,261,97,164
102,龙塔,20220412,全国,全国,277,120,157
103,龙塔,20220413,全国,全国,297,137,160
104,龙塔,20220414,全国,全国,290,125,165
105,龙塔,20220415,全国,全国,307,140,167
106,龙塔,20220416,全国,全国,309,127,182
107,龙塔,20220417,全国,全国,270,110,160
108,龙塔,20220418,全国,全国,310,139,171
109,龙塔,20220419,全国,全国,265,127,138
110,龙塔,20220420,全国,全国,239,104,135
111,龙塔,20220421,全国,全国,262,101,161
112,龙塔,20220422,全国,全国,292,125,167
113,龙塔,20220423,全国,全国,259,97,162
114,龙塔,20220424,全国,全国,262,131,131
115,龙塔,20220425,全国,全国,311,140,171
116,龙塔,20220426,全国,全国,306,139,167
117,龙塔,20220427,全国,全国,258,110,148
118,龙塔,20220428,全国,全国,291,118,173
119,龙塔,20220429,全国,全国,310,150,160
120,龙塔,20220430,全国,全国,262,104,158
121,龙塔,20220501,全国,全国,285,112,173
122,龙塔,20220502,全国,全国,291,127,164
123,龙塔,20220503,全国,全国,294,116,178
124,龙塔,20220504,全国,全国,304,125,179
125,龙塔,20220505,全国,全国,281,118,163
126,龙塔,20220506,全国,全国,276,116,160
127,龙塔,20220507,全国,全国,316,120,196
128,龙塔,20220508,全国,全国,298,106,192
129,龙塔,20220509,全国,全国,299,121,178
130,龙塔,20220510,全国,全国,265,120,145
131,龙塔,20220511,全国,全国,314,131,183
132,龙塔,20220512,全国,全国,295,110,185
133,龙塔,20220513,全国,全国,272,121,151
134,龙塔,20220514,全国,全国,303,110,193
135,龙塔,20220515,全国,全国,286,120,166
136,龙塔,20220516,全国,全国,270,106,164
137,龙塔,20220517,全国,全国,327,142,185
138,龙塔,20220518,全国,全国,315,118,197
139,龙塔,20220519,全国,全国,293,112,181
140,龙塔,20220520,全国,全国,313,116,197
141,龙塔,20220521,全国,全国,311,99,212
142,龙塔,20220522,全国,全国,390,112,278
143,龙塔,20220523,全国,全国,297,114,183
144,龙塔,20220524,全国,全国,277,97,180
145,龙塔,20220525,全国,全国,278,104,174
146,龙塔,20220526,全国,全国,292,112,180
147,龙塔,20220527,全国,全国,335,127,208
148,龙塔,20220528,全国,全国,315,112,203
149,龙塔,20220529,全国,全国,309,78,231
150,龙塔,20220530,全国,全国,275,108,167
151,龙塔,20220531,全国,全国,326,123,203
152,龙塔,20220601,全国,全国,284,97,187
153,龙塔,20220602,全国,全国,327,118,209
154,龙塔,20220603,全国,全国,348,110,238
155,龙塔,20220604,全国,全国,320,99,221
156,龙塔,20220605,全国,全国,309,110,199
157,龙塔,20220606,全国,全国,294,101,193
158,龙塔,20220607,全国,全国,282,101,181
159,龙塔,20220608,全国,全国,336,135,201
160,龙塔,20220609,全国,全国,313,133,180
161,龙塔,20220610,全国,全国,291,121,170
162,龙塔,20220611,全国,全国,311,116,195
163,龙塔,20220612,全国,全国,328,106,222
164,龙塔,20220613,全国,全国,303,114,189
165,龙塔,20220614,全国,全国,322,114,208
166,龙塔,20220615,全国,全国,264,85,179
167,龙塔,20220616,全国,全国,303,104,199
168,龙塔,20220617,全国,全国,301,114,187
169,龙塔,20220618,全国,全国,265,66,199
170,龙塔,20220619,全国,全国,254,59,195
171,龙塔,20220620,全国,全国,242,72,170
172,龙塔,20220621,全国,全国,294,82,212
173,龙塔,20220622,全国,全国,256,72,184
174,龙塔,20220623,全国,全国,261,72,189
175,龙塔,20220624,全国,全国,253,68,185
176,龙塔,20220625,全国,全国,308,72,236
177,龙塔,20220626,全国,全国,275,64,211
178,龙塔,20220627,全国,全国,252,68,184
179,龙塔,20220628,全国,全国,278,78,200
180,龙塔,20220629,全国,全国,296,74,222
181,龙塔,20220630,全国,全国,292,70,222
182,龙塔,20220701,全国,全国,290,72,218
183,龙塔,20220702,全国,全国,253,66,187
184,龙塔,20220703,全国,全国,261,72,189
185,龙塔,20220704,全国,全国,276,72,204
186,龙塔,20220705,全国,全国,256,70,186
187,龙塔,20220706,全国,全国,255,72,183
188,龙塔,20220707,全国,全国,289,74,215
189,龙塔,20220708,全国,全国,272,72,200
190,龙塔,20220709,全国,全国,313,61,252
191,龙塔,20220710,全国,全国,301,66,235
192,龙塔,20220711,全国,全国,273,61,212
193,龙塔,20220712,全国,全国,322,74,248
194,龙塔,20220713,全国,全国,304,72,232
195,龙塔,20220714,全国,全国,347,72,275
196,龙塔,20220715,全国,全国,301,70,231
197,龙塔,20220716,全国,全国,348,63,285
198,龙塔,20220717,全国,全国,365,64,301
199,龙塔,20220718,全国,全国,295,70,225
200,龙塔,20220719,全国,全国,313,70,243
201,龙塔,20220720,全国,全国,312,66,246
202,龙塔,20220721,全国,全国,340,76,264
203,龙塔,20220722,全国,全国,363,78,285
204,龙塔,20220723,全国,全国,350,66,284
205,龙塔,20220724,全国,全国,397,74,323
206,龙塔,20220725,全国,全国,363,72,291
207,龙塔,20220726,全国,全国,311,72,239
208,龙塔,20220727,全国,全国,366,72,294
209,龙塔,20220728,全国,全国,374,82,292
210,龙塔,20220729,全国,全国,339,72,267
211,龙塔,20220730,全国,全国,419,82,337
212,龙塔,20220731,全国,全国,383,66,317
213,龙塔,20220801,全国,全国,379,70,309
214,龙塔,20220802,全国,全国,393,78,315
215,龙塔,20220803,全国,全国,367,83,284
216,龙塔,20220804,全国,全国,376,61,315
217,龙塔,20220805,全国,全国,402,74,328
218,龙塔,20220806,全国,全国,429,64,365
219,龙塔,20220807,全国,全国,387,72,315
220,龙塔,20220808,全国,全国,393,80,313
221,龙塔,20220809,全国,全国,376,87,289
222,龙塔,20220810,全国,全国,339,76,263
223,龙塔,20220811,全国,全国,341,70,271
224,龙塔,20220812,全国,全国,316,82,234
225,龙塔,20220813,全国,全国,385,68,317
226,龙塔,20220814,全国,全国,364,70,294
227,龙塔,20220815,全国,全国,340,76,264
228,龙塔,20220816,全国,全国,343,72,271
229,龙塔,20220817,全国,全国,346,72,274
230,龙塔,20220818,全国,全国,322,68,254
231,龙塔,20220819,全国,全国,340,83,257
232,龙塔,20220820,全国,全国,347,70,277
233,龙塔,20220821,全国,全国,318,61,257
234,龙塔,20220822,全国,全国,323,70,253
235,龙塔,20220823,全国,全国,328,83,245
236,龙塔,20220824,全国,全国,334,70,264
237,龙塔,20220825,全国,全国,295,64,231
238,龙塔,20220826,全国,全国,318,70,248
239,龙塔,20220827,全国,全国,308,61,247
240,龙塔,20220828,全国,全国,274,66,208
241,龙塔,20220829,全国,全国,261,72,189
242,龙塔,20220830,全国,全国,228,76,152
243,龙塔,20220831,全国,全国,216,61,155
244,龙塔,20220901,全国,全国,267,74,193
245,龙塔,20220902,全国,全国,248,64,184
246,龙塔,20220903,全国,全国,225,61,164
247,龙塔,20220904,全国,全国,250,72,178
248,龙塔,20220905,全国,全国,240,59,181
249,龙塔,20220906,全国,全国,264,74,190
250,龙塔,20220907,全国,全国,252,63,189
251,龙塔,20220908,全国,全国,280,91,189
252,龙塔,20220909,全国,全国,309,95,214
253,龙塔,20220910,全国,全国,307,85,222
254,龙塔,20220911,全国,全国,290,76,214
255,龙塔,20220912,全国,全国,277,82,195
256,龙塔,20220913,全国,全国,249,97,152
257,龙塔,20220914,全国,全国,235,76,159
258,龙塔,20220915,全国,全国,263,82,181
259,龙塔,20220916,全国,全国,235,78,157
260,龙塔,20220917,全国,全国,261,68,193
261,龙塔,20220918,全国,全国,276,74,202
262,龙塔,20220919,全国,全国,224,76,148
263,龙塔,20220920,全国,全国,277,87,190
264,龙塔,20220921,全国,全国,242,82,160
265,龙塔,20220922,全国,全国,234,68,166
266,龙塔,20220923,全国,全国,246,76,170
267,龙塔,20220924,全国,全国,246,72,174
268,龙塔,20220925,全国,全国,261,83,178
269,龙塔,20220926,全国,全国,212,68,144
270,龙塔,20220927,全国,全国,244,78,166
271,龙塔,20220928,全国,全国,219,64,155
272,龙塔,20220929,全国,全国,235,68,167
273,龙塔,20220930,全国,全国,244,78,166
274,龙塔,20221001,全国,全国,201,0,201
275,龙塔,20221002,全国,全国,240,59,181
276,龙塔,20221003,全国,全国,248,64,184
277,龙塔,20221004,全国,全国,246,64,182
278,龙塔,20221005,全国,全国,229,59,170
279,龙塔,20221006,全国,全国,255,68,187
280,龙塔,20221007,全国,全国,245,74,171
281,龙塔,20221008,全国,全国,240,72,168
282,龙塔,20221009,全国,全国,251,78,173
283,龙塔,20221010,全国,全国,295,99,196
284,龙塔,20221011,全国,全国,415,85,330
285,龙塔,20221012,全国,全国,350,93,257
286,龙塔,20221013,全国,全国,242,76,166
287,龙塔,20221014,全国,全国,257,83,174
288,龙塔,20221015,全国,全国,237,74,163
289,龙塔,20221016,全国,全国,235,78,157
290,龙塔,20221017,全国,全国,250,85,165
291,龙塔,20221018,全国,全国,247,93,154
292,龙塔,20221019,全国,全国,239,85,154
293,龙塔,20221020,全国,全国,240,89,151
294,龙塔,20221021,全国,全国,227,68,159
295,龙塔,20221022,全国,全国,283,66,217
296,龙塔,20221023,全国,全国,231,0,231
297,龙塔,20221024,全国,全国,235,74,161
298,龙塔,20221025,全国,全国,264,74,190
299,龙塔,20221026,全国,全国,270,80,190
300,龙塔,20221027,全国,全国,224,64,160
301,龙塔,20221028,全国,全国,246,78,168
302,龙塔,20221029,全国,全国,212,0,212
303,龙塔,20221030,全国,全国,167,0,167
304,龙塔,20221031,全国,全国,230,64,166
305,龙塔,20221101,全国,全国,220,72,148
306,龙塔,20221102,全国,全国,288,76,212
307,龙塔,20221103,全国,全国,223,61,162
308,龙塔,20221104,全国,全国,235,80,155
309,龙塔,20221105,全国,全国,248,61,187
310,龙塔,20221106,全国,全国,212,61,151
311,龙塔,20221107,全国,全国,231,76,155
312,龙塔,20221108,全国,全国,202,64,138
313,龙塔,20221109,全国,全国,231,70,161
314,龙塔,20221110,全国,全国,237,72,165
315,龙塔,20221111,全国,全国,237,72,165
316,龙塔,20221112,全国,全国,220,59,161
317,龙塔,20221113,全国,全国,230,68,162
318,龙塔,20221114,全国,全国,220,72,148
319,龙塔,20221115,全国,全国,209,68,141
320,龙塔,20221116,全国,全国,189,61,128
321,龙塔,20221117,全国,全国,244,70,174
322,龙塔,20221118,全国,全国,223,72,151
323,龙塔,20221119,全国,全国,212,61,151
324,龙塔,20221120,全国,全国,214,63,151
325,龙塔,20221121,全国,全国,235,74,161
326,龙塔,20221122,全国,全国,223,68,155
327,龙塔,20221123,全国,全国,203,68,135
328,龙塔,20221124,全国,全国,241,68,173
329,龙塔,20221125,全国,全国,192,66,126
330,龙塔,20221126,全国,全国,199,61,138
331,龙塔,20221127,全国,全国,198,64,134
332,龙塔,20221128,全国,全国,214,63,151
333,龙塔,20221129,全国,全国,193,70,123
334,龙塔,20221130,全国,全国,211,68,143
335,龙塔,20221201,全国,全国,216,64,152
336,龙塔,20221202,全国,全国,226,74,152
337,龙塔,20221203,全国,全国,200,66,134
338,龙塔,20221204,全国,全国,214,63,151
339,龙塔,20221205,全国,全国,199,64,135
340,龙塔,20221206,全国,全国,204,61,143
341,龙塔,20221207,全国,全国,204,66,138
342,龙塔,20221208,全国,全国,221,74,147
343,龙塔,20221209,全国,全国,196,66,130
344,龙塔,20221210,全国,全国,186,61,125
345,龙塔,20221211,全国,全国,187,59,128
346,龙塔,20221212,全国,全国,200,61,139
347,龙塔,20221213,全国,全国,178,63,115
348,龙塔,20221214,全国,全国,189,64,125
349,龙塔,20221215,全国,全国,198,63,135
350,龙塔,20221216,全国,全国,195,72,123
351,龙塔,20221217,全国,全国,202,64,138
352,龙塔,20221218,全国,全国,169,63,106
353,龙塔,20221219,全国,全国,188,63,125
354,龙塔,20221220,全国,全国,177,64,113
355,龙塔,20221221,全国,全国,169,59,110
356,龙塔,20221222,全国,全国,106,0,106
357,龙塔,20221223,全国,全国,134,0,134
358,龙塔,20221224,全国,全国,170,66,104
359,龙塔,20221225,全国,全国,182,63,119
360,龙塔,20221226,全国,全国,191,66,125
361,龙塔,20221227,全国,全国,196,61,135
362,龙塔,20221228,全国,全国,185,63,122
363,龙塔,20221229,全国,全国,167,59,108
364,龙塔,20221230,全国,全国,206,61,145
365,龙塔,20221231,全国,全国,213,59,154
366,龙塔,20230101,全国,全国,205,64,141
367,龙塔,20230102,全国,全国,208,59,149
368,龙塔,20230103,全国,全国,201,63,138
369,龙塔,20230104,全国,全国,211,66,145
370,龙塔,20230105,全国,全国,215,64,151
371,龙塔,20230106,全国,全国,222,74,148
372,龙塔,20230107,全国,全国,221,66,155
373,龙塔,20230108,全国,全国,242,63,179
374,龙塔,20230109,全国,全国,205,74,131
375,龙塔,20230110,全国,全国,227,80,147
376,龙塔,20230111,全国,全国,213,74,139
377,龙塔,20230112,全国,全国,236,63,173
378,龙塔,20230113,全国,全国,237,74,163
379,龙塔,20230114,全国,全国,226,61,165
380,龙塔,20230115,全国,全国,212,64,148
381,龙塔,20230116,全国,全国,212,68,144
382,龙塔,20230117,全国,全国,227,66,161
383,龙塔,20230118,全国,全国,246,80,166
384,龙塔,20230119,全国,全国,224,63,161
385,龙塔,20230120,全国,全国,198,66,132
386,龙塔,20230121,全国,全国,174,59,115
387,龙塔,20230122,全国,全国,207,59,148
388,龙塔,20230123,全国,全国,250,64,186
389,龙塔,20230124,全国,全国,180,0,180
390,龙塔,20230125,全国,全国,278,61,217
391,龙塔,20230126,全国,全国,309,61,248
392,龙塔,20230127,全国,全国,272,80,192
393,龙塔,20230128,全国,全国,264,64,200
394,龙塔,20230129,全国,全国,290,97,193
395,龙塔,20230130,全国,全国,278,74,204
396,龙塔,20230131,全国,全国,290,97,193
397,龙塔,20230201,全国,全国,271,68,203
398,龙塔,20230202,全国,全国,267,83,184
399,龙塔,20230203,全国,全国,285,89,196
400,龙塔,20230204,全国,全国,251,59,192
401,龙塔,20230205,全国,全国,244,66,178
402,龙塔,20230206,全国,全国,237,74,163
403,龙塔,20230207,全国,全国,246,76,170
404,龙塔,20230208,全国,全国,276,80,196
405,龙塔,20230209,全国,全国,289,61,228
406,龙塔,20230210,全国,全国,245,74,171
407,龙塔,20230211,全国,全国,254,64,190
408,龙塔,20230212,全国,全国,297,66,231
409,龙塔,20230213,全国,全国,273,68,205
410,龙塔,20230214,全国,全国,248,70,178
411,龙塔,20230215,全国,全国,228,68,160
412,龙塔,20230216,全国,全国,237,66,171
413,龙塔,20230217,全国,全国,244,76,168
414,龙塔,20230218,全国,全国,263,59,204
415,龙塔,20230219,全国,全国,265,61,204
416,龙塔,20230220,全国,全国,237,64,173
417,龙塔,20230221,全国,全国,240,66,174
418,龙塔,20230222,全国,全国,232,66,166
419,龙塔,20230223,全国,全国,221,70,151
420,龙塔,20230224,全国,全国,238,68,170
421,龙塔,20230225,全国,全国,277,66,211
422,龙塔,20230226,全国,全国,271,74,197
423,龙塔,20230227,全国,全国,252,76,176
424,龙塔,20230228,全国,全国,219,70,149
425,龙塔,20230301,全国,全国,229,74,155
426,龙塔,20230302,全国,全国,231,74,157
427,龙塔,20230303,全国,全国,241,76,165
428,龙塔,20230304,全国,全国,284,59,225
429,龙塔,20230305,全国,全国,257,68,189
430,龙塔,20230306,全国,全国,237,82,155
431,龙塔,20230307,全国,全国,236,72,164
432,龙塔,20230308,全国,全国,247,70,177
433,龙塔,20230309,全国,全国,227,72,155
434,龙塔,20230310,全国,全国,244,63,181
435,龙塔,20230311,全国,全国,264,61,203
436,龙塔,20230312,全国,全国,284,66,218
437,龙塔,20230313,全国,全国,244,74,170
438,龙塔,20230314,全国,全国,227,64,163
439,龙塔,20230315,全国,全国,239,76,163
440,龙塔,20230316,全国,全国,242,68,174
441,龙塔,20230317,全国,全国,249,64,185
442,龙塔,20230318,全国,全国,283,64,219
443,龙塔,20230319,全国,全国,281,70,211
444,龙塔,20230320,全国,全国,227,64,163
445,龙塔,20230321,全国,全国,243,70,173
446,龙塔,20230322,全国,全国,230,70,160
447,龙塔,20230323,全国,全国,242,74,168
448,龙塔,20230324,全国,全国,242,68,174
449,龙塔,20230325,全国,全国,264,61,203
450,龙塔,20230326,全国,全国,259,59,200
451,龙塔,20230327,全国,全国,242,74,168
452,龙塔,20230328,全国,全国,252,70,182
453,龙塔,20230329,全国,全国,248,74,174
454,龙塔,20230330,全国,全国,281,76,205
455,龙塔,20230331,全国,全国,257,59,198
456,龙塔,20230401,全国,全国,288,59,229
457,龙塔,20230402,全国,全国,283,64,219
458,龙塔,20230403,全国,全国,261,78,183
459,龙塔,20230404,全国,全国,286,82,204
460,龙塔,20230405,全国,全国,304,72,232
461,龙塔,20230406,全国,全国,235,64,171
462,龙塔,20230407,全国,全国,269,70,199
463,龙塔,20230408,全国,全国,285,63,222
464,龙塔,20230409,全国,全国,292,68,224
465,龙塔,20230410,全国,全国,233,72,161
466,龙塔,20230411,全国,全国,252,76,176
467,龙塔,20230412,全国,全国,272,82,190
468,龙塔,20230413,全国,全国,279,89,190
469,龙塔,20230414,全国,全国,273,78,195
470,龙塔,20230415,全国,全国,324,63,261
471,龙塔,20230416,全国,全国,300,61,239
472,龙塔,20230417,全国,全国,264,72,192
473,龙塔,20230418,全国,全国,237,61,176
474,龙塔,20230419,全国,全国,284,72,212
475,龙塔,20230420,全国,全国,292,72,220
476,龙塔,20230421,全国,全国,294,72,222
477,龙塔,20230422,全国,全国,299,64,235
478,龙塔,20230423,全国,全国,295,68,227
479,龙塔,20230424,全国,全国,285,76,209
480,龙塔,20230425,全国,全国,280,72,208
481,龙塔,20230426,全国,全国,305,85,220
482,龙塔,20230427,全国,全国,310,68,242
483,龙塔,20230428,全国,全国,391,74,317
484,龙塔,20230429,全国,全国,583,72,511
485,龙塔,20230430,全国,全国,640,72,568
486,龙塔,20230501,全国,全国,647,68,579
487,龙塔,20230502,全国,全国,537,64,473
488,龙塔,20230503,全国,全国,471,74,397
489,龙塔,20230504,全国,全国,322,72,250
490,龙塔,20230505,全国,全国,297,66,231
491,龙塔,20230506,全国,全国,286,68,218
492,龙塔,20230507,全国,全国,317,61,256
493,龙塔,20230508,全国,全国,279,78,201
494,龙塔,20230509,全国,全国,272,74,198
495,龙塔,20230510,全国,全国,292,78,214
496,龙塔,20230511,全国,全国,284,80,204
497,龙塔,20230512,全国,全国,259,66,193
498,龙塔,20230513,全国,全国,273,61,212
499,龙塔,20230514,全国,全国,287,59,228
500,龙塔,20230515,全国,全国,271,74,197
501,龙塔,20230516,全国,全国,244,61,183
502,龙塔,20230517,全国,全国,270,66,204
503,龙塔,20230518,全国,全国,283,82,201
504,龙塔,20230519,全国,全国,269,66,203
505,龙塔,20230520,全国,全国,275,61,214
506,龙塔,20230521,全国,全国,320,66,254
507,龙塔,20230522,全国,全国,258,61,197
508,龙塔,20230523,全国,全国,235,61,174
509,龙塔,20230524,全国,全国,248,66,182
510,龙塔,20230525,全国,全国,248,66,182
511,龙塔,20230526,全国,全国,238,61,177
512,龙塔,20230527,全国,全国,278,66,212
513,龙塔,20230528,全国,全国,271,63,208
514,龙塔,20230529,全国,全国,254,64,190
515,龙塔,20230530,全国,全国,261,64,197
516,龙塔,20230531,全国,全国,279,74,205
517,龙塔,20230601,全国,全国,265,80,185
518,龙塔,20230602,全国,全国,261,76,185
519,龙塔,20230603,全国,全国,290,59,231
520,龙塔,20230604,全国,全国,288,64,224
521,龙塔,20230605,全国,全国,244,66,178
522,龙塔,20230606,全国,全国,257,72,185
523,龙塔,20230607,全国,全国,313,82,231
524,龙塔,20230608,全国,全国,304,72,232
525,龙塔,20230609,全国,全国,294,80,214
526,龙塔,20230610,全国,全国,286,61,225
527,龙塔,20230611,全国,全国,342,68,274
528,龙塔,20230612,全国,全国,289,85,204
529,龙塔,20230613,全国,全国,267,72,195
530,龙塔,20230614,全国,全国,271,78,193
531,龙塔,20230615,全国,全国,269,80,189
532,龙塔,20230616,全国,全国,254,68,186
533,龙塔,20230617,全国,全国,285,61,224
534,龙塔,20230618,全国,全国,267,0,267
535,龙塔,20230619,全国,全国,265,76,189
536,龙塔,20230620,全国,全国,259,66,193
537,龙塔,20230621,全国,全国,243,59,184
538,龙塔,20230622,全国,全国,312,64,248
539,龙塔,20230623,全国,全国,309,59,250
540,龙塔,20230624,全国,全国,208,0,208
541,龙塔,20230625,全国,全国,287,76,211
542,龙塔,20230626,全国,全国,270,64,206
543,龙塔,20230627,全国,全国,276,76,200
544,龙塔,20230628,全国,全国,294,85,209
545,龙塔,20230629,全国,全国,267,64,203
546,龙塔,20230630,全国,全国,252,70,182
547,龙塔,20230701,全国,全国,255,63,192
548,龙塔,20230702,全国,全国,298,63,235
549,龙塔,20230703,全国,全国,278,72,206
550,龙塔,20230704,全国,全国,256,66,190
551,龙塔,20230705,全国,全国,284,76,208
552,龙塔,20230706,全国,全国,270,78,192
553,龙塔,20230707,全国,全国,295,68,227
554,龙塔,20230708,全国,全国,344,66,278
555,龙塔,20230709,全国,全国,334,72,262
556,龙塔,20230710,全国,全国,293,78,215
557,龙塔,20230711,全国,全国,314,68,246
558,龙塔,20230712,全国,全国,333,70,263
559,龙塔,20230713,全国,全国,298,76,222
560,龙塔,20230714,全国,全国,289,70,219
561,龙塔,20230715,全国,全国,328,61,267
562,龙塔,20230716,全国,全国,316,63,253
563,龙塔,20230717,全国,全国,331,76,255
564,龙塔,20230718,全国,全国,322,76,246
565,龙塔,20230719,全国,全国,319,74,245
566,龙塔,20230720,全国,全国,319,78,241
567,龙塔,20230721,全国,全国,346,78,268
568,龙塔,20230722,全国,全国,338,68,270
569,龙塔,20230723,全国,全国,341,68,273
570,龙塔,20230724,全国,全国,367,87,280
571,龙塔,20230725,全国,全国,313,78,235
572,龙塔,20230726,全国,全国,358,70,288
573,龙塔,20230727,全国,全国,332,64,268
574,龙塔,20230728,全国,全国,376,78,298
575,龙塔,20230729,全国,全国,361,72,289
576,龙塔,20230730,全国,全国,389,66,323
577,龙塔,20230731,全国,全国,355,70,285
578,龙塔,20230801,全国,全国,354,83,271
579,龙塔,20230802,全国,全国,325,78,247
580,龙塔,20230803,全国,全国,331,74,257
581,龙塔,20230804,全国,全国,311,70,241
582,龙塔,20230805,全国,全国,347,63,284
583,龙塔,20230806,全国,全国,341,63,278
584,龙塔,20230807,全国,全国,404,101,303
585,龙塔,20230808,全国,全国,282,64,218
586,龙塔,20230809,全国,全国,323,76,247
587,龙塔,20230810,全国,全国,344,70,274
588,龙塔,20230811,全国,全国,311,72,239
589,龙塔,20230812,全国,全国,313,66,247
590,龙塔,20230813,全国,全国,295,70,225
591,龙塔,20230814,全国,全国,305,74,231
592,龙塔,20230815,全国,全国,309,68,241
593,龙塔,20230816,全国,全国,335,68,267
594,龙塔,20230817,全国,全国,307,68,239
595,龙塔,20230818,全国,全国,306,70,236
596,龙塔,20230819,全国,全国,354,72,282
597,龙塔,20230820,全国,全国,317,61,256
598,龙塔,20230821,全国,全国,312,74,238
599,龙塔,20230822,全国,全国,316,82,234
600,龙塔,20230823,全国,全国,282,70,212
601,龙塔,20230824,全国,全国,307,68,239
602,龙塔,20230825,全国,全国,325,80,245
603,龙塔,20230826,全国,全国,319,72,247
604,龙塔,20230827,全国,全国,290,63,227
605,龙塔,20230828,全国,全国,317,70,247
606,龙塔,20230829,全国,全国,282,76,206
607,龙塔,20230830,全国,全国,293,78,215
608,龙塔,20230831,全国,全国,258,63,195
609,龙塔,20230901,全国,全国,249,59,190
610,龙塔,20230902,全国,全国,256,63,193
611,龙塔,20230903,全国,全国,215,0,215
612,龙塔,20230904,全国,全国,229,68,161
613,龙塔,20230905,全国,全国,223,63,160
614,龙塔,20230906,全国,全国,244,64,180
615,龙塔,20230907,全国,全国,240,70,170
616,龙塔,20230908,全国,全国,261,66,195
617,龙塔,20230909,全国,全国,293,59,234
618,龙塔,20230910,全国,全国,337,64,273
619,龙塔,20230911,全国,全国,251,80,171
620,龙塔,20230912,全国,全国,271,78,193
621,龙塔,20230913,全国,全国,258,72,186
622,龙塔,20230914,全国,全国,250,63,187
623,龙塔,20230915,全国,全国,258,63,195
624,龙塔,20230916,全国,全国,280,66,214
625,龙塔,20230917,全国,全国,267,59,208
626,龙塔,20230918,全国,全国,243,70,173
627,龙塔,20230919,全国,全国,236,74,162
628,龙塔,20230920,全国,全国,248,72,176
629,龙塔,20230921,全国,全国,220,66,154
630,龙塔,20230922,全国,全国,242,72,170
631,龙塔,20230923,全国,全国,201,0,201
632,龙塔,20230924,全国,全国,250,63,187
633,龙塔,20230925,全国,全国,200,70,130
634,龙塔,20230926,全国,全国,226,66,160
635,龙塔,20230927,全国,全国,249,66,183
636,龙塔,20230928,全国,全国,241,61,180
637,龙塔,20230929,全国,全国,264,59,205
638,龙塔,20230930,全国,全国,322,63,259
639,龙塔,20231001,全国,全国,310,0,310
640,龙塔,20231002,全国,全国,390,0,390
641,龙塔,20231003,全国,全国,423,61,362
642,龙塔,20231004,全国,全国,417,68,349
643,龙塔,20231005,全国,全国,333,72,261
644,龙塔,20231006,全国,全国,306,64,242
645,龙塔,20231007,全国,全国,196,0,196
646,龙塔,20231008,全国,全国,233,63,170
647,龙塔,20231009,全国,全国,257,70,187
648,龙塔,20231010,全国,全国,261,72,189
649,龙塔,20231011,全国,全国,293,72,221
650,龙塔,20231012,全国,全国,304,83,221
651,龙塔,20231013,全国,全国,256,70,186
652,龙塔,20231014,全国,全国,282,74,208
653,龙塔,20231015,全国,全国,256,66,190
654,龙塔,20231016,全国,全国,282,85,197
655,龙塔,20231017,全国,全国,246,72,174
656,龙塔,20231018,全国,全国,236,72,164
657,龙塔,20231019,全国,全国,239,78,161
658,龙塔,20231020,全国,全国,230,68,162
659,龙塔,20231021,全国,全国,259,70,189
660,龙塔,20231022,全国,全国,245,68,177
661,龙塔,20231023,全国,全国,227,70,157
662,龙塔,20231024,全国,全国,203,72,131
663,龙塔,20231025,全国,全国,196,64,132
664,龙塔,20231026,全国,全国,219,80,139
665,龙塔,20231027,全国,全国,224,72,152
666,龙塔,20231028,全国,全国,248,59,189
667,龙塔,20231029,全国,全国,263,70,193
668,龙塔,20231030,全国,全国,234,80,154
669,龙塔,20231031,全国,全国,220,66,154
670,龙塔,20231101,全国,全国,235,83,152
671,龙塔,20231102,全国,全国,238,78,160
672,龙塔,20231103,全国,全国,223,74,149
673,龙塔,20231104,全国,全国,247,68,179
674,龙塔,20231105,全国,全国,223,68,155
675,龙塔,20231106,全国,全国,222,78,144
676,龙塔,20231107,全国,全国,246,87,159
677,龙塔,20231108,全国,全国,221,74,147
678,龙塔,20231109,全国,全国,221,66,155
679,龙塔,20231110,全国,全国,196,70,126
680,龙塔,20231111,全国,全国,219,64,155
681,龙塔,20231112,全国,全国,223,68,155
682,龙塔,20231113,全国,全国,213,74,139
683,龙塔,20231114,全国,全国,227,76,151
684,龙塔,20231115,全国,全国,244,89,155
685,龙塔,20231116,全国,全国,218,83,135
686,龙塔,20231117,全国,全国,232,70,162
687,龙塔,20231118,全国,全国,170,0,170
688,龙塔,20231119,全国,全国,174,0,174
689,龙塔,20231120,全国,全国,215,70,145
690,龙塔,20231121,全国,全国,248,99,149
691,龙塔,20231122,全国,全国,201,80,121
692,龙塔,20231123,全国,全国,223,80,143
693,龙塔,20231124,全国,全国,249,76,173
694,龙塔,20231125,全国,全国,259,85,174
695,龙塔,20231126,全国,全国,254,80,174
696,龙塔,20231127,全国,全国,224,76,148
697,龙塔,20231128,全国,全国,252,82,170
698,龙塔,20231129,全国,全国,250,95,155
699,龙塔,20231130,全国,全国,242,95,147
700,龙塔,20231201,全国,全国,220,66,154
701,龙塔,20231202,全国,全国,236,66,170
702,龙塔,20231203,全国,全国,259,64,195
703,龙塔,20231204,全国,全国,243,82,161
704,龙塔,20231205,全国,全国,239,87,152
705,龙塔,20231206,全国,全国,223,68,155
706,龙塔,20231207,全国,全国,231,70,161
707,龙塔,20231208,全国,全国,249,82,167
708,龙塔,20231209,全国,全国,230,70,160
709,龙塔,20231210,全国,全国,238,72,166
710,龙塔,20231211,全国,全国,194,72,122
711,龙塔,20231212,全国,全国,209,78,131
712,龙塔,20231213,全国,全国,213,70,143
713,龙塔,20231214,全国,全国,239,68,171
714,龙塔,20231215,全国,全国,225,70,155
715,龙塔,20231216,全国,全国,224,63,161
716,龙塔,20231217,全国,全国,233,63,170
717,龙塔,20231218,全国,全国,227,64,163
718,龙塔,20231219,全国,全国,255,85,170
719,龙塔,20231220,全国,全国,221,64,157
720,龙塔,20231221,全国,全国,219,72,147
721,龙塔,20231222,全国,全国,240,66,174
722,龙塔,20231223,全国,全国,254,61,193
723,龙塔,20231224,全国,全国,270,70,200
724,龙塔,20231225,全国,全国,232,78,154
725,龙塔,20231226,全国,全国,247,76,171
726,龙塔,20231227,全国,全国,251,74,177
727,龙塔,20231228,全国,全国,251,66,185
728,龙塔,20231229,全国,全国,275,80,195
729,龙塔,20231230,全国,全国,281,70,211
730,龙塔,20231231,全国,全国,270,59,211
731,龙塔,20240101,全国,全国,270,61,209
732,龙塔,20240102,全国,全国,215,70,145
733,龙塔,20240103,全国,全国,301,93,208
734,龙塔,20240104,全国,全国,257,76,181
735,龙塔,20240105,全国,全国,314,102,212
736,龙塔,20240106,全国,全国,280,72,208
737,龙塔,20240107,全国,全国,263,59,204
738,龙塔,20240108,全国,全国,286,87,199
739,龙塔,20240109,全国,全国,306,89,217
740,龙塔,20240110,全国,全国,289,87,202
741,龙塔,20240111,全国,全国,250,72,178
742,龙塔,20240112,全国,全国,246,70,176
743,龙塔,20240113,全国,全国,268,76,192
744,龙塔,20240114,全国,全国,252,68,184
745,龙塔,20240115,全国,全国,270,85,185
746,龙塔,20240116,全国,全国,256,83,173
747,龙塔,20240117,全国,全国,282,87,195
748,龙塔,20240118,全国,全国,266,82,184
749,龙塔,20240119,全国,全国,272,80,192
750,龙塔,20240120,全国,全国,266,63,203
751,龙塔,20240121,全国,全国,264,66,198
752,龙塔,20240122,全国,全国,249,68,181
753,龙塔,20240123,全国,全国,226,63,163
754,龙塔,20240124,全国,全国,238,76,162
755,龙塔,20240125,全国,全国,246,78,168
756,龙塔,20240126,全国,全国,261,82,179
757,龙塔,20240127,全国,全国,262,85,177
758,龙塔,20240128,全国,全国,300,68,232
759,龙塔,20240129,全国,全国,282,70,212
760,龙塔,20240130,全国,全国,303,76,227
761,龙塔,20240131,全国,全国,269,74,195
762,龙塔,20240201,全国,全国,255,70,185
763,龙塔,20240202,全国,全国,250,72,178
764,龙塔,20240203,全国,全国,258,63,195
765,龙塔,20240204,全国,全国,255,66,189
766,龙塔,20240205,全国,全国,298,63,235
767,龙塔,20240206,全国,全国,278,72,206
768,龙塔,20240207,全国,全国,244,68,176
769,龙塔,20240208,全国,全国,235,61,174
770,龙塔,20240209,全国,全国,305,63,242
771,龙塔,20240210,全国,全国,288,64,224
772,龙塔,20240211,全国,全国,371,63,308
773,龙塔,20240212,全国,全国,355,61,294
774,龙塔,20240213,全国,全国,460,70,390
775,龙塔,20240214,全国,全国,429,64,365
776,龙塔,20240215,全国,全国,415,61,354
777,龙塔,20240216,全国,全国,343,59,284
778,龙塔,20240217,全国,全国,389,63,326
779,龙塔,20240218,全国,全国,336,70,266
780,龙塔,20240219,全国,全国,306,78,228
781,龙塔,20240220,全国,全国,307,72,235
782,龙塔,20240221,全国,全国,298,74,224
783,龙塔,20240222,全国,全国,333,85,248
784,龙塔,20240223,全国,全国,289,74,215
785,龙塔,20240224,全国,全国,295,64,231
786,龙塔,20240225,全国,全国,279,59,220
787,龙塔,20240226,全国,全国,288,64,224
788,龙塔,20240227,全国,全国,284,83,201
789,龙塔,20240228,全国,全国,237,61,176
790,龙塔,20240229,全国,全国,235,64,171
791,龙塔,20240301,全国,全国,239,76,163
792,龙塔,20240302,全国,全国,224,64,160
793,龙塔,20240303,全国,全国,244,64,180
794,龙塔,20240304,全国,全国,244,74,170
795,龙塔,20240305,全国,全国,235,72,163
796,龙塔,20240306,全国,全国,228,68,160
797,龙塔,20240307,全国,全国,244,70,174
798,龙塔,20240308,全国,全国,261,66,195
799,龙塔,20240309,全国,全国,301,70,231
800,龙塔,20240310,全国,全国,267,59,208
801,龙塔,20240311,全国,全国,278,89,189
802,龙塔,20240312,全国,全国,242,87,155
803,龙塔,20240313,全国,全国,221,64,157
804,龙塔,20240314,全国,全国,219,72,147
805,龙塔,20240315,全国,全国,231,76,155
806,龙塔,20240316,全国,全国,222,68,154
807,龙塔,20240317,全国,全国,232,64,168
808,龙塔,20240318,全国,全国,209,64,145
809,龙塔,20240319,全国,全国,238,74,164
810,龙塔,20240320,全国,全国,207,72,135
811,龙塔,20240321,全国,全国,226,72,154
812,龙塔,20240322,全国,全国,202,68,134
813,龙塔,20240323,全国,全国,229,63,166
814,龙塔,20240324,全国,全国,242,68,174
815,龙塔,20240325,全国,全国,216,72,144
816,龙塔,20240326,全国,全国,224,63,161
817,龙塔,20240327,全国,全国,225,68,157
818,龙塔,20240328,全国,全国,237,78,159
819,龙塔,20240329,全国,全国,223,68,155
820,龙塔,20240330,全国,全国,250,61,189
821,龙塔,20240331,全国,全国,231,70,161
822,龙塔,20240401,全国,全国,221,72,149
823,龙塔,20240402,全国,全国,240,76,164
824,龙塔,20240403,全国,全国,231,83,148
825,龙塔,20240404,全国,全国,319,63,256
826,龙塔,20240405,全国,全国,340,63,277
827,龙塔,20240406,全国,全国,268,68,200
828,龙塔,20240407,全国,全国,218,74,144
829,龙塔,20240408,全国,全国,203,68,135
830,龙塔,20240409,全国,全国,220,63,157
831,龙塔,20240410,全国,全国,203,68,135
832,龙塔,20240411,全国,全国,199,74,125
833,龙塔,20240412,全国,全国,198,70,128
834,龙塔,20240413,全国,全国,247,63,184
835,龙塔,20240414,全国,全国,236,74,162
836,龙塔,20240415,全国,全国,199,61,138
837,龙塔,20240416,全国,全国,233,74,159
838,龙塔,20240417,全国,全国,218,63,155
839,龙塔,20240418,全国,全国,215,66,149
840,龙塔,20240419,全国,全国,225,76,149
841,龙塔,20240420,全国,全国,230,59,171
842,龙塔,20240421,全国,全国,241,61,180
843,龙塔,20240422,全国,全国,206,68,138
844,龙塔,20240423,全国,全国,245,82,163
845,龙塔,20240424,全国,全国,246,76,170
846,龙塔,20240425,全国,全国,242,66,176
847,龙塔,20240426,全国,全国,231,72,159
848,龙塔,20240427,全国,全国,259,66,193
849,龙塔,20240428,全国,全国,238,80,158
850,龙塔,20240429,全国,全国,187,61,126
851,龙塔,20240430,全国,全国,260,68,192
1,哈尔滨文化公园,20220101,全国,全国,63,0,63
2,哈尔滨文化公园,20220102,全国,全国,78,0,78
3,哈尔滨文化公园,20220103,全国,全国,84,0,84
4,哈尔滨文化公园,20220104,全国,全国,61,0,61
5,哈尔滨文化公园,20220105,全国,全国,63,0,63
6,哈尔滨文化公园,20220106,全国,全国,76,0,76
7,哈尔滨文化公园,20220107,全国,全国,59,59,0
8,哈尔滨文化公园,20220108,全国,全国,67,0,67
9,哈尔滨文化公园,20220109,全国,全国,129,59,70
10,哈尔滨文化公园,20220110,全国,全国,61,0,61
11,哈尔滨文化公园,20220111,全国,全国,66,0,66
12,哈尔滨文化公园,20220112,全国,全国,74,0,74
13,哈尔滨文化公园,20220113,全国,全国,125,59,66
14,哈尔滨文化公园,20220114,全国,全国,70,0,70
15,哈尔滨文化公园,20220115,全国,全国,70,0,70
16,哈尔滨文化公园,20220116,全国,全国,69,0,69
17,哈尔滨文化公园,20220117,全国,全国,61,0,61
18,哈尔滨文化公园,20220118,全国,全国,134,63,71
19,哈尔滨文化公园,20220119,全国,全国,124,59,65
20,哈尔滨文化公园,20220120,全国,全国,0,0,0
21,哈尔滨文化公园,20220121,全国,全国,63,0,63
22,哈尔滨文化公园,20220122,全国,全国,65,0,65
23,哈尔滨文化公园,20220123,全国,全国,69,0,69
24,哈尔滨文化公园,20220124,全国,全国,69,0,69
25,哈尔滨文化公园,20220125,全国,全国,0,0,0
26,哈尔滨文化公园,20220126,全国,全国,59,59,0
27,哈尔滨文化公园,20220127,全国,全国,130,61,69
28,哈尔滨文化公园,20220128,全国,全国,126,61,65
29,哈尔滨文化公园,20220129,全国,全国,63,0,63
30,哈尔滨文化公园,20220130,全国,全国,0,0,0
31,哈尔滨文化公园,20220131,全国,全国,0,0,0
32,哈尔滨文化公园,20220201,全国,全国,71,0,71
33,哈尔滨文化公园,20220202,全国,全国,69,0,69
34,哈尔滨文化公园,20220203,全国,全国,70,0,70
35,哈尔滨文化公园,20220204,全国,全国,66,0,66
36,哈尔滨文化公园,20220205,全国,全国,67,0,67
37,哈尔滨文化公园,20220206,全国,全国,70,0,70
38,哈尔滨文化公园,20220207,全国,全国,0,0,0
39,哈尔滨文化公园,20220208,全国,全国,126,61,65
40,哈尔滨文化公园,20220209,全国,全国,126,59,67
41,哈尔滨文化公园,20220210,全国,全国,71,0,71
42,哈尔滨文化公园,20220211,全国,全国,67,0,67
43,哈尔滨文化公园,20220212,全国,全国,67,0,67
44,哈尔滨文化公园,20220213,全国,全国,66,0,66
45,哈尔滨文化公园,20220214,全国,全国,0,0,0
46,哈尔滨文化公园,20220215,全国,全国,66,0,66
47,哈尔滨文化公园,20220216,全国,全国,63,0,63
48,哈尔滨文化公园,20220217,全国,全国,67,0,67
49,哈尔滨文化公园,20220218,全国,全国,135,59,76
50,哈尔滨文化公园,20220219,全国,全国,71,0,71
51,哈尔滨文化公园,20220220,全国,全国,71,0,71
52,哈尔滨文化公园,20220221,全国,全国,126,59,67
53,哈尔滨文化公园,20220222,全国,全国,127,61,66
54,哈尔滨文化公园,20220223,全国,全国,67,0,67
55,哈尔滨文化公园,20220224,全国,全国,135,61,74
56,哈尔滨文化公园,20220225,全国,全国,71,0,71
57,哈尔滨文化公园,20220226,全国,全国,66,0,66
58,哈尔滨文化公园,20220227,全国,全国,71,0,71
59,哈尔滨文化公园,20220228,全国,全国,126,59,67
60,哈尔滨文化公园,20220301,全国,全国,78,0,78
61,哈尔滨文化公园,20220302,全国,全国,61,0,61
62,哈尔滨文化公园,20220303,全国,全国,144,68,76
63,哈尔滨文化公园,20220304,全国,全国,129,63,66
64,哈尔滨文化公园,20220305,全国,全国,63,0,63
65,哈尔滨文化公园,20220306,全国,全国,79,0,79
66,哈尔滨文化公园,20220307,全国,全国,71,0,71
67,哈尔滨文化公园,20220308,全国,全国,79,0,79
68,哈尔滨文化公园,20220309,全国,全国,74,0,74
69,哈尔滨文化公园,20220310,全国,全国,78,0,78
70,哈尔滨文化公园,20220311,全国,全国,70,0,70
71,哈尔滨文化公园,20220312,全国,全国,71,0,71
72,哈尔滨文化公园,20220313,全国,全国,139,61,78
73,哈尔滨文化公园,20220314,全国,全国,128,59,69
74,哈尔滨文化公园,20220315,全国,全国,133,63,70
75,哈尔滨文化公园,20220316,全国,全国,142,64,78
76,哈尔滨文化公园,20220317,全国,全国,65,0,65
77,哈尔滨文化公园,20220318,全国,全国,69,0,69
78,哈尔滨文化公园,20220319,全国,全国,71,0,71
79,哈尔滨文化公园,20220320,全国,全国,69,0,69
80,哈尔滨文化公园,20220321,全国,全国,130,61,69
81,哈尔滨文化公园,20220322,全国,全国,130,59,71
82,哈尔滨文化公园,20220323,全国,全国,65,0,65
83,哈尔滨文化公园,20220324,全国,全国,61,61,0
84,哈尔滨文化公园,20220325,全国,全国,126,59,67
85,哈尔滨文化公园,20220326,全国,全国,74,0,74
86,哈尔滨文化公园,20220327,全国,全国,79,0,79
87,哈尔滨文化公园,20220328,全国,全国,78,0,78
88,哈尔滨文化公园,20220329,全国,全国,120,59,61
89,哈尔滨文化公园,20220330,全国,全国,143,61,82
90,哈尔滨文化公园,20220331,全国,全国,74,0,74
91,哈尔滨文化公园,20220401,全国,全国,130,59,71
92,哈尔滨文化公园,20220402,全国,全国,78,0,78
93,哈尔滨文化公园,20220403,全国,全国,139,59,80
94,哈尔滨文化公园,20220404,全国,全国,71,0,71
95,哈尔滨文化公园,20220405,全国,全国,132,61,71
96,哈尔滨文化公园,20220406,全国,全国,67,0,67
97,哈尔滨文化公园,20220407,全国,全国,74,0,74
98,哈尔滨文化公园,20220408,全国,全国,76,0,76
99,哈尔滨文化公园,20220409,全国,全国,71,0,71
100,哈尔滨文化公园,20220410,全国,全国,76,0,76
101,哈尔滨文化公园,20220411,全国,全国,145,59,86
102,哈尔滨文化公园,20220412,全国,全国,136,66,70
103,哈尔滨文化公园,20220413,全国,全国,71,0,71
104,哈尔滨文化公园,20220414,全国,全国,73,0,73
105,哈尔滨文化公园,20220415,全国,全国,66,0,66
106,哈尔滨文化公园,20220416,全国,全国,73,0,73
107,哈尔滨文化公园,20220417,全国,全国,132,59,73
108,哈尔滨文化公园,20220418,全国,全国,67,0,67
109,哈尔滨文化公园,20220419,全国,全国,65,0,65
110,哈尔滨文化公园,20220420,全国,全国,78,0,78
111,哈尔滨文化公园,20220421,全国,全国,120,59,61
112,哈尔滨文化公园,20220422,全国,全国,74,0,74
113,哈尔滨文化公园,20220423,全国,全国,63,0,63
114,哈尔滨文化公园,20220424,全国,全国,122,59,63
115,哈尔滨文化公园,20220425,全国,全国,79,0,79
116,哈尔滨文化公园,20220426,全国,全国,80,0,80
117,哈尔滨文化公园,20220427,全国,全国,124,59,65
118,哈尔滨文化公园,20220428,全国,全国,80,0,80
119,哈尔滨文化公园,20220429,全国,全国,78,0,78
120,哈尔滨文化公园,20220430,全国,全国,143,59,84
121,哈尔滨文化公园,20220501,全国,全国,140,64,76
122,哈尔滨文化公园,20220502,全国,全国,80,0,80
123,哈尔滨文化公园,20220503,全国,全国,132,59,73
124,哈尔滨文化公园,20220504,全国,全国,78,0,78
125,哈尔滨文化公园,20220505,全国,全国,93,0,93
126,哈尔滨文化公园,20220506,全国,全国,137,61,76
127,哈尔滨文化公园,20220507,全国,全国,78,0,78
128,哈尔滨文化公园,20220508,全国,全国,99,0,99
129,哈尔滨文化公园,20220509,全国,全国,95,0,95
130,哈尔滨文化公园,20220510,全国,全国,146,59,87
131,哈尔滨文化公园,20220511,全国,全国,165,63,102
132,哈尔滨文化公园,20220512,全国,全国,79,0,79
133,哈尔滨文化公园,20220513,全国,全国,142,63,79
134,哈尔滨文化公园,20220514,全国,全国,158,59,99
135,哈尔滨文化公园,20220515,全国,全国,109,0,109
136,哈尔滨文化公园,20220516,全国,全国,141,59,82
137,哈尔滨文化公园,20220517,全国,全国,79,0,79
138,哈尔滨文化公园,20220518,全国,全国,86,0,86
139,哈尔滨文化公园,20220519,全国,全国,95,0,95
140,哈尔滨文化公园,20220520,全国,全国,92,0,92
141,哈尔滨文化公园,20220521,全国,全国,168,63,105
142,哈尔滨文化公园,20220522,全国,全国,118,0,118
143,哈尔滨文化公园,20220523,全国,全国,153,64,89
144,哈尔滨文化公园,20220524,全国,全国,154,61,93
145,哈尔滨文化公园,20220525,全国,全国,139,59,80
146,哈尔滨文化公园,20220526,全国,全国,145,61,84
147,哈尔滨文化公园,20220527,全国,全国,93,0,93
148,哈尔滨文化公园,20220528,全国,全国,182,59,123
149,哈尔滨文化公园,20220529,全国,全国,151,59,92
150,哈尔滨文化公园,20220530,全国,全国,150,66,84
151,哈尔滨文化公园,20220531,全国,全国,118,0,118
152,哈尔滨文化公园,20220601,全国,全国,239,63,176
153,哈尔滨文化公园,20220602,全国,全国,128,0,128
154,哈尔滨文化公园,20220603,全国,全国,195,0,195
155,哈尔滨文化公园,20220604,全国,全国,135,0,135
156,哈尔滨文化公园,20220605,全国,全国,109,0,109
157,哈尔滨文化公园,20220606,全国,全国,156,61,95
158,哈尔滨文化公园,20220607,全国,全国,169,63,106
159,哈尔滨文化公园,20220608,全国,全国,113,0,113
160,哈尔滨文化公园,20220609,全国,全国,193,68,125
161,哈尔滨文化公园,20220610,全国,全国,156,64,92
162,哈尔滨文化公园,20220611,全国,全国,173,61,112
163,哈尔滨文化公园,20220612,全国,全国,176,61,115
164,哈尔滨文化公园,20220613,全国,全国,163,61,102
165,哈尔滨文化公园,20220614,全国,全国,154,61,93
166,哈尔滨文化公园,20220615,全国,全国,138,59,79
167,哈尔滨文化公园,20220616,全国,全国,71,0,71
168,哈尔滨文化公园,20220617,全国,全国,172,66,106
169,哈尔滨文化公园,20220618,全国,全国,123,0,123
170,哈尔滨文化公园,20220619,全国,全国,102,0,102
171,哈尔滨文化公园,20220620,全国,全国,156,63,93
172,哈尔滨文化公园,20220621,全国,全国,106,0,106
173,哈尔滨文化公园,20220622,全国,全国,147,64,83
174,哈尔滨文化公园,20220623,全国,全国,86,0,86
175,哈尔滨文化公园,20220624,全国,全国,86,0,86
176,哈尔滨文化公园,20220625,全国,全国,163,61,102
177,哈尔滨文化公园,20220626,全国,全国,168,59,109
178,哈尔滨文化公园,20220627,全国,全国,155,59,96
179,哈尔滨文化公园,20220628,全国,全国,99,0,99
180,哈尔滨文化公园,20220629,全国,全国,176,61,115
181,哈尔滨文化公园,20220630,全国,全国,183,66,117
182,哈尔滨文化公园,20220701,全国,全国,169,63,106
183,哈尔滨文化公园,20220702,全国,全国,121,0,121
184,哈尔滨文化公园,20220703,全国,全国,192,61,131
185,哈尔滨文化公园,20220704,全国,全国,157,61,96
186,哈尔滨文化公园,20220705,全国,全国,177,59,118
187,哈尔滨文化公园,20220706,全国,全国,185,59,126
188,哈尔滨文化公园,20220707,全国,全国,186,63,123
189,哈尔滨文化公园,20220708,全国,全国,138,0,138
190,哈尔滨文化公园,20220709,全国,全国,203,59,144
191,哈尔滨文化公园,20220710,全国,全国,195,61,134
192,哈尔滨文化公园,20220711,全国,全国,211,59,152
193,哈尔滨文化公园,20220712,全国,全国,209,61,148
194,哈尔滨文化公园,20220713,全国,全国,198,63,135
195,哈尔滨文化公园,20220714,全国,全国,195,63,132
196,哈尔滨文化公园,20220715,全国,全国,138,0,138
197,哈尔滨文化公园,20220716,全国,全国,215,61,154
198,哈尔滨文化公园,20220717,全国,全国,171,0,171
199,哈尔滨文化公园,20220718,全国,全国,195,59,136
200,哈尔滨文化公园,20220719,全国,全国,217,59,158
201,哈尔滨文化公园,20220720,全国,全国,202,63,139
202,哈尔滨文化公园,20220721,全国,全国,203,64,139
203,哈尔滨文化公园,20220722,全国,全国,210,63,147
204,哈尔滨文化公园,20220723,全国,全国,230,63,167
205,哈尔滨文化公园,20220724,全国,全国,196,61,135
206,哈尔滨文化公园,20220725,全国,全国,189,63,126
207,哈尔滨文化公园,20220726,全国,全国,215,66,149
208,哈尔滨文化公园,20220727,全国,全国,155,0,155
209,哈尔滨文化公园,20220728,全国,全国,218,66,152
210,哈尔滨文化公园,20220729,全国,全国,187,64,123
211,哈尔滨文化公园,20220730,全国,全国,160,0,160
212,哈尔滨文化公园,20220731,全国,全国,174,0,174
213,哈尔滨文化公园,20220801,全国,全国,215,64,151
214,哈尔滨文化公园,20220802,全国,全国,216,61,155
215,哈尔滨文化公园,20220803,全国,全国,157,0,157
216,哈尔滨文化公园,20220804,全国,全国,209,61,148
217,哈尔滨文化公园,20220805,全国,全国,224,59,165
218,哈尔滨文化公园,20220806,全国,全国,245,64,181
219,哈尔滨文化公园,20220807,全国,全国,207,59,148
220,哈尔滨文化公园,20220808,全国,全国,211,59,152
221,哈尔滨文化公园,20220809,全国,全国,128,0,128
222,哈尔滨文化公园,20220810,全国,全国,157,61,96
223,哈尔滨文化公园,20220811,全国,全国,184,61,123
224,哈尔滨文化公园,20220812,全国,全国,131,0,131
225,哈尔滨文化公园,20220813,全国,全国,182,61,121
226,哈尔滨文化公园,20220814,全国,全国,145,0,145
227,哈尔滨文化公园,20220815,全国,全国,126,0,126
228,哈尔滨文化公园,20220816,全国,全国,119,0,119
229,哈尔滨文化公园,20220817,全国,全国,198,64,134
230,哈尔滨文化公园,20220818,全国,全国,180,59,121
231,哈尔滨文化公园,20220819,全国,全国,105,0,105
232,哈尔滨文化公园,20220820,全国,全国,135,0,135
233,哈尔滨文化公园,20220821,全国,全国,125,0,125
234,哈尔滨文化公园,20220822,全国,全国,150,59,91
235,哈尔滨文化公园,20220823,全国,全国,97,0,97
236,哈尔滨文化公园,20220824,全国,全国,102,0,102
237,哈尔滨文化公园,20220825,全国,全国,148,59,89
238,哈尔滨文化公园,20220826,全国,全国,92,0,92
239,哈尔滨文化公园,20220827,全国,全国,173,63,110
240,哈尔滨文化公园,20220828,全国,全国,87,0,87
241,哈尔滨文化公园,20220829,全国,全国,71,0,71
242,哈尔滨文化公园,20220830,全国,全国,73,0,73
243,哈尔滨文化公园,20220831,全国,全国,82,0,82
244,哈尔滨文化公园,20220901,全国,全国,124,59,65
245,哈尔滨文化公园,20220902,全国,全国,71,0,71
246,哈尔滨文化公园,20220903,全国,全国,133,59,74
247,哈尔滨文化公园,20220904,全国,全国,78,0,78
248,哈尔滨文化公园,20220905,全国,全国,67,0,67
249,哈尔滨文化公园,20220906,全国,全国,67,0,67
250,哈尔滨文化公园,20220907,全国,全国,132,61,71
251,哈尔滨文化公园,20220908,全国,全国,133,59,74
252,哈尔滨文化公园,20220909,全国,全国,143,59,84
253,哈尔滨文化公园,20220910,全国,全国,100,0,100
254,哈尔滨文化公园,20220911,全国,全国,100,0,100
255,哈尔滨文化公园,20220912,全国,全国,115,0,115
256,哈尔滨文化公园,20220913,全国,全国,137,61,76
257,哈尔滨文化公园,20220914,全国,全国,92,0,92
258,哈尔滨文化公园,20220915,全国,全国,80,0,80
259,哈尔滨文化公园,20220916,全国,全国,146,59,87
260,哈尔滨文化公园,20220917,全国,全国,80,0,80
261,哈尔滨文化公园,20220918,全国,全国,84,0,84
262,哈尔滨文化公园,20220919,全国,全国,69,0,69
263,哈尔滨文化公园,20220920,全国,全国,70,0,70
264,哈尔滨文化公园,20220921,全国,全国,126,59,67
265,哈尔滨文化公园,20220922,全国,全国,124,61,63
266,哈尔滨文化公园,20220923,全国,全国,61,0,61
267,哈尔滨文化公园,20220924,全国,全国,70,0,70
268,哈尔滨文化公园,20220925,全国,全国,95,0,95
269,哈尔滨文化公园,20220926,全国,全国,128,63,65
270,哈尔滨文化公园,20220927,全国,全国,131,61,70
271,哈尔滨文化公园,20220928,全国,全国,124,59,65
272,哈尔滨文化公园,20220929,全国,全国,71,0,71
273,哈尔滨文化公园,20220930,全国,全国,86,0,86
274,哈尔滨文化公园,20221001,全国,全国,109,0,109
275,哈尔滨文化公园,20221002,全国,全国,109,0,109
276,哈尔滨文化公园,20221003,全国,全国,76,0,76
277,哈尔滨文化公园,20221004,全国,全国,89,0,89
278,哈尔滨文化公园,20221005,全国,全国,76,0,76
279,哈尔滨文化公园,20221006,全国,全国,78,0,78
280,哈尔滨文化公园,20221007,全国,全国,78,0,78
281,哈尔滨文化公园,20221008,全国,全国,73,0,73
282,哈尔滨文化公园,20221009,全国,全国,63,0,63
283,哈尔滨文化公园,20221010,全国,全国,63,0,63
284,哈尔滨文化公园,20221011,全国,全国,69,0,69
285,哈尔滨文化公园,20221012,全国,全国,86,0,86
286,哈尔滨文化公园,20221013,全国,全国,67,0,67
287,哈尔滨文化公园,20221014,全国,全国,134,63,71
288,哈尔滨文化公园,20221015,全国,全国,73,0,73
289,哈尔滨文化公园,20221016,全国,全国,76,0,76
290,哈尔滨文化公园,20221017,全国,全国,73,0,73
291,哈尔滨文化公园,20221018,全国,全国,76,0,76
292,哈尔滨文化公园,20221019,全国,全国,78,0,78
293,哈尔滨文化公园,20221020,全国,全国,142,59,83
294,哈尔滨文化公园,20221021,全国,全国,82,0,82
295,哈尔滨文化公园,20221022,全国,全国,105,0,105
296,哈尔滨文化公园,20221023,全国,全国,100,0,100
297,哈尔滨文化公园,20221024,全国,全国,79,0,79
298,哈尔滨文化公园,20221025,全国,全国,70,0,70
299,哈尔滨文化公园,20221026,全国,全国,67,0,67
300,哈尔滨文化公园,20221027,全国,全国,87,0,87
301,哈尔滨文化公园,20221028,全国,全国,70,0,70
302,哈尔滨文化公园,20221029,全国,全国,74,0,74
303,哈尔滨文化公园,20221030,全国,全国,80,0,80
304,哈尔滨文化公园,20221031,全国,全国,133,59,74
305,哈尔滨文化公园,20221101,全国,全国,70,0,70
306,哈尔滨文化公园,20221102,全国,全国,66,0,66
307,哈尔滨文化公园,20221103,全国,全国,61,0,61
308,哈尔滨文化公园,20221104,全国,全国,61,0,61
309,哈尔滨文化公园,20221105,全国,全国,61,0,61
310,哈尔滨文化公园,20221106,全国,全国,73,0,73
311,哈尔滨文化公园,20221107,全国,全国,66,0,66
312,哈尔滨文化公园,20221108,全国,全国,71,0,71
313,哈尔滨文化公园,20221109,全国,全国,79,0,79
314,哈尔滨文化公园,20221110,全国,全国,73,0,73
315,哈尔滨文化公园,20221111,全国,全国,70,0,70
316,哈尔滨文化公园,20221112,全国,全国,124,59,65
317,哈尔滨文化公园,20221113,全国,全国,70,0,70
318,哈尔滨文化公园,20221114,全国,全国,61,0,61
319,哈尔滨文化公园,20221115,全国,全国,139,68,71
320,哈尔滨文化公园,20221116,全国,全国,66,0,66
321,哈尔滨文化公园,20221117,全国,全国,70,0,70
322,哈尔滨文化公园,20221118,全国,全国,0,0,0
323,哈尔滨文化公园,20221119,全国,全国,69,0,69
324,哈尔滨文化公园,20221120,全国,全国,122,59,63
325,哈尔滨文化公园,20221121,全国,全国,122,59,63
326,哈尔滨文化公园,20221122,全国,全国,65,0,65
327,哈尔滨文化公园,20221123,全国,全国,129,66,63
328,哈尔滨文化公园,20221124,全国,全国,65,0,65
329,哈尔滨文化公园,20221125,全国,全国,130,64,66
330,哈尔滨文化公园,20221126,全国,全国,0,0,0
331,哈尔滨文化公园,20221127,全国,全国,130,59,71
332,哈尔滨文化公园,20221128,全国,全国,0,0,0
333,哈尔滨文化公园,20221129,全国,全国,67,0,67
334,哈尔滨文化公园,20221130,全国,全国,64,64,0
335,哈尔滨文化公园,20221201,全国,全国,59,59,0
336,哈尔滨文化公园,20221202,全国,全国,65,0,65
337,哈尔滨文化公园,20221203,全国,全国,70,0,70
338,哈尔滨文化公园,20221204,全国,全国,70,0,70
339,哈尔滨文化公园,20221205,全国,全国,0,0,0
340,哈尔滨文化公园,20221206,全国,全国,0,0,0
341,哈尔滨文化公园,20221207,全国,全国,66,0,66
342,哈尔滨文化公园,20221208,全国,全国,65,0,65
343,哈尔滨文化公园,20221209,全国,全国,65,0,65
344,哈尔滨文化公园,20221210,全国,全国,67,0,67
345,哈尔滨文化公园,20221211,全国,全国,63,0,63
346,哈尔滨文化公园,20221212,全国,全国,66,0,66
347,哈尔滨文化公园,20221213,全国,全国,0,0,0
348,哈尔滨文化公园,20221214,全国,全国,126,59,67
349,哈尔滨文化公园,20221215,全国,全国,66,0,66
350,哈尔滨文化公园,20221216,全国,全国,70,0,70
351,哈尔滨文化公园,20221217,全国,全国,73,0,73
352,哈尔滨文化公园,20221218,全国,全国,63,0,63
353,哈尔滨文化公园,20221219,全国,全国,127,61,66
354,哈尔滨文化公园,20221220,全国,全国,63,0,63
355,哈尔滨文化公园,20221221,全国,全国,0,0,0
356,哈尔滨文化公园,20221222,全国,全国,61,0,61
357,哈尔滨文化公园,20221223,全国,全国,65,0,65
358,哈尔滨文化公园,20221224,全国,全国,0,0,0
359,哈尔滨文化公园,20221225,全国,全国,63,0,63
360,哈尔滨文化公园,20221226,全国,全国,0,0,0
361,哈尔滨文化公园,20221227,全国,全国,122,61,61
362,哈尔滨文化公园,20221228,全国,全国,128,63,65
363,哈尔滨文化公园,20221229,全国,全国,65,0,65
364,哈尔滨文化公园,20221230,全国,全国,83,0,83
365,哈尔滨文化公园,20221231,全国,全国,69,0,69
366,哈尔滨文化公园,20230101,全国,全国,61,0,61
367,哈尔滨文化公园,20230102,全国,全国,80,0,80
368,哈尔滨文化公园,20230103,全国,全国,69,0,69
369,哈尔滨文化公园,20230104,全国,全国,135,59,76
370,哈尔滨文化公园,20230105,全国,全国,132,59,73
371,哈尔滨文化公园,20230106,全国,全国,66,0,66
372,哈尔滨文化公园,20230107,全国,全国,84,0,84
373,哈尔滨文化公园,20230108,全国,全国,70,0,70
374,哈尔滨文化公园,20230109,全国,全国,132,59,73
375,哈尔滨文化公园,20230110,全国,全国,137,59,78
376,哈尔滨文化公园,20230111,全国,全国,130,59,71
377,哈尔滨文化公园,20230112,全国,全国,130,63,67
378,哈尔滨文化公园,20230113,全国,全国,137,61,76
379,哈尔滨文化公园,20230114,全国,全国,79,0,79
380,哈尔滨文化公园,20230115,全国,全国,92,0,92
381,哈尔滨文化公园,20230116,全国,全国,74,0,74
382,哈尔滨文化公园,20230117,全国,全国,79,0,79
383,哈尔滨文化公园,20230118,全国,全国,65,0,65
384,哈尔滨文化公园,20230119,全国,全国,74,0,74
385,哈尔滨文化公园,20230120,全国,全国,66,0,66
386,哈尔滨文化公园,20230121,全国,全国,69,0,69
387,哈尔滨文化公园,20230122,全国,全国,137,61,76
388,哈尔滨文化公园,20230123,全国,全国,87,0,87
389,哈尔滨文化公园,20230124,全国,全国,71,0,71
390,哈尔滨文化公园,20230125,全国,全国,73,0,73
391,哈尔滨文化公园,20230126,全国,全国,79,0,79
392,哈尔滨文化公园,20230127,全国,全国,84,0,84
393,哈尔滨文化公园,20230128,全国,全国,74,0,74
394,哈尔滨文化公园,20230129,全国,全国,73,0,73
395,哈尔滨文化公园,20230130,全国,全国,74,0,74
396,哈尔滨文化公园,20230131,全国,全国,137,61,76
397,哈尔滨文化公园,20230201,全国,全国,76,0,76
398,哈尔滨文化公园,20230202,全国,全国,76,0,76
399,哈尔滨文化公园,20230203,全国,全国,86,0,86
400,哈尔滨文化公园,20230204,全国,全国,83,0,83
401,哈尔滨文化公园,20230205,全国,全国,95,0,95
402,哈尔滨文化公园,20230206,全国,全国,74,0,74
403,哈尔滨文化公园,20230207,全国,全国,141,61,80
404,哈尔滨文化公园,20230208,全国,全国,86,0,86
405,哈尔滨文化公园,20230209,全国,全国,78,0,78
406,哈尔滨文化公园,20230210,全国,全国,100,0,100
407,哈尔滨文化公园,20230211,全国,全国,87,0,87
408,哈尔滨文化公园,20230212,全国,全国,80,0,80
409,哈尔滨文化公园,20230213,全国,全国,80,0,80
410,哈尔滨文化公园,20230214,全国,全国,76,0,76
411,哈尔滨文化公园,20230215,全国,全国,79,0,79
412,哈尔滨文化公园,20230216,全国,全国,78,0,78
413,哈尔滨文化公园,20230217,全国,全国,79,0,79
414,哈尔滨文化公园,20230218,全国,全国,92,0,92
415,哈尔滨文化公园,20230219,全国,全国,143,59,84
416,哈尔滨文化公园,20230220,全国,全国,74,0,74
417,哈尔滨文化公园,20230221,全国,全国,84,0,84
418,哈尔滨文化公园,20230222,全国,全国,80,0,80
419,哈尔滨文化公园,20230223,全国,全国,143,64,79
420,哈尔滨文化公园,20230224,全国,全国,140,61,79
421,哈尔滨文化公园,20230225,全国,全国,119,0,119
422,哈尔滨文化公园,20230226,全国,全国,92,0,92
423,哈尔滨文化公园,20230227,全国,全国,145,59,86
424,哈尔滨文化公园,20230228,全国,全国,69,0,69
425,哈尔滨文化公园,20230301,全国,全国,133,59,74
426,哈尔滨文化公园,20230302,全国,全国,141,61,80
427,哈尔滨文化公园,20230303,全国,全国,142,63,79
428,哈尔滨文化公园,20230304,全国,全国,109,0,109
429,哈尔滨文化公园,20230305,全国,全国,117,0,117
430,哈尔滨文化公园,20230306,全国,全国,83,0,83
431,哈尔滨文化公园,20230307,全国,全国,141,59,82
432,哈尔滨文化公园,20230308,全国,全国,118,0,118
433,哈尔滨文化公园,20230309,全国,全国,136,63,73
434,哈尔滨文化公园,20230310,全国,全国,89,0,89
435,哈尔滨文化公园,20230311,全国,全国,95,0,95
436,哈尔滨文化公园,20230312,全国,全国,105,0,105
437,哈尔滨文化公园,20230313,全国,全国,82,0,82
438,哈尔滨文化公园,20230314,全国,全国,99,0,99
439,哈尔滨文化公园,20230315,全国,全国,79,0,79
440,哈尔滨文化公园,20230316,全国,全国,87,0,87
441,哈尔滨文化公园,20230317,全国,全国,95,0,95
442,哈尔滨文化公园,20230318,全国,全国,110,0,110
443,哈尔滨文化公园,20230319,全国,全国,106,0,106
444,哈尔滨文化公园,20230320,全国,全国,161,61,100
445,哈尔滨文化公园,20230321,全国,全国,92,0,92
446,哈尔滨文化公园,20230322,全国,全国,86,0,86
447,哈尔滨文化公园,20230323,全国,全国,152,63,89
448,哈尔滨文化公园,20230324,全国,全国,86,0,86
449,哈尔滨文化公园,20230325,全国,全国,108,0,108
450,哈尔滨文化公园,20230326,全国,全国,99,0,99
451,哈尔滨文化公园,20230327,全国,全国,165,59,106
452,哈尔滨文化公园,20230328,全国,全国,91,0,91
453,哈尔滨文化公园,20230329,全国,全国,139,59,80
454,哈尔滨文化公园,20230330,全国,全国,153,61,92
455,哈尔滨文化公园,20230331,全国,全国,169,61,108
456,哈尔滨文化公园,20230401,全国,全国,224,61,163
457,哈尔滨文化公园,20230402,全国,全国,190,59,131
458,哈尔滨文化公园,20230403,全国,全国,156,61,95
459,哈尔滨文化公园,20230404,全国,全国,109,0,109
460,哈尔滨文化公园,20230405,全国,全国,193,61,132
461,哈尔滨文化公园,20230406,全国,全国,153,61,92
462,哈尔滨文化公园,20230407,全国,全国,108,0,108
463,哈尔滨文化公园,20230408,全国,全国,171,61,110
464,哈尔滨文化公园,20230409,全国,全国,138,0,138
465,哈尔滨文化公园,20230410,全国,全国,145,59,86
466,哈尔滨文化公园,20230411,全国,全国,96,0,96
467,哈尔滨文化公园,20230412,全国,全国,157,64,93
468,哈尔滨文化公园,20230413,全国,全国,147,61,86
469,哈尔滨文化公园,20230414,全国,全国,110,0,110
470,哈尔滨文化公园,20230415,全国,全国,195,59,136
471,哈尔滨文化公园,20230416,全国,全国,136,0,136
472,哈尔滨文化公园,20230417,全国,全国,162,63,99
473,哈尔滨文化公园,20230418,全国,全国,100,0,100
474,哈尔滨文化公园,20230419,全国,全国,146,59,87
475,哈尔滨文化公园,20230420,全国,全国,165,70,95
476,哈尔滨文化公园,20230421,全国,全国,167,63,104
477,哈尔滨文化公园,20230422,全国,全国,105,0,105
478,哈尔滨文化公园,20230423,全国,全国,152,59,93
479,哈尔滨文化公园,20230424,全国,全国,108,0,108
480,哈尔滨文化公园,20230425,全国,全国,163,61,102
481,哈尔滨文化公园,20230426,全国,全国,180,61,119
482,哈尔滨文化公园,20230427,全国,全国,135,0,135
483,哈尔滨文化公园,20230428,全国,全国,222,59,163
484,哈尔滨文化公园,20230429,全国,全国,177,0,177
485,哈尔滨文化公园,20230430,全国,全国,259,59,200
486,哈尔滨文化公园,20230501,全国,全国,334,59,275
487,哈尔滨文化公园,20230502,全国,全国,209,0,209
488,哈尔滨文化公园,20230503,全国,全国,191,59,132
489,哈尔滨文化公园,20230504,全国,全国,179,61,118
490,哈尔滨文化公园,20230505,全国,全国,118,0,118
491,哈尔滨文化公园,20230506,全国,全国,110,0,110
492,哈尔滨文化公园,20230507,全国,全国,169,59,110
493,哈尔滨文化公园,20230508,全国,全国,93,0,93
494,哈尔滨文化公园,20230509,全国,全国,100,0,100
495,哈尔滨文化公园,20230510,全国,全国,95,0,95
496,哈尔滨文化公园,20230511,全国,全国,99,0,99
497,哈尔滨文化公园,20230512,全国,全国,170,61,109
498,哈尔滨文化公园,20230513,全国,全国,161,59,102
499,哈尔滨文化公园,20230514,全国,全国,115,0,115
500,哈尔滨文化公园,20230515,全国,全国,117,0,117
501,哈尔滨文化公园,20230516,全国,全国,128,0,128
502,哈尔滨文化公园,20230517,全国,全国,173,61,112
503,哈尔滨文化公园,20230518,全国,全国,180,59,121
504,哈尔滨文化公园,20230519,全国,全国,157,61,96
505,哈尔滨文化公园,20230520,全国,全国,178,59,119
506,哈尔滨文化公园,20230521,全国,全国,99,0,99
507,哈尔滨文化公园,20230522,全国,全国,100,0,100
508,哈尔滨文化公园,20230523,全国,全国,112,0,112
509,哈尔滨文化公园,20230524,全国,全国,108,0,108
510,哈尔滨文化公园,20230525,全国,全国,165,63,102
511,哈尔滨文化公园,20230526,全国,全国,180,59,121
512,哈尔滨文化公园,20230527,全国,全国,200,59,141
513,哈尔滨文化公园,20230528,全国,全国,134,0,134
514,哈尔滨文化公园,20230529,全国,全国,165,63,102
515,哈尔滨文化公园,20230530,全国,全国,121,0,121
516,哈尔滨文化公园,20230531,全国,全国,110,0,110
517,哈尔滨文化公园,20230601,全国,全国,144,0,144
518,哈尔滨文化公园,20230602,全国,全国,119,0,119
519,哈尔滨文化公园,20230603,全国,全国,108,0,108
520,哈尔滨文化公园,20230604,全国,全国,131,0,131
521,哈尔滨文化公园,20230605,全国,全国,178,59,119
522,哈尔滨文化公园,20230606,全国,全国,165,59,106
523,哈尔滨文化公园,20230607,全国,全国,165,66,99
524,哈尔滨文化公园,20230608,全国,全国,173,64,109
525,哈尔滨文化公园,20230609,全国,全国,83,0,83
526,哈尔滨文化公园,20230610,全国,全国,99,0,99
527,哈尔滨文化公园,20230611,全国,全国,105,0,105
528,哈尔滨文化公园,20230612,全国,全国,105,0,105
529,哈尔滨文化公园,20230613,全国,全国,165,59,106
530,哈尔滨文化公园,20230614,全国,全国,167,59,108
531,哈尔滨文化公园,20230615,全国,全国,151,59,92
532,哈尔滨文化公园,20230616,全国,全国,158,63,95
533,哈尔滨文化公园,20230617,全国,全国,165,59,106
534,哈尔滨文化公园,20230618,全国,全国,108,0,108
535,哈尔滨文化公园,20230619,全国,全国,100,0,100
536,哈尔滨文化公园,20230620,全国,全国,91,0,91
537,哈尔滨文化公园,20230621,全国,全国,160,63,97
538,哈尔滨文化公园,20230622,全国,全国,132,0,132
539,哈尔滨文化公园,20230623,全国,全国,208,59,149
540,哈尔滨文化公园,20230624,全国,全国,95,0,95
541,哈尔滨文化公园,20230625,全国,全国,147,63,84
542,哈尔滨文化公园,20230626,全国,全国,172,63,109
543,哈尔滨文化公园,20230627,全国,全国,102,0,102
544,哈尔滨文化公园,20230628,全国,全国,142,59,83
545,哈尔滨文化公园,20230629,全国,全国,99,0,99
546,哈尔滨文化公园,20230630,全国,全国,99,0,99
547,哈尔滨文化公园,20230701,全国,全国,119,0,119
548,哈尔滨文化公园,20230702,全国,全国,123,0,123
549,哈尔滨文化公园,20230703,全国,全国,100,0,100
550,哈尔滨文化公园,20230704,全国,全国,99,0,99
551,哈尔滨文化公园,20230705,全国,全国,104,0,104
552,哈尔滨文化公园,20230706,全国,全国,184,61,123
553,哈尔滨文化公园,20230707,全国,全国,106,0,106
554,哈尔滨文化公园,20230708,全国,全国,130,0,130
555,哈尔滨文化公园,20230709,全国,全国,172,59,113
556,哈尔滨文化公园,20230710,全国,全国,172,59,113
557,哈尔滨文化公园,20230711,全国,全国,121,0,121
558,哈尔滨文化公园,20230712,全国,全国,179,64,115
559,哈尔滨文化公园,20230713,全国,全国,182,59,123
560,哈尔滨文化公园,20230714,全国,全国,104,0,104
561,哈尔滨文化公园,20230715,全国,全国,148,59,89
562,哈尔滨文化公园,20230716,全国,全国,91,0,91
563,哈尔滨文化公园,20230717,全国,全国,187,64,123
564,哈尔滨文化公园,20230718,全国,全国,184,61,123
565,哈尔滨文化公园,20230719,全国,全国,206,61,145
566,哈尔滨文化公园,20230720,全国,全国,168,59,109
567,哈尔滨文化公园,20230721,全国,全国,144,0,144
568,哈尔滨文化公园,20230722,全国,全国,117,0,117
569,哈尔滨文化公园,20230723,全国,全国,168,63,105
570,哈尔滨文化公园,20230724,全国,全国,110,0,110
571,哈尔滨文化公园,20230725,全国,全国,121,0,121
572,哈尔滨文化公园,20230726,全国,全国,123,0,123
573,哈尔滨文化公园,20230727,全国,全国,186,61,125
574,哈尔滨文化公园,20230728,全国,全国,193,59,134
575,哈尔滨文化公园,20230729,全国,全国,119,0,119
576,哈尔滨文化公园,20230730,全国,全国,193,59,134
577,哈尔滨文化公园,20230731,全国,全国,152,0,152
578,哈尔滨文化公园,20230801,全国,全国,131,0,131
579,哈尔滨文化公园,20230802,全国,全国,148,64,84
580,哈尔滨文化公园,20230803,全国,全国,117,0,117
581,哈尔滨文化公园,20230804,全国,全国,130,0,130
582,哈尔滨文化公园,20230805,全国,全国,181,64,117
583,哈尔滨文化公园,20230806,全国,全国,149,0,149
584,哈尔滨文化公园,20230807,全国,全国,106,0,106
585,哈尔滨文化公园,20230808,全国,全国,206,59,147
586,哈尔滨文化公园,20230809,全国,全国,117,0,117
587,哈尔滨文化公园,20230810,全国,全国,182,59,123
588,哈尔滨文化公园,20230811,全国,全国,185,64,121
589,哈尔滨文化公园,20230812,全国,全国,110,0,110
590,哈尔滨文化公园,20230813,全国,全国,130,0,130
591,哈尔滨文化公园,20230814,全国,全国,135,0,135
592,哈尔滨文化公园,20230815,全国,全国,212,61,151
593,哈尔滨文化公园,20230816,全国,全国,119,0,119
594,哈尔滨文化公园,20230817,全国,全国,119,0,119
595,哈尔滨文化公园,20230818,全国,全国,130,0,130
596,哈尔滨文化公园,20230819,全国,全国,128,0,128
597,哈尔滨文化公园,20230820,全国,全国,143,0,143
598,哈尔滨文化公园,20230821,全国,全国,175,63,112
599,哈尔滨文化公园,20230822,全国,全国,164,59,105
600,哈尔滨文化公园,20230823,全国,全国,147,0,147
601,哈尔滨文化公园,20230824,全国,全国,128,0,128
602,哈尔滨文化公园,20230825,全国,全国,160,63,97
603,哈尔滨文化公园,20230826,全国,全国,119,0,119
604,哈尔滨文化公园,20230827,全国,全国,167,59,108
605,哈尔滨文化公园,20230828,全国,全国,153,61,92
606,哈尔滨文化公园,20230829,全国,全国,140,61,79
607,哈尔滨文化公园,20230830,全国,全国,93,0,93
608,哈尔滨文化公园,20230831,全国,全国,89,0,89
609,哈尔滨文化公园,20230901,全国,全国,105,0,105
610,哈尔滨文化公园,20230902,全国,全国,113,0,113
611,哈尔滨文化公园,20230903,全国,全国,115,0,115
612,哈尔滨文化公园,20230904,全国,全国,86,0,86
613,哈尔滨文化公园,20230905,全国,全国,84,0,84
614,哈尔滨文化公园,20230906,全国,全国,96,0,96
615,哈尔滨文化公园,20230907,全国,全国,95,0,95
616,哈尔滨文化公园,20230908,全国,全国,110,0,110
617,哈尔滨文化公园,20230909,全国,全国,115,0,115
618,哈尔滨文化公园,20230910,全国,全国,171,59,112
619,哈尔滨文化公园,20230911,全国,全国,118,0,118
620,哈尔滨文化公园,20230912,全国,全国,158,61,97
621,哈尔滨文化公园,20230913,全国,全国,100,0,100
622,哈尔滨文化公园,20230914,全国,全国,165,61,104
623,哈尔滨文化公园,20230915,全国,全国,159,59,100
624,哈尔滨文化公园,20230916,全国,全国,162,63,99
625,哈尔滨文化公园,20230917,全国,全国,112,0,112
626,哈尔滨文化公园,20230918,全国,全国,80,0,80
627,哈尔滨文化公园,20230919,全国,全国,110,0,110
628,哈尔滨文化公园,20230920,全国,全国,93,0,93
629,哈尔滨文化公园,20230921,全国,全国,87,0,87
630,哈尔滨文化公园,20230922,全国,全国,92,0,92
631,哈尔滨文化公园,20230923,全国,全国,87,0,87
632,哈尔滨文化公园,20230924,全国,全国,89,0,89
633,哈尔滨文化公园,20230925,全国,全国,86,0,86
634,哈尔滨文化公园,20230926,全国,全国,99,0,99
635,哈尔滨文化公园,20230927,全国,全国,80,0,80
636,哈尔滨文化公园,20230928,全国,全国,163,61,102
637,哈尔滨文化公园,20230929,全国,全国,109,0,109
638,哈尔滨文化公园,20230930,全国,全国,104,0,104
639,哈尔滨文化公园,20231001,全国,全国,148,0,148
640,哈尔滨文化公园,20231002,全国,全国,118,0,118
641,哈尔滨文化公园,20231003,全国,全国,169,59,110
642,哈尔滨文化公园,20231004,全国,全国,108,0,108
643,哈尔滨文化公园,20231005,全国,全国,109,0,109
644,哈尔滨文化公园,20231006,全国,全国,89,0,89
645,哈尔滨文化公园,20231007,全国,全国,129,59,70
646,哈尔滨文化公园,20231008,全国,全国,147,63,84
647,哈尔滨文化公园,20231009,全国,全国,146,59,87
648,哈尔滨文化公园,20231010,全国,全国,74,0,74
649,哈尔滨文化公园,20231011,全国,全国,132,59,73
650,哈尔滨文化公园,20231012,全国,全国,84,0,84
651,哈尔滨文化公园,20231013,全国,全国,80,0,80
652,哈尔滨文化公园,20231014,全国,全国,93,0,93
653,哈尔滨文化公园,20231015,全国,全国,143,59,84
654,哈尔滨文化公园,20231016,全国,全国,80,0,80
655,哈尔滨文化公园,20231017,全国,全国,137,59,78
656,哈尔滨文化公园,20231018,全国,全国,67,0,67
657,哈尔滨文化公园,20231019,全国,全国,79,0,79
658,哈尔滨文化公园,20231020,全国,全国,67,0,67
659,哈尔滨文化公园,20231021,全国,全国,69,0,69
660,哈尔滨文化公园,20231022,全国,全国,70,0,70
661,哈尔滨文化公园,20231023,全国,全国,69,0,69
662,哈尔滨文化公园,20231024,全国,全国,67,0,67
663,哈尔滨文化公园,20231025,全国,全国,71,0,71
664,哈尔滨文化公园,20231026,全国,全国,63,0,63
665,哈尔滨文化公园,20231027,全国,全国,126,59,67
666,哈尔滨文化公园,20231028,全国,全国,78,0,78
667,哈尔滨文化公园,20231029,全国,全国,74,0,74
668,哈尔滨文化公园,20231030,全国,全国,70,0,70
669,哈尔滨文化公园,20231031,全国,全国,127,61,66
670,哈尔滨文化公园,20231101,全国,全国,122,59,63
671,哈尔滨文化公园,20231102,全国,全国,0,0,0
672,哈尔滨文化公园,20231103,全国,全国,0,0,0
673,哈尔滨文化公园,20231104,全国,全国,65,0,65
674,哈尔滨文化公园,20231105,全国,全国,66,0,66
675,哈尔滨文化公园,20231106,全国,全国,0,0,0
676,哈尔滨文化公园,20231107,全国,全国,61,0,61
677,哈尔滨文化公园,20231108,全国,全国,61,0,61
678,哈尔滨文化公园,20231109,全国,全国,0,0,0
679,哈尔滨文化公园,20231110,全国,全国,63,0,63
680,哈尔滨文化公园,20231111,全国,全国,0,0,0
681,哈尔滨文化公园,20231112,全国,全国,66,0,66
682,哈尔滨文化公园,20231113,全国,全国,61,0,61
683,哈尔滨文化公园,20231114,全国,全国,130,63,67
684,哈尔滨文化公园,20231115,全国,全国,0,0,0
685,哈尔滨文化公园,20231116,全国,全国,61,61,0
686,哈尔滨文化公园,20231117,全国,全国,59,59,0
687,哈尔滨文化公园,20231118,全国,全国,0,0,0
688,哈尔滨文化公园,20231119,全国,全国,65,0,65
689,哈尔滨文化公园,20231120,全国,全国,0,0,0
690,哈尔滨文化公园,20231121,全国,全国,63,63,0
691,哈尔滨文化公园,20231122,全国,全国,122,59,63
692,哈尔滨文化公园,20231123,全国,全国,59,59,0
693,哈尔滨文化公园,20231124,全国,全国,125,59,66
694,哈尔滨文化公园,20231125,全国,全国,70,0,70
695,哈尔滨文化公园,20231126,全国,全国,122,59,63
696,哈尔滨文化公园,20231127,全国,全国,61,0,61
697,哈尔滨文化公园,20231128,全国,全国,0,0,0
698,哈尔滨文化公园,20231129,全国,全国,67,0,67
699,哈尔滨文化公园,20231130,全国,全国,69,0,69
700,哈尔滨文化公园,20231201,全国,全国,122,59,63
701,哈尔滨文化公园,20231202,全国,全国,66,0,66
702,哈尔滨文化公园,20231203,全国,全国,132,59,73
703,哈尔滨文化公园,20231204,全国,全国,0,0,0
704,哈尔滨文化公园,20231205,全国,全国,73,0,73
705,哈尔滨文化公园,20231206,全国,全国,124,59,65
706,哈尔滨文化公园,20231207,全国,全国,63,0,63
707,哈尔滨文化公园,20231208,全国,全国,63,0,63
708,哈尔滨文化公园,20231209,全国,全国,124,59,65
709,哈尔滨文化公园,20231210,全国,全国,0,0,0
710,哈尔滨文化公园,20231211,全国,全国,0,0,0
711,哈尔滨文化公园,20231212,全国,全国,59,59,0
712,哈尔滨文化公园,20231213,全国,全国,61,61,0
713,哈尔滨文化公园,20231214,全国,全国,0,0,0
714,哈尔滨文化公园,20231215,全国,全国,0,0,0
715,哈尔滨文化公园,20231216,全国,全国,63,0,63
716,哈尔滨文化公园,20231217,全国,全国,65,0,65
717,哈尔滨文化公园,20231218,全国,全国,134,61,73
718,哈尔滨文化公园,20231219,全国,全国,128,59,69
719,哈尔滨文化公园,20231220,全国,全国,122,61,61
720,哈尔滨文化公园,20231221,全国,全国,59,59,0
721,哈尔滨文化公园,20231222,全国,全国,122,59,63
722,哈尔滨文化公园,20231223,全国,全国,70,0,70
723,哈尔滨文化公园,20231224,全国,全国,66,0,66
724,哈尔滨文化公园,20231225,全国,全国,0,0,0
725,哈尔滨文化公园,20231226,全国,全国,130,59,71
726,哈尔滨文化公园,20231227,全国,全国,61,0,61
727,哈尔滨文化公园,20231228,全国,全国,130,59,71
728,哈尔滨文化公园,20231229,全国,全国,135,66,69
729,哈尔滨文化公园,20231230,全国,全国,66,0,66
730,哈尔滨文化公园,20231231,全国,全国,71,0,71
731,哈尔滨文化公园,20240101,全国,全国,66,0,66
732,哈尔滨文化公园,20240102,全国,全国,59,59,0
733,哈尔滨文化公园,20240103,全国,全国,67,0,67
734,哈尔滨文化公园,20240104,全国,全国,78,0,78
735,哈尔滨文化公园,20240105,全国,全国,78,0,78
736,哈尔滨文化公园,20240106,全国,全国,69,0,69
737,哈尔滨文化公园,20240107,全国,全国,125,59,66
738,哈尔滨文化公园,20240108,全国,全国,74,0,74
739,哈尔滨文化公园,20240109,全国,全国,67,0,67
740,哈尔滨文化公园,20240110,全国,全国,61,0,61
741,哈尔滨文化公园,20240111,全国,全国,135,66,69
742,哈尔滨文化公园,20240112,全国,全国,71,0,71
743,哈尔滨文化公园,20240113,全国,全国,135,61,74
744,哈尔滨文化公园,20240114,全国,全国,61,0,61
745,哈尔滨文化公园,20240115,全国,全国,0,0,0
746,哈尔滨文化公园,20240116,全国,全国,61,0,61
747,哈尔滨文化公园,20240117,全国,全国,73,0,73
748,哈尔滨文化公园,20240118,全国,全国,61,0,61
749,哈尔滨文化公园,20240119,全国,全国,76,0,76
750,哈尔滨文化公园,20240120,全国,全国,80,0,80
751,哈尔滨文化公园,20240121,全国,全国,66,0,66
752,哈尔滨文化公园,20240122,全国,全国,61,0,61
753,哈尔滨文化公园,20240123,全国,全国,73,0,73
754,哈尔滨文化公园,20240124,全国,全国,73,0,73
755,哈尔滨文化公园,20240125,全国,全国,127,61,66
756,哈尔滨文化公园,20240126,全国,全国,63,0,63
757,哈尔滨文化公园,20240127,全国,全国,67,0,67
758,哈尔滨文化公园,20240128,全国,全国,127,61,66
759,哈尔滨文化公园,20240129,全国,全国,131,61,70
760,哈尔滨文化公园,20240130,全国,全国,70,0,70
761,哈尔滨文化公园,20240131,全国,全国,63,0,63
762,哈尔滨文化公园,20240201,全国,全国,0,0,0
763,哈尔滨文化公园,20240202,全国,全国,71,0,71
764,哈尔滨文化公园,20240203,全国,全国,67,0,67
765,哈尔滨文化公园,20240204,全国,全国,76,0,76
766,哈尔滨文化公园,20240205,全国,全国,69,0,69
767,哈尔滨文化公园,20240206,全国,全国,66,0,66
768,哈尔滨文化公园,20240207,全国,全国,73,0,73
769,哈尔滨文化公园,20240208,全国,全国,61,0,61
770,哈尔滨文化公园,20240209,全国,全国,0,0,0
771,哈尔滨文化公园,20240210,全国,全国,66,0,66
772,哈尔滨文化公园,20240211,全国,全国,71,0,71
773,哈尔滨文化公园,20240212,全国,全国,69,0,69
774,哈尔滨文化公园,20240213,全国,全国,71,0,71
775,哈尔滨文化公园,20240214,全国,全国,80,0,80
776,哈尔滨文化公园,20240215,全国,全国,76,0,76
777,哈尔滨文化公园,20240216,全国,全国,73,0,73
778,哈尔滨文化公园,20240217,全国,全国,73,0,73
779,哈尔滨文化公园,20240218,全国,全国,65,0,65
780,哈尔滨文化公园,20240219,全国,全国,136,63,73
781,哈尔滨文化公园,20240220,全国,全国,66,0,66
782,哈尔滨文化公园,20240221,全国,全国,66,0,66
783,哈尔滨文化公园,20240222,全国,全国,125,59,66
784,哈尔滨文化公园,20240223,全国,全国,126,61,65
785,哈尔滨文化公园,20240224,全国,全国,78,0,78
786,哈尔滨文化公园,20240225,全国,全国,65,0,65
787,哈尔滨文化公园,20240226,全国,全国,125,59,66
788,哈尔滨文化公园,20240227,全国,全国,0,0,0
789,哈尔滨文化公园,20240228,全国,全国,65,0,65
790,哈尔滨文化公园,20240229,全国,全国,63,0,63
791,哈尔滨文化公园,20240301,全国,全国,134,63,71
792,哈尔滨文化公园,20240302,全国,全国,0,0,0
793,哈尔滨文化公园,20240303,全国,全国,61,0,61
794,哈尔滨文化公园,20240304,全国,全国,65,0,65
795,哈尔滨文化公园,20240305,全国,全国,65,0,65
796,哈尔滨文化公园,20240306,全国,全国,0,0,0
797,哈尔滨文化公园,20240307,全国,全国,63,0,63
798,哈尔滨文化公园,20240308,全国,全国,69,0,69
799,哈尔滨文化公园,20240309,全国,全国,126,59,67
800,哈尔滨文化公园,20240310,全国,全国,74,0,74
801,哈尔滨文化公园,20240311,全国,全国,79,0,79
802,哈尔滨文化公园,20240312,全国,全国,128,59,69
803,哈尔滨文化公园,20240313,全国,全国,76,0,76
804,哈尔滨文化公园,20240314,全国,全国,130,59,71
805,哈尔滨文化公园,20240315,全国,全国,74,0,74
806,哈尔滨文化公园,20240316,全国,全国,76,0,76
807,哈尔滨文化公园,20240317,全国,全国,79,0,79
808,哈尔滨文化公园,20240318,全国,全国,79,0,79
809,哈尔滨文化公园,20240319,全国,全国,59,59,0
810,哈尔滨文化公园,20240320,全国,全国,133,66,67
811,哈尔滨文化公园,20240321,全国,全国,83,0,83
812,哈尔滨文化公园,20240322,全国,全国,74,0,74
813,哈尔滨文化公园,20240323,全国,全国,133,59,74
814,哈尔滨文化公园,20240324,全国,全国,76,0,76
815,哈尔滨文化公园,20240325,全国,全国,140,74,66
816,哈尔滨文化公园,20240326,全国,全国,0,0,0
817,哈尔滨文化公园,20240327,全国,全国,73,0,73
818,哈尔滨文化公园,20240328,全国,全国,78,0,78
819,哈尔滨文化公园,20240329,全国,全国,65,0,65
820,哈尔滨文化公园,20240330,全国,全国,133,63,70
821,哈尔滨文化公园,20240331,全国,全国,136,63,73
822,哈尔滨文化公园,20240401,全国,全国,146,63,83
823,哈尔滨文化公园,20240402,全国,全国,130,61,69
824,哈尔滨文化公园,20240403,全国,全国,126,59,67
825,哈尔滨文化公园,20240404,全国,全国,109,0,109
826,哈尔滨文化公园,20240405,全国,全国,110,0,110
827,哈尔滨文化公园,20240406,全国,全国,89,0,89
828,哈尔滨文化公园,20240407,全国,全国,137,61,76
829,哈尔滨文化公园,20240408,全国,全国,120,59,61
830,哈尔滨文化公园,20240409,全国,全国,63,0,63
831,哈尔滨文化公园,20240410,全国,全国,67,0,67
832,哈尔滨文化公园,20240411,全国,全国,69,0,69
833,哈尔滨文化公园,20240412,全国,全国,80,0,80
834,哈尔滨文化公园,20240413,全国,全国,134,61,73
835,哈尔滨文化公园,20240414,全国,全国,137,57,80
836,哈尔滨文化公园,20240415,全国,全国,73,0,73
837,哈尔滨文化公园,20240416,全国,全国,128,59,69
838,哈尔滨文化公园,20240417,全国,全国,130,57,73
839,哈尔滨文化公园,20240418,全国,全国,133,57,76
840,哈尔滨文化公园,20240419,全国,全国,135,61,74
841,哈尔滨文化公园,20240420,全国,全国,139,57,82
842,哈尔滨文化公园,20240421,全国,全国,163,57,106
843,哈尔滨文化公园,20240422,全国,全国,133,59,74
844,哈尔滨文化公园,20240423,全国,全国,78,0,78
845,哈尔滨文化公园,20240424,全国,全国,126,59,67
846,哈尔滨文化公园,20240425,全国,全国,70,0,70
847,哈尔滨文化公园,20240426,全国,全国,144,61,83
848,哈尔滨文化公园,20240427,全国,全国,84,0,84
849,哈尔滨文化公园,20240428,全国,全国,145,59,86
850,哈尔滨文化公园,20240429,全国,全国,135,61,74
851,哈尔滨文化公园,20240430,全国,全国,182,57,125
1,哈尔滨极地馆,20220101,全国,全国,200,59,141
2,哈尔滨极地馆,20220102,全国,全国,115,0,115
3,哈尔滨极地馆,20220103,全国,全国,181,68,113
4,哈尔滨极地馆,20220104,全国,全国,155,59,96
5,哈尔滨极地馆,20220105,全国,全国,178,66,112
6,哈尔滨极地馆,20220106,全国,全国,167,59,108
7,哈尔滨极地馆,20220107,全国,全国,192,61,131
8,哈尔滨极地馆,20220108,全国,全国,125,0,125
9,哈尔滨极地馆,20220109,全国,全国,123,0,123
10,哈尔滨极地馆,20220110,全国,全国,178,70,108
11,哈尔滨极地馆,20220111,全国,全国,109,0,109
12,哈尔滨极地馆,20220112,全国,全国,171,66,105
13,哈尔滨极地馆,20220113,全国,全国,162,63,99
14,哈尔滨极地馆,20220114,全国,全国,177,64,113
15,哈尔滨极地馆,20220115,全国,全国,227,66,161
16,哈尔滨极地馆,20220116,全国,全国,130,0,130
17,哈尔滨极地馆,20220117,全国,全国,184,59,125
18,哈尔滨极地馆,20220118,全国,全国,177,64,113
19,哈尔滨极地馆,20220119,全国,全国,157,64,93
20,哈尔滨极地馆,20220120,全国,全国,164,59,105
21,哈尔滨极地馆,20220121,全国,全国,160,64,96
22,哈尔滨极地馆,20220122,全国,全国,180,61,119
23,哈尔滨极地馆,20220123,全国,全国,158,63,95
24,哈尔滨极地馆,20220124,全国,全国,173,61,112
25,哈尔滨极地馆,20220125,全国,全国,155,59,96
26,哈尔滨极地馆,20220126,全国,全国,152,61,91
27,哈尔滨极地馆,20220127,全国,全国,176,66,110
28,哈尔滨极地馆,20220128,全国,全国,165,63,102
29,哈尔滨极地馆,20220129,全国,全国,168,64,104
30,哈尔滨极地馆,20220130,全国,全国,138,59,79
31,哈尔滨极地馆,20220131,全国,全国,95,0,95
32,哈尔滨极地馆,20220201,全国,全国,151,0,151
33,哈尔滨极地馆,20220202,全国,全国,180,0,180
34,哈尔滨极地馆,20220203,全国,全国,202,0,202
35,哈尔滨极地馆,20220204,全国,全国,255,59,196
36,哈尔滨极地馆,20220205,全国,全国,247,66,181
37,哈尔滨极地馆,20220206,全国,全国,179,0,179
38,哈尔滨极地馆,20220207,全国,全国,221,66,155
39,哈尔滨极地馆,20220208,全国,全国,221,66,155
40,哈尔滨极地馆,20220209,全国,全国,218,63,155
41,哈尔滨极地馆,20220210,全国,全国,211,66,145
42,哈尔滨极地馆,20220211,全国,全国,223,64,159
43,哈尔滨极地馆,20220212,全国,全国,254,68,186
44,哈尔滨极地馆,20220213,全国,全国,240,59,181
45,哈尔滨极地馆,20220214,全国,全国,234,70,164
46,哈尔滨极地馆,20220215,全国,全国,209,61,148
47,哈尔滨极地馆,20220216,全国,全国,191,72,119
48,哈尔滨极地馆,20220217,全国,全国,208,64,144
49,哈尔滨极地馆,20220218,全国,全国,157,0,157
50,哈尔滨极地馆,20220219,全国,全国,247,61,186
51,哈尔滨极地馆,20220220,全国,全国,211,63,148
52,哈尔滨极地馆,20220221,全国,全国,194,63,131
53,哈尔滨极地馆,20220222,全国,全国,185,66,119
54,哈尔滨极地馆,20220223,全国,全国,173,61,112
55,哈尔滨极地馆,20220224,全国,全国,145,0,145
56,哈尔滨极地馆,20220225,全国,全国,198,64,134
57,哈尔滨极地馆,20220226,全国,全国,197,61,136
58,哈尔滨极地馆,20220227,全国,全国,204,61,143
59,哈尔滨极地馆,20220228,全国,全国,185,72,113
60,哈尔滨极地馆,20220301,全国,全国,169,64,105
61,哈尔滨极地馆,20220302,全国,全国,159,66,93
62,哈尔滨极地馆,20220303,全国,全国,170,70,100
63,哈尔滨极地馆,20220304,全国,全国,172,63,109
64,哈尔滨极地馆,20220305,全国,全国,181,59,122
65,哈尔滨极地馆,20220306,全国,全国,122,0,122
66,哈尔滨极地馆,20220307,全国,全国,173,63,110
67,哈尔滨极地馆,20220308,全国,全国,156,59,97
68,哈尔滨极地馆,20220309,全国,全国,158,63,95
69,哈尔滨极地馆,20220310,全国,全国,168,64,104
70,哈尔滨极地馆,20220311,全国,全国,191,70,121
71,哈尔滨极地馆,20220312,全国,全国,171,59,112
72,哈尔滨极地馆,20220313,全国,全国,95,0,95
73,哈尔滨极地馆,20220314,全国,全国,135,59,76
74,哈尔滨极地馆,20220315,全国,全国,147,61,86
75,哈尔滨极地馆,20220316,全国,全国,140,64,76
76,哈尔滨极地馆,20220317,全国,全国,154,63,91
77,哈尔滨极地馆,20220318,全国,全国,143,64,79
78,哈尔滨极地馆,20220319,全国,全国,78,0,78
79,哈尔滨极地馆,20220320,全国,全国,167,63,104
80,哈尔滨极地馆,20220321,全国,全国,139,63,76
81,哈尔滨极地馆,20220322,全国,全国,151,72,79
82,哈尔滨极地馆,20220323,全国,全国,139,61,78
83,哈尔滨极地馆,20220324,全国,全国,145,63,82
84,哈尔滨极地馆,20220325,全国,全国,146,68,78
85,哈尔滨极地馆,20220326,全国,全国,134,61,73
86,哈尔滨极地馆,20220327,全国,全国,74,0,74
87,哈尔滨极地馆,20220328,全国,全国,141,61,80
88,哈尔滨极地馆,20220329,全国,全国,126,63,63
89,哈尔滨极地馆,20220330,全国,全国,139,63,76
90,哈尔滨极地馆,20220331,全国,全国,146,66,80
91,哈尔滨极地馆,20220401,全国,全国,79,0,79
92,哈尔滨极地馆,20220402,全国,全国,135,59,76
93,哈尔滨极地馆,20220403,全国,全国,69,0,69
94,哈尔滨极地馆,20220404,全国,全国,86,0,86
95,哈尔滨极地馆,20220405,全国,全国,91,0,91
96,哈尔滨极地馆,20220406,全国,全国,126,63,63
97,哈尔滨极地馆,20220407,全国,全国,152,66,86
98,哈尔滨极地馆,20220408,全国,全国,138,59,79
99,哈尔滨极地馆,20220409,全国,全国,82,0,82
100,哈尔滨极地馆,20220410,全国,全国,163,63,100
101,哈尔滨极地馆,20220411,全国,全国,161,66,95
102,哈尔滨极地馆,20220412,全国,全国,176,72,104
103,哈尔滨极地馆,20220413,全国,全国,146,64,82
104,哈尔滨极地馆,20220414,全国,全国,155,59,96
105,哈尔滨极地馆,20220415,全国,全国,141,61,80
106,哈尔滨极地馆,20220416,全国,全国,130,59,71
107,哈尔滨极地馆,20220417,全国,全国,152,59,93
108,哈尔滨极地馆,20220418,全国,全国,129,59,70
109,哈尔滨极地馆,20220419,全国,全国,74,0,74
110,哈尔滨极地馆,20220420,全国,全国,87,0,87
111,哈尔滨极地馆,20220421,全国,全国,148,59,89
112,哈尔滨极地馆,20220422,全国,全国,164,72,92
113,哈尔滨极地馆,20220423,全国,全国,152,59,93
114,哈尔滨极地馆,20220424,全国,全国,96,0,96
115,哈尔滨极地馆,20220425,全国,全国,146,63,83
116,哈尔滨极地馆,20220426,全国,全国,142,64,78
117,哈尔滨极地馆,20220427,全国,全国,156,59,97
118,哈尔滨极地馆,20220428,全国,全国,146,59,87
119,哈尔滨极地馆,20220429,全国,全国,146,59,87
120,哈尔滨极地馆,20220430,全国,全国,100,0,100
121,哈尔滨极地馆,20220501,全国,全国,150,61,89
122,哈尔滨极地馆,20220502,全国,全国,153,64,89
123,哈尔滨极地馆,20220503,全国,全国,141,59,82
124,哈尔滨极地馆,20220504,全国,全国,158,63,95
125,哈尔滨极地馆,20220505,全国,全国,161,68,93
126,哈尔滨极地馆,20220506,全国,全国,167,68,99
127,哈尔滨极地馆,20220507,全国,全国,171,66,105
128,哈尔滨极地馆,20220508,全国,全国,118,0,118
129,哈尔滨极地馆,20220509,全国,全国,168,68,100
130,哈尔滨极地馆,20220510,全国,全国,80,0,80
131,哈尔滨极地馆,20220511,全国,全国,152,63,89
132,哈尔滨极地馆,20220512,全国,全国,163,68,95
133,哈尔滨极地馆,20220513,全国,全国,160,63,97
134,哈尔滨极地馆,20220514,全国,全国,174,64,110
135,哈尔滨极地馆,20220515,全国,全国,168,59,109
136,哈尔滨极地馆,20220516,全国,全国,159,66,93
137,哈尔滨极地馆,20220517,全国,全国,148,61,87
138,哈尔滨极地馆,20220518,全国,全国,180,72,108
139,哈尔滨极地馆,20220519,全国,全国,181,66,115
140,哈尔滨极地馆,20220520,全国,全国,181,72,109
141,哈尔滨极地馆,20220521,全国,全国,193,59,134
142,哈尔滨极地馆,20220522,全国,全国,245,59,186
143,哈尔滨极地馆,20220523,全国,全国,202,61,141
144,哈尔滨极地馆,20220524,全国,全国,199,61,138
145,哈尔滨极地馆,20220525,全国,全国,222,74,148
146,哈尔滨极地馆,20220526,全国,全国,201,70,131
147,哈尔滨极地馆,20220527,全国,全国,214,63,151
148,哈尔滨极地馆,20220528,全国,全国,210,63,147
149,哈尔滨极地馆,20220529,全国,全国,216,59,157
150,哈尔滨极地馆,20220530,全国,全国,208,61,147
151,哈尔滨极地馆,20220531,全国,全国,231,61,170
152,哈尔滨极地馆,20220601,全国,全国,284,85,199
153,哈尔滨极地馆,20220602,全国,全国,289,74,215
154,哈尔滨极地馆,20220603,全国,全国,220,0,220
155,哈尔滨极地馆,20220604,全国,全国,269,80,189
156,哈尔滨极地馆,20220605,全国,全国,227,61,166
157,哈尔滨极地馆,20220606,全国,全国,211,72,139
158,哈尔滨极地馆,20220607,全国,全国,202,63,139
159,哈尔滨极地馆,20220608,全国,全国,205,64,141
160,哈尔滨极地馆,20220609,全国,全国,222,63,159
161,哈尔滨极地馆,20220610,全国,全国,243,64,179
162,哈尔滨极地馆,20220611,全国,全国,250,72,178
163,哈尔滨极地馆,20220612,全国,全国,178,0,178
164,哈尔滨极地馆,20220613,全国,全国,210,59,151
165,哈尔滨极地馆,20220614,全国,全国,221,66,155
166,哈尔滨极地馆,20220615,全国,全国,191,63,128
167,哈尔滨极地馆,20220616,全国,全国,221,76,145
168,哈尔滨极地馆,20220617,全国,全国,254,70,184
169,哈尔滨极地馆,20220618,全国,全国,248,63,185
170,哈尔滨极地馆,20220619,全国,全国,231,64,167
171,哈尔滨极地馆,20220620,全国,全国,198,63,135
172,哈尔滨极地馆,20220621,全国,全国,223,64,159
173,哈尔滨极地馆,20220622,全国,全国,216,61,155
174,哈尔滨极地馆,20220623,全国,全国,247,70,177
175,哈尔滨极地馆,20220624,全国,全国,255,76,179
176,哈尔滨极地馆,20220625,全国,全国,247,63,184
177,哈尔滨极地馆,20220626,全国,全国,256,64,192
178,哈尔滨极地馆,20220627,全国,全国,260,74,186
179,哈尔滨极地馆,20220628,全国,全国,279,70,209
180,哈尔滨极地馆,20220629,全国,全国,270,68,202
181,哈尔滨极地馆,20220630,全国,全国,294,70,224
182,哈尔滨极地馆,20220701,全国,全国,309,74,235
183,哈尔滨极地馆,20220702,全国,全国,320,63,257
184,哈尔滨极地馆,20220703,全国,全国,287,63,224
185,哈尔滨极地馆,20220704,全国,全国,279,68,211
186,哈尔滨极地馆,20220705,全国,全国,298,74,224
187,哈尔滨极地馆,20220706,全国,全国,333,72,261
188,哈尔滨极地馆,20220707,全国,全国,331,72,259
189,哈尔滨极地馆,20220708,全国,全国,332,80,252
190,哈尔滨极地馆,20220709,全国,全国,378,66,312
191,哈尔滨极地馆,20220710,全国,全国,385,61,324
192,哈尔滨极地馆,20220711,全国,全国,342,64,278
193,哈尔滨极地馆,20220712,全国,全国,379,85,294
194,哈尔滨极地馆,20220713,全国,全国,402,93,309
195,哈尔滨极地馆,20220714,全国,全国,433,82,351
196,哈尔滨极地馆,20220715,全国,全国,364,72,292
197,哈尔滨极地馆,20220716,全国,全国,350,76,274
198,哈尔滨极地馆,20220717,全国,全国,366,59,307
199,哈尔滨极地馆,20220718,全国,全国,342,72,270
200,哈尔滨极地馆,20220719,全国,全国,327,80,247
201,哈尔滨极地馆,20220720,全国,全国,380,91,289
202,哈尔滨极地馆,20220721,全国,全国,376,78,298
203,哈尔滨极地馆,20220722,全国,全国,428,83,345
204,哈尔滨极地馆,20220723,全国,全国,409,78,331
205,哈尔滨极地馆,20220724,全国,全国,366,59,307
206,哈尔滨极地馆,20220725,全国,全国,396,87,309
207,哈尔滨极地馆,20220726,全国,全国,429,87,342
208,哈尔滨极地馆,20220727,全国,全国,447,78,369
209,哈尔滨极地馆,20220728,全国,全国,441,83,358
210,哈尔滨极地馆,20220729,全国,全国,477,93,384
211,哈尔滨极地馆,20220730,全国,全国,459,68,391
212,哈尔滨极地馆,20220731,全国,全国,474,66,408
213,哈尔滨极地馆,20220801,全国,全国,472,70,402
214,哈尔滨极地馆,20220802,全国,全国,548,82,466
215,哈尔滨极地馆,20220803,全国,全国,507,87,420
216,哈尔滨极地馆,20220804,全国,全国,519,82,437
217,哈尔滨极地馆,20220805,全国,全国,519,99,420
218,哈尔滨极地馆,20220806,全国,全国,546,78,468
219,哈尔滨极地馆,20220807,全国,全国,510,64,446
220,哈尔滨极地馆,20220808,全国,全国,476,78,398
221,哈尔滨极地馆,20220809,全国,全国,292,64,228
222,哈尔滨极地馆,20220810,全国,全国,275,80,195
223,哈尔滨极地馆,20220811,全国,全国,272,64,208
224,哈尔滨极地馆,20220812,全国,全国,331,76,255
225,哈尔滨极地馆,20220813,全国,全国,285,63,222
226,哈尔滨极地馆,20220814,全国,全国,246,0,246
227,哈尔滨极地馆,20220815,全国,全国,307,66,241
228,哈尔滨极地馆,20220816,全国,全国,312,70,242
229,哈尔滨极地馆,20220817,全国,全国,320,74,246
230,哈尔滨极地馆,20220818,全国,全国,283,72,211
231,哈尔滨极地馆,20220819,全国,全国,291,80,211
232,哈尔滨极地馆,20220820,全国,全国,275,76,199
233,哈尔滨极地馆,20220821,全国,全国,208,59,149
234,哈尔滨极地馆,20220822,全国,全国,232,70,162
235,哈尔滨极地馆,20220823,全国,全国,208,64,144
236,哈尔滨极地馆,20220824,全国,全国,212,61,151
237,哈尔滨极地馆,20220825,全国,全国,208,63,145
238,哈尔滨极地馆,20220826,全国,全国,242,72,170
239,哈尔滨极地馆,20220827,全国,全国,240,74,166
240,哈尔滨极地馆,20220828,全国,全国,130,0,130
241,哈尔滨极地馆,20220829,全国,全国,158,59,99
242,哈尔滨极地馆,20220830,全国,全国,156,63,93
243,哈尔滨极地馆,20220831,全国,全国,165,63,102
244,哈尔滨极地馆,20220901,全国,全国,76,0,76
245,哈尔滨极地馆,20220902,全国,全国,155,64,91
246,哈尔滨极地馆,20220903,全国,全国,142,59,83
247,哈尔滨极地馆,20220904,全国,全国,163,63,100
248,哈尔滨极地馆,20220905,全国,全国,138,64,74
249,哈尔滨极地馆,20220906,全国,全国,146,63,83
250,哈尔滨极地馆,20220907,全国,全国,160,61,99
251,哈尔滨极地馆,20220908,全国,全国,158,63,95
252,哈尔滨极地馆,20220909,全国,全国,159,63,96
253,哈尔滨极地馆,20220910,全国,全国,117,0,117
254,哈尔滨极地馆,20220911,全国,全国,221,66,155
255,哈尔滨极地馆,20220912,全国,全国,204,61,143
256,哈尔滨极地馆,20220913,全国,全国,184,72,112
257,哈尔滨极地馆,20220914,全国,全国,187,66,121
258,哈尔滨极地馆,20220915,全国,全国,182,59,123
259,哈尔滨极地馆,20220916,全国,全国,215,68,147
260,哈尔滨极地馆,20220917,全国,全国,220,61,159
261,哈尔滨极地馆,20220918,全国,全国,123,0,123
262,哈尔滨极地馆,20220919,全国,全国,154,63,91
263,哈尔滨极地馆,20220920,全国,全国,177,64,113
264,哈尔滨极地馆,20220921,全国,全国,156,63,93
265,哈尔滨极地馆,20220922,全国,全国,169,64,105
266,哈尔滨极地馆,20220923,全国,全国,156,64,92
267,哈尔滨极地馆,20220924,全国,全国,102,0,102
268,哈尔滨极地馆,20220925,全国,全国,166,64,102
269,哈尔滨极地馆,20220926,全国,全国,145,61,84
270,哈尔滨极地馆,20220927,全国,全国,150,61,89
271,哈尔滨极地馆,20220928,全国,全国,165,70,95
272,哈尔滨极地馆,20220929,全国,全国,179,66,113
273,哈尔滨极地馆,20220930,全国,全国,184,66,118
274,哈尔滨极地馆,20221001,全国,全国,119,0,119
275,哈尔滨极地馆,20221002,全国,全国,202,63,139
276,哈尔滨极地馆,20221003,全国,全国,174,59,115
277,哈尔滨极地馆,20221004,全国,全国,169,63,106
278,哈尔滨极地馆,20221005,全国,全国,168,63,105
279,哈尔滨极地馆,20221006,全国,全国,168,63,105
280,哈尔滨极地馆,20221007,全国,全国,142,59,83
281,哈尔滨极地馆,20221008,全国,全国,169,64,105
282,哈尔滨极地馆,20221009,全国,全国,146,70,76
283,哈尔滨极地馆,20221010,全国,全国,148,61,87
284,哈尔滨极地馆,20221011,全国,全国,169,72,97
285,哈尔滨极地馆,20221012,全国,全国,170,74,96
286,哈尔滨极地馆,20221013,全国,全国,161,70,91
287,哈尔滨极地馆,20221014,全国,全国,173,63,110
288,哈尔滨极地馆,20221015,全国,全国,100,0,100
289,哈尔滨极地馆,20221016,全国,全国,117,0,117
290,哈尔滨极地馆,20221017,全国,全国,191,72,119
291,哈尔滨极地馆,20221018,全国,全国,151,59,92
292,哈尔滨极地馆,20221019,全国,全国,155,64,91
293,哈尔滨极地馆,20221020,全国,全国,178,68,110
294,哈尔滨极地馆,20221021,全国,全国,157,61,96
295,哈尔滨极地馆,20221022,全国,全国,108,0,108
296,哈尔滨极地馆,20221023,全国,全国,168,66,102
297,哈尔滨极地馆,20221024,全国,全国,157,68,89
298,哈尔滨极地馆,20221025,全国,全国,158,63,95
299,哈尔滨极地馆,20221026,全国,全国,183,74,109
300,哈尔滨极地馆,20221027,全国,全国,178,68,110
301,哈尔滨极地馆,20221028,全国,全国,160,64,96
302,哈尔滨极地馆,20221029,全国,全国,159,59,100
303,哈尔滨极地馆,20221030,全国,全国,89,0,89
304,哈尔滨极地馆,20221031,全国,全国,92,0,92
305,哈尔滨极地馆,20221101,全国,全国,180,61,119
306,哈尔滨极地馆,20221102,全国,全国,146,59,87
307,哈尔滨极地馆,20221103,全国,全国,141,59,82
308,哈尔滨极地馆,20221104,全国,全国,158,63,95
309,哈尔滨极地馆,20221105,全国,全国,82,0,82
310,哈尔滨极地馆,20221106,全国,全国,142,59,83
311,哈尔滨极地馆,20221107,全国,全国,149,66,83
312,哈尔滨极地馆,20221108,全国,全国,133,59,74
313,哈尔滨极地馆,20221109,全国,全国,143,64,79
314,哈尔滨极地馆,20221110,全国,全国,146,68,78
315,哈尔滨极地馆,20221111,全国,全国,87,0,87
316,哈尔滨极地馆,20221112,全国,全国,160,64,96
317,哈尔滨极地馆,20221113,全国,全国,96,0,96
318,哈尔滨极地馆,20221114,全国,全国,128,59,69
319,哈尔滨极地馆,20221115,全国,全国,143,61,82
320,哈尔滨极地馆,20221116,全国,全国,153,61,92
321,哈尔滨极地馆,20221117,全国,全国,155,63,92
322,哈尔滨极地馆,20221118,全国,全国,161,61,100
323,哈尔滨极地馆,20221119,全国,全国,182,78,104
324,哈尔滨极地馆,20221120,全国,全国,146,66,80
325,哈尔滨极地馆,20221121,全国,全国,158,63,95
326,哈尔滨极地馆,20221122,全国,全国,145,63,82
327,哈尔滨极地馆,20221123,全国,全国,143,61,82
328,哈尔滨极地馆,20221124,全国,全国,181,76,105
329,哈尔滨极地馆,20221125,全国,全国,138,68,70
330,哈尔滨极地馆,20221126,全国,全国,132,61,71
331,哈尔滨极地馆,20221127,全国,全国,80,0,80
332,哈尔滨极地馆,20221128,全国,全国,137,63,74
333,哈尔滨极地馆,20221129,全国,全国,139,59,80
334,哈尔滨极地馆,20221130,全国,全国,142,66,76
335,哈尔滨极地馆,20221201,全国,全国,84,0,84
336,哈尔滨极地馆,20221202,全国,全国,84,0,84
337,哈尔滨极地馆,20221203,全国,全国,82,0,82
338,哈尔滨极地馆,20221204,全国,全国,147,64,83
339,哈尔滨极地馆,20221205,全国,全国,143,63,80
340,哈尔滨极地馆,20221206,全国,全国,163,64,99
341,哈尔滨极地馆,20221207,全国,全国,95,0,95
342,哈尔滨极地馆,20221208,全国,全国,166,74,92
343,哈尔滨极地馆,20221209,全国,全国,161,61,100
344,哈尔滨极地馆,20221210,全国,全国,154,63,91
345,哈尔滨极地馆,20221211,全国,全国,152,66,86
346,哈尔滨极地馆,20221212,全国,全国,177,68,109
347,哈尔滨极地馆,20221213,全国,全国,92,0,92
348,哈尔滨极地馆,20221214,全国,全国,165,68,97
349,哈尔滨极地馆,20221215,全国,全国,143,59,84
350,哈尔滨极地馆,20221216,全国,全国,171,59,112
351,哈尔滨极地馆,20221217,全国,全国,175,66,109
352,哈尔滨极地馆,20221218,全国,全国,91,0,91
353,哈尔滨极地馆,20221219,全国,全国,146,59,87
354,哈尔滨极地馆,20221220,全国,全国,150,68,82
355,哈尔滨极地馆,20221221,全国,全国,157,64,93
356,哈尔滨极地馆,20221222,全国,全国,141,61,80
357,哈尔滨极地馆,20221223,全国,全国,159,63,96
358,哈尔滨极地馆,20221224,全国,全国,160,61,99
359,哈尔滨极地馆,20221225,全国,全国,161,61,100
360,哈尔滨极地馆,20221226,全国,全国,163,66,97
361,哈尔滨极地馆,20221227,全国,全国,148,66,82
362,哈尔滨极地馆,20221228,全国,全国,166,64,102
363,哈尔滨极地馆,20221229,全国,全国,176,66,110
364,哈尔滨极地馆,20221230,全国,全国,175,66,109
365,哈尔滨极地馆,20221231,全国,全国,199,61,138
366,哈尔滨极地馆,20230101,全国,全国,199,63,136
367,哈尔滨极地馆,20230102,全国,全国,218,63,155
368,哈尔滨极地馆,20230103,全国,全国,218,63,155
369,哈尔滨极地馆,20230104,全国,全国,210,78,132
370,哈尔滨极地馆,20230105,全国,全国,233,66,167
371,哈尔滨极地馆,20230106,全国,全国,356,101,255
372,哈尔滨极地馆,20230107,全国,全国,300,76,224
373,哈尔滨极地馆,20230108,全国,全国,301,70,231
374,哈尔滨极地馆,20230109,全国,全国,287,89,198
375,哈尔滨极地馆,20230110,全国,全国,305,76,229
376,哈尔滨极地馆,20230111,全国,全国,311,68,243
377,哈尔滨极地馆,20230112,全国,全国,335,99,236
378,哈尔滨极地馆,20230113,全国,全国,294,70,224
379,哈尔滨极地馆,20230114,全国,全国,325,66,259
380,哈尔滨极地馆,20230115,全国,全国,319,59,260
381,哈尔滨极地馆,20230116,全国,全国,349,87,262
382,哈尔滨极地馆,20230117,全国,全国,321,82,239
383,哈尔滨极地馆,20230118,全国,全国,295,80,215
384,哈尔滨极地馆,20230119,全国,全国,278,76,202
385,哈尔滨极地馆,20230120,全国,全国,260,64,196
386,哈尔滨极地馆,20230121,全国,全国,236,66,170
387,哈尔滨极地馆,20230122,全国,全国,395,64,331
388,哈尔滨极地馆,20230123,全国,全国,402,64,338
389,哈尔滨极地馆,20230124,全国,全国,438,61,377
390,哈尔滨极地馆,20230125,全国,全国,397,70,327
391,哈尔滨极地馆,20230126,全国,全国,451,63,388
392,哈尔滨极地馆,20230127,全国,全国,366,70,296
393,哈尔滨极地馆,20230128,全国,全国,416,70,346
394,哈尔滨极地馆,20230129,全国,全国,371,91,280
395,哈尔滨极地馆,20230130,全国,全国,342,74,268
396,哈尔滨极地馆,20230131,全国,全国,325,80,245
397,哈尔滨极地馆,20230201,全国,全国,360,87,273
398,哈尔滨极地馆,20230202,全国,全国,321,72,249
399,哈尔滨极地馆,20230203,全国,全国,372,76,296
400,哈尔滨极地馆,20230204,全国,全国,340,74,266
401,哈尔滨极地馆,20230205,全国,全国,260,59,201
402,哈尔滨极地馆,20230206,全国,全国,324,85,239
403,哈尔滨极地馆,20230207,全国,全国,317,83,234
404,哈尔滨极地馆,20230208,全国,全国,288,70,218
405,哈尔滨极地馆,20230209,全国,全国,365,80,285
406,哈尔滨极地馆,20230210,全国,全国,365,66,299
407,哈尔滨极地馆,20230211,全国,全国,319,70,249
408,哈尔滨极地馆,20230212,全国,全国,329,59,270
409,哈尔滨极地馆,20230213,全国,全国,309,70,239
410,哈尔滨极地馆,20230214,全国,全国,264,63,201
411,哈尔滨极地馆,20230215,全国,全国,282,63,219
412,哈尔滨极地馆,20230216,全国,全国,310,72,238
413,哈尔滨极地馆,20230217,全国,全国,335,85,250
414,哈尔滨极地馆,20230218,全国,全国,274,66,208
415,哈尔滨极地馆,20230219,全国,全国,201,0,201
416,哈尔滨极地馆,20230220,全国,全国,263,78,185
417,哈尔滨极地馆,20230221,全国,全国,230,66,164
418,哈尔滨极地馆,20230222,全国,全国,228,66,162
419,哈尔滨极地馆,20230223,全国,全国,237,70,167
420,哈尔滨极地馆,20230224,全国,全国,252,66,186
421,哈尔滨极地馆,20230225,全国,全国,241,68,173
422,哈尔滨极地馆,20230226,全国,全国,238,64,174
423,哈尔滨极地馆,20230227,全国,全国,205,66,139
424,哈尔滨极地馆,20230228,全国,全国,220,63,157
425,哈尔滨极地馆,20230301,全国,全国,233,70,163
426,哈尔滨极地馆,20230302,全国,全国,202,66,136
427,哈尔滨极地馆,20230303,全国,全国,243,76,167
428,哈尔滨极地馆,20230304,全国,全国,282,63,219
429,哈尔滨极地馆,20230305,全国,全国,232,59,173
430,哈尔滨极地馆,20230306,全国,全国,230,68,162
431,哈尔滨极地馆,20230307,全国,全国,221,74,147
432,哈尔滨极地馆,20230308,全国,全国,200,66,134
433,哈尔滨极地馆,20230309,全国,全国,206,61,145
434,哈尔滨极地馆,20230310,全国,全国,223,63,160
435,哈尔滨极地馆,20230311,全国,全国,158,0,158
436,哈尔滨极地馆,20230312,全国,全国,231,61,170
437,哈尔滨极地馆,20230313,全国,全国,234,68,166
438,哈尔滨极地馆,20230314,全国,全国,155,0,155
439,哈尔滨极地馆,20230315,全国,全国,242,72,170
440,哈尔滨极地馆,20230316,全国,全国,227,64,163
441,哈尔滨极地馆,20230317,全国,全国,256,66,190
442,哈尔滨极地馆,20230318,全国,全国,270,64,206
443,哈尔滨极地馆,20230319,全国,全国,249,72,177
444,哈尔滨极地馆,20230320,全国,全国,239,68,171
445,哈尔滨极地馆,20230321,全国,全国,236,66,170
446,哈尔滨极地馆,20230322,全国,全国,231,64,167
447,哈尔滨极地馆,20230323,全国,全国,246,78,168
448,哈尔滨极地馆,20230324,全国,全国,270,68,202
449,哈尔滨极地馆,20230325,全国,全国,276,64,212
450,哈尔滨极地馆,20230326,全国,全国,237,63,174
451,哈尔滨极地馆,20230327,全国,全国,251,72,179
452,哈尔滨极地馆,20230328,全国,全国,232,72,160
453,哈尔滨极地馆,20230329,全国,全国,250,74,176
454,哈尔滨极地馆,20230330,全国,全国,238,68,170
455,哈尔滨极地馆,20230331,全国,全国,273,78,195
456,哈尔滨极地馆,20230401,全国,全国,192,0,192
457,哈尔滨极地馆,20230402,全国,全国,236,66,170
458,哈尔滨极地馆,20230403,全国,全国,227,64,163
459,哈尔滨极地馆,20230404,全国,全国,276,76,200
460,哈尔滨极地馆,20230405,全国,全国,198,0,198
461,哈尔滨极地馆,20230406,全国,全国,239,66,173
462,哈尔滨极地馆,20230407,全国,全国,246,68,178
463,哈尔滨极地馆,20230408,全国,全国,277,63,214
464,哈尔滨极地馆,20230409,全国,全国,272,74,198
465,哈尔滨极地馆,20230410,全国,全国,243,70,173
466,哈尔滨极地馆,20230411,全国,全国,240,76,164
467,哈尔滨极地馆,20230412,全国,全国,243,85,158
468,哈尔滨极地馆,20230413,全国,全国,291,83,208
469,哈尔滨极地馆,20230414,全国,全国,286,72,214
470,哈尔滨极地馆,20230415,全国,全国,276,64,212
471,哈尔滨极地馆,20230416,全国,全国,297,70,227
472,哈尔滨极地馆,20230417,全国,全国,277,87,190
473,哈尔滨极地馆,20230418,全国,全国,299,82,217
474,哈尔滨极地馆,20230419,全国,全国,285,76,209
475,哈尔滨极地馆,20230420,全国,全国,347,108,239
476,哈尔滨极地馆,20230421,全国,全国,351,85,266
477,哈尔滨极地馆,20230422,全国,全国,339,68,271
478,哈尔滨极地馆,20230423,全国,全国,378,101,277
479,哈尔滨极地馆,20230424,全国,全国,337,82,255
480,哈尔滨极地馆,20230425,全国,全国,362,101,261
481,哈尔滨极地馆,20230426,全国,全国,399,91,308
482,哈尔滨极地馆,20230427,全国,全国,502,121,381
483,哈尔滨极地馆,20230428,全国,全国,614,93,521
484,哈尔滨极地馆,20230429,全国,全国,806,80,726
485,哈尔滨极地馆,20230430,全国,全国,900,82,818
486,哈尔滨极地馆,20230501,全国,全国,640,70,570
487,哈尔滨极地馆,20230502,全国,全国,484,64,420
488,哈尔滨极地馆,20230503,全国,全国,338,64,274
489,哈尔滨极地馆,20230504,全国,全国,223,68,155
490,哈尔滨极地馆,20230505,全国,全国,267,72,195
491,哈尔滨极地馆,20230506,全国,全国,245,85,160
492,哈尔滨极地馆,20230507,全国,全国,243,59,184
493,哈尔滨极地馆,20230508,全国,全国,224,66,158
494,哈尔滨极地馆,20230509,全国,全国,216,64,152
495,哈尔滨极地馆,20230510,全国,全国,227,66,161
496,哈尔滨极地馆,20230511,全国,全国,229,68,161
497,哈尔滨极地馆,20230512,全国,全国,271,82,189
498,哈尔滨极地馆,20230513,全国,全国,238,64,174
499,哈尔滨极地馆,20230514,全国,全国,211,64,147
500,哈尔滨极地馆,20230515,全国,全国,229,64,165
501,哈尔滨极地馆,20230516,全国,全国,211,64,147
502,哈尔滨极地馆,20230517,全国,全国,241,74,167
503,哈尔滨极地馆,20230518,全国,全国,246,80,166
504,哈尔滨极地馆,20230519,全国,全国,223,64,159
505,哈尔滨极地馆,20230520,全国,全国,231,63,168
506,哈尔滨极地馆,20230521,全国,全国,228,63,165
507,哈尔滨极地馆,20230522,全国,全国,225,70,155
508,哈尔滨极地馆,20230523,全国,全国,213,59,154
509,哈尔滨极地馆,20230524,全国,全国,215,74,141
510,哈尔滨极地馆,20230525,全国,全国,241,61,180
511,哈尔滨极地馆,20230526,全国,全国,220,59,161
512,哈尔滨极地馆,20230527,全国,全国,221,63,158
513,哈尔滨极地馆,20230528,全国,全国,214,63,151
514,哈尔滨极地馆,20230529,全国,全国,230,66,164
515,哈尔滨极地馆,20230530,全国,全国,244,70,174
516,哈尔滨极地馆,20230531,全国,全国,253,76,177
517,哈尔滨极地馆,20230601,全国,全国,271,68,203
518,哈尔滨极地馆,20230602,全国,全国,244,66,178
519,哈尔滨极地馆,20230603,全国,全国,183,0,183
520,哈尔滨极地馆,20230604,全国,全国,159,0,159
521,哈尔滨极地馆,20230605,全国,全国,263,76,187
522,哈尔滨极地馆,20230606,全国,全国,243,70,173
523,哈尔滨极地馆,20230607,全国,全国,238,68,170
524,哈尔滨极地馆,20230608,全国,全国,233,68,165
525,哈尔滨极地馆,20230609,全国,全国,219,64,155
526,哈尔滨极地馆,20230610,全国,全国,243,59,184
527,哈尔滨极地馆,20230611,全国,全国,255,66,189
528,哈尔滨极地馆,20230612,全国,全国,236,78,158
529,哈尔滨极地馆,20230613,全国,全国,252,74,178
530,哈尔滨极地馆,20230614,全国,全国,259,70,189
531,哈尔滨极地馆,20230615,全国,全国,231,72,159
532,哈尔滨极地馆,20230616,全国,全国,250,80,170
533,哈尔滨极地馆,20230617,全国,全国,256,64,192
534,哈尔滨极地馆,20230618,全国,全国,263,64,199
535,哈尔滨极地馆,20230619,全国,全国,278,80,198
536,哈尔滨极地馆,20230620,全国,全国,307,78,229
537,哈尔滨极地馆,20230621,全国,全国,310,76,234
538,哈尔滨极地馆,20230622,全国,全国,325,70,255
539,哈尔滨极地馆,20230623,全国,全国,297,66,231
540,哈尔滨极地馆,20230624,全国,全国,271,63,208
541,哈尔滨极地馆,20230625,全国,全国,298,80,218
542,哈尔滨极地馆,20230626,全国,全国,263,76,187
543,哈尔滨极地馆,20230627,全国,全国,275,82,193
544,哈尔滨极地馆,20230628,全国,全国,289,70,219
545,哈尔滨极地馆,20230629,全国,全国,292,74,218
546,哈尔滨极地馆,20230630,全国,全国,301,82,219
547,哈尔滨极地馆,20230701,全国,全国,290,72,218
548,哈尔滨极地馆,20230702,全国,全国,267,59,208
549,哈尔滨极地馆,20230703,全国,全国,294,80,214
550,哈尔滨极地馆,20230704,全国,全国,286,80,206
551,哈尔滨极地馆,20230705,全国,全国,355,89,266
552,哈尔滨极地馆,20230706,全国,全国,300,72,228
553,哈尔滨极地馆,20230707,全国,全国,327,74,253
554,哈尔滨极地馆,20230708,全国,全国,340,72,268
555,哈尔滨极地馆,20230709,全国,全国,319,64,255
556,哈尔滨极地馆,20230710,全国,全国,354,95,259
557,哈尔滨极地馆,20230711,全国,全国,372,85,287
558,哈尔滨极地馆,20230712,全国,全国,335,83,252
559,哈尔滨极地馆,20230713,全国,全国,362,70,292
560,哈尔滨极地馆,20230714,全国,全国,370,70,300
561,哈尔滨极地馆,20230715,全国,全国,394,66,328
562,哈尔滨极地馆,20230716,全国,全国,351,66,285
563,哈尔滨极地馆,20230717,全国,全国,383,80,303
564,哈尔滨极地馆,20230718,全国,全国,427,108,319
565,哈尔滨极地馆,20230719,全国,全国,373,74,299
566,哈尔滨极地馆,20230720,全国,全国,373,85,288
567,哈尔滨极地馆,20230721,全国,全国,401,78,323
568,哈尔滨极地馆,20230722,全国,全国,412,66,346
569,哈尔滨极地馆,20230723,全国,全国,417,66,351
570,哈尔滨极地馆,20230724,全国,全国,447,82,365
571,哈尔滨极地馆,20230725,全国,全国,449,80,369
572,哈尔滨极地馆,20230726,全国,全国,472,82,390
573,哈尔滨极地馆,20230727,全国,全国,436,80,356
574,哈尔滨极地馆,20230728,全国,全国,445,76,369
575,哈尔滨极地馆,20230729,全国,全国,488,66,422
576,哈尔滨极地馆,20230730,全国,全国,513,66,447
577,哈尔滨极地馆,20230731,全国,全国,515,89,426
578,哈尔滨极地馆,20230801,全国,全国,507,85,422
579,哈尔滨极地馆,20230802,全国,全国,439,74,365
580,哈尔滨极地馆,20230803,全国,全国,435,97,338
581,哈尔滨极地馆,20230804,全国,全国,389,74,315
582,哈尔滨极地馆,20230805,全国,全国,387,63,324
583,哈尔滨极地馆,20230806,全国,全国,378,66,312
584,哈尔滨极地馆,20230807,全国,全国,412,74,338
585,哈尔滨极地馆,20230808,全国,全国,355,82,273
586,哈尔滨极地馆,20230809,全国,全国,364,72,292
587,哈尔滨极地馆,20230810,全国,全国,326,72,254
588,哈尔滨极地馆,20230811,全国,全国,351,78,273
589,哈尔滨极地馆,20230812,全国,全国,354,66,288
590,哈尔滨极地馆,20230813,全国,全国,353,59,294
591,哈尔滨极地馆,20230814,全国,全国,380,78,302
592,哈尔滨极地馆,20230815,全国,全国,402,76,326
593,哈尔滨极地馆,20230816,全国,全国,386,74,312
594,哈尔滨极地馆,20230817,全国,全国,386,72,314
595,哈尔滨极地馆,20230818,全国,全国,401,85,316
596,哈尔滨极地馆,20230819,全国,全国,362,68,294
597,哈尔滨极地馆,20230820,全国,全国,330,59,271
598,哈尔滨极地馆,20230821,全国,全国,331,74,257
599,哈尔滨极地馆,20230822,全国,全国,290,70,220
600,哈尔滨极地馆,20230823,全国,全国,287,63,224
601,哈尔滨极地馆,20230824,全国,全国,300,66,234
602,哈尔滨极地馆,20230825,全国,全国,279,64,215
603,哈尔滨极地馆,20230826,全国,全国,293,59,234
604,哈尔滨极地馆,20230827,全国,全国,197,0,197
605,哈尔滨极地馆,20230828,全国,全国,243,59,184
606,哈尔滨极地馆,20230829,全国,全国,295,78,217
607,哈尔滨极地馆,20230830,全国,全国,237,63,174
608,哈尔滨极地馆,20230831,全国,全国,214,59,155
609,哈尔滨极地馆,20230901,全国,全国,232,72,160
610,哈尔滨极地馆,20230902,全国,全国,258,61,197
611,哈尔滨极地馆,20230903,全国,全国,224,61,163
612,哈尔滨极地馆,20230904,全国,全国,222,68,154
613,哈尔滨极地馆,20230905,全国,全国,199,64,135
614,哈尔滨极地馆,20230906,全国,全国,213,66,147
615,哈尔滨极地馆,20230907,全国,全国,219,70,149
616,哈尔滨极地馆,20230908,全国,全国,223,61,162
617,哈尔滨极地馆,20230909,全国,全国,243,59,184
618,哈尔滨极地馆,20230910,全国,全国,236,70,166
619,哈尔滨极地馆,20230911,全国,全国,207,66,141
620,哈尔滨极地馆,20230912,全国,全国,238,68,170
621,哈尔滨极地馆,20230913,全国,全国,219,64,155
622,哈尔滨极地馆,20230914,全国,全国,241,82,159
623,哈尔滨极地馆,20230915,全国,全国,249,76,173
624,哈尔滨极地馆,20230916,全国,全国,226,63,163
625,哈尔滨极地馆,20230917,全国,全国,243,59,184
626,哈尔滨极地馆,20230918,全国,全国,227,66,161
627,哈尔滨极地馆,20230919,全国,全国,216,82,134
628,哈尔滨极地馆,20230920,全国,全国,238,70,168
629,哈尔滨极地馆,20230921,全国,全国,184,78,106
630,哈尔滨极地馆,20230922,全国,全国,198,68,130
631,哈尔滨极地馆,20230923,全国,全国,217,59,158
632,哈尔滨极地馆,20230924,全国,全国,227,63,164
633,哈尔滨极地馆,20230925,全国,全国,229,72,157
634,哈尔滨极地馆,20230926,全国,全国,240,72,168
635,哈尔滨极地馆,20230927,全国,全国,265,68,197
636,哈尔滨极地馆,20230928,全国,全国,272,74,198
637,哈尔滨极地馆,20230929,全国,全国,371,61,310
638,哈尔滨极地馆,20230930,全国,全国,438,59,379
639,哈尔滨极地馆,20231001,全国,全国,397,63,334
640,哈尔滨极地馆,20231002,全国,全国,331,0,331
641,哈尔滨极地馆,20231003,全国,全国,359,59,300
642,哈尔滨极地馆,20231004,全国,全国,331,72,259
643,哈尔滨极地馆,20231005,全国,全国,206,0,206
644,哈尔滨极地馆,20231006,全国,全国,254,61,193
645,哈尔滨极地馆,20231007,全国,全国,189,68,121
646,哈尔滨极地馆,20231008,全国,全国,176,66,110
647,哈尔滨极地馆,20231009,全国,全国,185,66,119
648,哈尔滨极地馆,20231010,全国,全国,199,78,121
649,哈尔滨极地馆,20231011,全国,全国,179,64,115
650,哈尔滨极地馆,20231012,全国,全国,193,68,125
651,哈尔滨极地馆,20231013,全国,全国,185,72,113
652,哈尔滨极地馆,20231014,全国,全国,197,63,134
653,哈尔滨极地馆,20231015,全国,全国,207,63,144
654,哈尔滨极地馆,20231016,全国,全国,171,63,108
655,哈尔滨极地馆,20231017,全国,全国,199,93,106
656,哈尔滨极地馆,20231018,全国,全国,173,68,105
657,哈尔滨极地馆,20231019,全国,全国,201,80,121
658,哈尔滨极地馆,20231020,全国,全国,176,70,106
659,哈尔滨极地馆,20231021,全国,全国,181,63,118
660,哈尔滨极地馆,20231022,全国,全国,164,64,100
661,哈尔滨极地馆,20231023,全国,全国,183,78,105
662,哈尔滨极地馆,20231024,全国,全国,180,72,108
663,哈尔滨极地馆,20231025,全国,全国,181,66,115
664,哈尔滨极地馆,20231026,全国,全国,170,68,102
665,哈尔滨极地馆,20231027,全国,全国,184,82,102
666,哈尔滨极地馆,20231028,全国,全国,161,66,95
667,哈尔滨极地馆,20231029,全国,全国,164,64,100
668,哈尔滨极地馆,20231030,全国,全国,161,72,89
669,哈尔滨极地馆,20231031,全国,全国,162,70,92
670,哈尔滨极地馆,20231101,全国,全国,182,74,108
671,哈尔滨极地馆,20231102,全国,全国,157,68,89
672,哈尔滨极地馆,20231103,全国,全国,195,76,119
673,哈尔滨极地馆,20231104,全国,全国,178,70,108
674,哈尔滨极地馆,20231105,全国,全国,143,61,82
675,哈尔滨极地馆,20231106,全国,全国,187,91,96
676,哈尔滨极地馆,20231107,全国,全国,169,64,105
677,哈尔滨极地馆,20231108,全国,全国,168,82,86
678,哈尔滨极地馆,20231109,全国,全国,175,83,92
679,哈尔滨极地馆,20231110,全国,全国,180,78,102
680,哈尔滨极地馆,20231111,全国,全国,182,76,106
681,哈尔滨极地馆,20231112,全国,全国,161,68,93
682,哈尔滨极地馆,20231113,全国,全国,199,80,119
683,哈尔滨极地馆,20231114,全国,全国,190,78,112
684,哈尔滨极地馆,20231115,全国,全国,183,87,96
685,哈尔滨极地馆,20231116,全国,全国,172,68,104
686,哈尔滨极地馆,20231117,全国,全国,175,76,99
687,哈尔滨极地馆,20231118,全国,全国,167,63,104
688,哈尔滨极地馆,20231119,全国,全国,187,66,121
689,哈尔滨极地馆,20231120,全国,全国,165,68,97
690,哈尔滨极地馆,20231121,全国,全国,198,89,109
691,哈尔滨极地馆,20231122,全国,全国,185,76,109
692,哈尔滨极地馆,20231123,全国,全国,219,97,122
693,哈尔滨极地馆,20231124,全国,全国,216,68,148
694,哈尔滨极地馆,20231125,全国,全国,196,70,126
695,哈尔滨极地馆,20231126,全国,全国,218,74,144
696,哈尔滨极地馆,20231127,全国,全国,191,74,117
697,哈尔滨极地馆,20231128,全国,全国,205,87,118
698,哈尔滨极地馆,20231129,全国,全国,182,80,102
699,哈尔滨极地馆,20231130,全国,全国,205,83,122
700,哈尔滨极地馆,20231201,全国,全国,191,74,117
701,哈尔滨极地馆,20231202,全国,全国,195,63,132
702,哈尔滨极地馆,20231203,全国,全国,191,70,121
703,哈尔滨极地馆,20231204,全国,全国,193,80,113
704,哈尔滨极地馆,20231205,全国,全国,225,78,147
705,哈尔滨极地馆,20231206,全国,全国,195,82,113
706,哈尔滨极地馆,20231207,全国,全国,213,95,118
707,哈尔滨极地馆,20231208,全国,全国,185,85,100
708,哈尔滨极地馆,20231209,全国,全国,194,68,126
709,哈尔滨极地馆,20231210,全国,全国,187,64,123
710,哈尔滨极地馆,20231211,全国,全国,201,91,110
711,哈尔滨极地馆,20231212,全国,全国,167,80,87
712,哈尔滨极地馆,20231213,全国,全国,191,82,109
713,哈尔滨极地馆,20231214,全国,全国,190,72,118
714,哈尔滨极地馆,20231215,全国,全国,226,78,148
715,哈尔滨极地馆,20231216,全国,全国,208,72,136
716,哈尔滨极地馆,20231217,全国,全国,237,80,157
717,哈尔滨极地馆,20231218,全国,全国,280,118,162
718,哈尔滨极地馆,20231219,全国,全国,212,78,134
719,哈尔滨极地馆,20231220,全国,全国,214,78,136
720,哈尔滨极地馆,20231221,全国,全国,231,83,148
721,哈尔滨极地馆,20231222,全国,全国,215,72,143
722,哈尔滨极地馆,20231223,全国,全国,200,66,134
723,哈尔滨极地馆,20231224,全国,全国,191,63,128
724,哈尔滨极地馆,20231225,全国,全国,221,89,132
725,哈尔滨极地馆,20231226,全国,全国,248,78,170
726,哈尔滨极地馆,20231227,全国,全国,217,72,145
727,哈尔滨极地馆,20231228,全国,全国,231,83,148
728,哈尔滨极地馆,20231229,全国,全国,227,91,136
729,哈尔滨极地馆,20231230,全国,全国,238,64,174
730,哈尔滨极地馆,20231231,全国,全国,219,64,155
731,哈尔滨极地馆,20240101,全国,全国,214,70,144
732,哈尔滨极地馆,20240102,全国,全国,229,99,130
733,哈尔滨极地馆,20240103,全国,全国,309,116,193
734,哈尔滨极地馆,20240104,全国,全国,312,129,183
735,哈尔滨极地馆,20240105,全国,全国,287,101,186
736,哈尔滨极地馆,20240106,全国,全国,336,97,239
737,哈尔滨极地馆,20240107,全国,全国,291,83,208
738,哈尔滨极地馆,20240108,全国,全国,306,127,179
739,哈尔滨极地馆,20240109,全国,全国,275,101,174
740,哈尔滨极地馆,20240110,全国,全国,274,120,154
741,哈尔滨极地馆,20240111,全国,全国,251,97,154
742,哈尔滨极地馆,20240112,全国,全国,271,95,176
743,哈尔滨极地馆,20240113,全国,全国,231,70,161
744,哈尔滨极地馆,20240114,全国,全国,257,70,187
745,哈尔滨极地馆,20240115,全国,全国,242,85,157
746,哈尔滨极地馆,20240116,全国,全国,232,83,149
747,哈尔滨极地馆,20240117,全国,全国,267,97,170
748,哈尔滨极地馆,20240118,全国,全国,238,70,168
749,哈尔滨极地馆,20240119,全国,全国,240,89,151
750,哈尔滨极地馆,20240120,全国,全国,244,85,159
751,哈尔滨极地馆,20240121,全国,全国,250,70,180
752,哈尔滨极地馆,20240122,全国,全国,244,95,149
753,哈尔滨极地馆,20240123,全国,全国,258,91,167
754,哈尔滨极地馆,20240124,全国,全国,231,76,155
755,哈尔滨极地馆,20240125,全国,全国,259,85,174
756,哈尔滨极地馆,20240126,全国,全国,240,85,155
757,哈尔滨极地馆,20240127,全国,全国,229,74,155
758,哈尔滨极地馆,20240128,全国,全国,232,68,164
759,哈尔滨极地馆,20240129,全国,全国,232,70,162
760,哈尔滨极地馆,20240130,全国,全国,260,87,173
761,哈尔滨极地馆,20240131,全国,全国,237,72,165
762,哈尔滨极地馆,20240201,全国,全国,232,78,154
763,哈尔滨极地馆,20240202,全国,全国,206,70,136
764,哈尔滨极地馆,20240203,全国,全国,240,66,174
765,哈尔滨极地馆,20240204,全国,全国,250,82,168
766,哈尔滨极地馆,20240205,全国,全国,236,74,162
767,哈尔滨极地馆,20240206,全国,全国,215,63,152
768,哈尔滨极地馆,20240207,全国,全国,202,80,122
769,哈尔滨极地馆,20240208,全国,全国,198,64,134
770,哈尔滨极地馆,20240209,全国,全国,189,70,119
771,哈尔滨极地馆,20240210,全国,全国,164,0,164
772,哈尔滨极地馆,20240211,全国,全国,263,63,200
773,哈尔滨极地馆,20240212,全国,全国,265,61,204
774,哈尔滨极地馆,20240213,全国,全国,307,76,231
775,哈尔滨极地馆,20240214,全国,全国,308,61,247
776,哈尔滨极地馆,20240215,全国,全国,290,59,231
777,哈尔滨极地馆,20240216,全国,全国,266,64,202
778,哈尔滨极地馆,20240217,全国,全国,269,61,208
779,哈尔滨极地馆,20240218,全国,全国,241,70,171
780,哈尔滨极地馆,20240219,全国,全国,211,59,152
781,哈尔滨极地馆,20240220,全国,全国,229,68,161
782,哈尔滨极地馆,20240221,全国,全国,207,68,139
783,哈尔滨极地馆,20240222,全国,全国,191,66,125
784,哈尔滨极地馆,20240223,全国,全国,176,61,115
785,哈尔滨极地馆,20240224,全国,全国,178,61,117
786,哈尔滨极地馆,20240225,全国,全国,181,59,122
787,哈尔滨极地馆,20240226,全国,全国,171,63,108
788,哈尔滨极地馆,20240227,全国,全国,186,76,110
789,哈尔滨极地馆,20240228,全国,全国,197,63,134
790,哈尔滨极地馆,20240229,全国,全国,167,59,108
791,哈尔滨极地馆,20240301,全国,全国,184,76,108
792,哈尔滨极地馆,20240302,全国,全国,118,0,118
793,哈尔滨极地馆,20240303,全国,全国,102,0,102
794,哈尔滨极地馆,20240304,全国,全国,159,64,95
795,哈尔滨极地馆,20240305,全国,全国,158,66,92
796,哈尔滨极地馆,20240306,全国,全国,145,63,82
797,哈尔滨极地馆,20240307,全国,全国,162,63,99
798,哈尔滨极地馆,20240308,全国,全国,157,66,91
799,哈尔滨极地馆,20240309,全国,全国,169,64,105
800,哈尔滨极地馆,20240310,全国,全国,93,0,93
801,哈尔滨极地馆,20240311,全国,全国,172,68,104
802,哈尔滨极地馆,20240312,全国,全国,165,61,104
803,哈尔滨极地馆,20240313,全国,全国,160,63,97
804,哈尔滨极地馆,20240314,全国,全国,179,70,109
805,哈尔滨极地馆,20240315,全国,全国,207,66,141
806,哈尔滨极地馆,20240316,全国,全国,178,61,117
807,哈尔滨极地馆,20240317,全国,全国,115,0,115
808,哈尔滨极地馆,20240318,全国,全国,172,70,102
809,哈尔滨极地馆,20240319,全国,全国,96,0,96
810,哈尔滨极地馆,20240320,全国,全国,100,0,100
811,哈尔滨极地馆,20240321,全国,全国,176,61,115
812,哈尔滨极地馆,20240322,全国,全国,195,78,117
813,哈尔滨极地馆,20240323,全国,全国,169,61,108
814,哈尔滨极地馆,20240324,全国,全国,183,64,119
815,哈尔滨极地馆,20240325,全国,全国,151,64,87
816,哈尔滨极地馆,20240326,全国,全国,169,63,106
817,哈尔滨极地馆,20240327,全国,全国,172,66,106
818,哈尔滨极地馆,20240328,全国,全国,167,68,99
819,哈尔滨极地馆,20240329,全国,全国,172,68,104
820,哈尔滨极地馆,20240330,全国,全国,176,61,115
821,哈尔滨极地馆,20240331,全国,全国,208,63,145
822,哈尔滨极地馆,20240401,全国,全国,187,68,119
823,哈尔滨极地馆,20240402,全国,全国,191,70,121
824,哈尔滨极地馆,20240403,全国,全国,277,82,195
825,哈尔滨极地馆,20240404,全国,全国,282,68,214
826,哈尔滨极地馆,20240405,全国,全国,250,61,189
827,哈尔滨极地馆,20240406,全国,全国,179,61,118
828,哈尔滨极地馆,20240407,全国,全国,179,64,115
829,哈尔滨极地馆,20240408,全国,全国,159,72,87
830,哈尔滨极地馆,20240409,全国,全国,189,63,126
831,哈尔滨极地馆,20240410,全国,全国,172,63,109
832,哈尔滨极地馆,20240411,全国,全国,178,70,108
833,哈尔滨极地馆,20240412,全国,全国,184,78,106
834,哈尔滨极地馆,20240413,全国,全国,154,57,97
835,哈尔滨极地馆,20240414,全国,全国,191,59,132
836,哈尔滨极地馆,20240415,全国,全国,187,66,121
837,哈尔滨极地馆,20240416,全国,全国,184,76,108
838,哈尔滨极地馆,20240417,全国,全国,211,64,147
839,哈尔滨极地馆,20240418,全国,全国,184,74,110
840,哈尔滨极地馆,20240419,全国,全国,198,70,128
841,哈尔滨极地馆,20240420,全国,全国,189,59,130
842,哈尔滨极地馆,20240421,全国,全国,198,64,134
843,哈尔滨极地馆,20240422,全国,全国,200,70,130
844,哈尔滨极地馆,20240423,全国,全国,205,74,131
845,哈尔滨极地馆,20240424,全国,全国,194,72,122
846,哈尔滨极地馆,20240425,全国,全国,217,68,149
847,哈尔滨极地馆,20240426,全国,全国,228,80,148
848,哈尔滨极地馆,20240427,全国,全国,216,64,152
849,哈尔滨极地馆,20240428,全国,全国,257,91,166
850,哈尔滨极地馆,20240429,全国,全国,254,72,182
851,哈尔滨极地馆,20240430,全国,全国,330,78,252
1,东北虎林园,20220101,全国,全国,145,63,82
2,东北虎林园,20220102,全国,全国,160,63,97
3,东北虎林园,20220103,全国,全国,168,63,105
4,东北虎林园,20220104,全国,全国,175,76,99
5,东北虎林园,20220105,全国,全国,161,68,93
6,东北虎林园,20220106,全国,全国,167,74,93
7,东北虎林园,20220107,全国,全国,152,66,86
8,东北虎林园,20220108,全国,全国,143,61,82
9,东北虎林园,20220109,全国,全国,148,61,87
10,东北虎林园,20220110,全国,全国,154,72,82
11,东北虎林园,20220111,全国,全国,155,64,91
12,东北虎林园,20220112,全国,全国,161,70,91
13,东北虎林园,20220113,全国,全国,170,78,92
14,东北虎林园,20220114,全国,全国,175,82,93
15,东北虎林园,20220115,全国,全国,164,68,96
16,东北虎林园,20220116,全国,全国,186,80,106
17,东北虎林园,20220117,全国,全国,174,68,106
18,东北虎林园,20220118,全国,全国,155,72,83
19,东北虎林园,20220119,全国,全国,170,70,100
20,东北虎林园,20220120,全国,全国,172,68,104
21,东北虎林园,20220121,全国,全国,161,74,87
22,东北虎林园,20220122,全国,全国,172,64,108
23,东北虎林园,20220123,全国,全国,164,68,96
24,东北虎林园,20220124,全国,全国,193,85,108
25,东北虎林园,20220125,全国,全国,158,66,92
26,东北虎林园,20220126,全国,全国,170,70,100
27,东北虎林园,20220127,全国,全国,169,70,99
28,东北虎林园,20220128,全国,全国,161,72,89
29,东北虎林园,20220129,全国,全国,178,59,119
30,东北虎林园,20220130,全国,全国,178,68,110
31,东北虎林园,20220131,全国,全国,240,63,177
32,东北虎林园,20220201,全国,全国,250,72,178
33,东北虎林园,20220202,全国,全国,231,68,163
34,东北虎林园,20220203,全国,全国,233,66,167
35,东北虎林园,20220204,全国,全国,192,66,126
36,东北虎林园,20220205,全国,全国,194,68,126
37,东北虎林园,20220206,全国,全国,134,0,134
38,东北虎林园,20220207,全国,全国,170,66,104
39,东北虎林园,20220208,全国,全国,176,72,104
40,东北虎林园,20220209,全国,全国,187,64,123
41,东北虎林园,20220210,全国,全国,183,78,105
42,东北虎林园,20220211,全国,全国,159,63,96
43,东北虎林园,20220212,全国,全国,175,63,112
44,东北虎林园,20220213,全国,全国,169,63,106
45,东北虎林园,20220214,全国,全国,161,61,100
46,东北虎林园,20220215,全国,全国,157,68,89
47,东北虎林园,20220216,全国,全国,169,76,93
48,东北虎林园,20220217,全国,全国,175,80,95
49,东北虎林园,20220218,全国,全国,219,85,134
50,东北虎林园,20220219,全国,全国,204,68,136
51,东北虎林园,20220220,全国,全国,156,61,95
52,东北虎林园,20220221,全国,全国,182,78,104
53,东北虎林园,20220222,全国,全国,192,87,105
54,东北虎林园,20220223,全国,全国,161,66,95
55,东北虎林园,20220224,全国,全国,171,66,105
56,东北虎林园,20220225,全国,全国,160,74,86
57,东北虎林园,20220226,全国,全国,157,68,89
58,东北虎林园,20220227,全国,全国,147,61,86
59,东北虎林园,20220228,全国,全国,154,72,82
60,东北虎林园,20220301,全国,全国,150,68,82
61,东北虎林园,20220302,全国,全国,153,70,83
62,东北虎林园,20220303,全国,全国,172,68,104
63,东北虎林园,20220304,全国,全国,187,64,123
64,东北虎林园,20220305,全国,全国,154,68,86
65,东北虎林园,20220306,全国,全国,191,72,119
66,东北虎林园,20220307,全国,全国,198,66,132
67,东北虎林园,20220308,全国,全国,206,68,138
68,东北虎林园,20220309,全国,全国,158,63,95
69,东北虎林园,20220310,全国,全国,142,64,78
70,东北虎林园,20220311,全国,全国,173,63,110
71,东北虎林园,20220312,全国,全国,139,63,76
72,东北虎林园,20220313,全国,全国,142,64,78
73,东北虎林园,20220314,全国,全国,142,64,78
74,东北虎林园,20220315,全国,全国,141,59,82
75,东北虎林园,20220316,全国,全国,145,59,86
76,东北虎林园,20220317,全国,全国,133,63,70
77,东北虎林园,20220318,全国,全国,74,0,74
78,东北虎林园,20220319,全国,全国,137,63,74
79,东北虎林园,20220320,全国,全国,82,0,82
80,东北虎林园,20220321,全国,全国,137,59,78
81,东北虎林园,20220322,全国,全国,161,70,91
82,东北虎林园,20220323,全国,全国,145,63,82
83,东北虎林园,20220324,全国,全国,141,74,67
84,东北虎林园,20220325,全国,全国,143,70,73
85,东北虎林园,20220326,全国,全国,71,0,71
86,东北虎林园,20220327,全国,全国,135,64,71
87,东北虎林园,20220328,全国,全国,145,63,82
88,东北虎林园,20220329,全国,全国,135,59,76
89,东北虎林园,20220330,全国,全国,91,0,91
90,东北虎林园,20220331,全国,全国,161,61,100
91,东北虎林园,20220401,全国,全国,142,63,79
92,东北虎林园,20220402,全国,全国,146,59,87
93,东北虎林园,20220403,全国,全国,87,0,87
94,东北虎林园,20220404,全国,全国,132,59,73
95,东北虎林园,20220405,全国,全国,143,61,82
96,东北虎林园,20220406,全国,全国,133,66,67
97,东北虎林园,20220407,全国,全国,134,63,71
98,东北虎林园,20220408,全国,全国,137,68,69
99,东北虎林园,20220409,全国,全国,89,0,89
100,东北虎林园,20220410,全国,全国,143,63,80
101,东北虎林园,20220411,全国,全国,142,66,76
102,东北虎林园,20220412,全国,全国,146,72,74
103,东北虎林园,20220413,全国,全国,141,63,78
104,东北虎林园,20220414,全国,全国,145,66,79
105,东北虎林园,20220415,全国,全国,134,63,71
106,东北虎林园,20220416,全国,全国,79,0,79
107,东北虎林园,20220417,全国,全国,89,0,89
108,东北虎林园,20220418,全国,全国,132,59,73
109,东北虎林园,20220419,全国,全国,156,61,95
110,东北虎林园,20220420,全国,全国,158,63,95
111,东北虎林园,20220421,全国,全国,143,61,82
112,东北虎林园,20220422,全国,全国,159,63,96
113,东北虎林园,20220423,全国,全国,163,59,104
114,东北虎林园,20220424,全国,全国,84,0,84
115,东北虎林园,20220425,全国,全国,131,61,70
116,东北虎林园,20220426,全国,全国,76,0,76
117,东北虎林园,20220427,全国,全国,145,63,82
118,东北虎林园,20220428,全国,全国,145,61,84
119,东北虎林园,20220429,全国,全国,78,0,78
120,东北虎林园,20220430,全国,全国,146,59,87
121,东北虎林园,20220501,全国,全国,143,64,79
122,东北虎林园,20220502,全国,全国,87,0,87
123,东北虎林园,20220503,全国,全国,148,59,89
124,东北虎林园,20220504,全国,全国,150,64,86
125,东北虎林园,20220505,全国,全国,144,64,80
126,东北虎林园,20220506,全国,全国,76,0,76
127,东北虎林园,20220507,全国,全国,137,64,73
128,东北虎林园,20220508,全国,全国,99,0,99
129,东北虎林园,20220509,全国,全国,158,72,86
130,东北虎林园,20220510,全国,全国,144,64,80
131,东北虎林园,20220511,全国,全国,146,68,78
132,东北虎林园,20220512,全国,全国,154,70,84
133,东北虎林园,20220513,全国,全国,173,68,105
134,东北虎林园,20220514,全国,全国,167,61,106
135,东北虎林园,20220515,全国,全国,86,0,86
136,东北虎林园,20220516,全国,全国,146,63,83
137,东北虎林园,20220517,全国,全国,87,0,87
138,东北虎林园,20220518,全国,全国,157,64,93
139,东北虎林园,20220519,全国,全国,143,63,80
140,东北虎林园,20220520,全国,全国,165,70,95
141,东北虎林园,20220521,全国,全国,157,64,93
142,东北虎林园,20220522,全国,全国,158,63,95
143,东北虎林园,20220523,全国,全国,168,64,104
144,东北虎林园,20220524,全国,全国,154,63,91
145,东北虎林园,20220525,全国,全国,151,64,87
146,东北虎林园,20220526,全国,全国,154,61,93
147,东北虎林园,20220527,全国,全国,140,64,76
148,东北虎林园,20220528,全国,全国,92,0,92
149,东北虎林园,20220529,全国,全国,156,61,95
150,东北虎林园,20220530,全国,全国,163,61,102
151,东北虎林园,20220531,全国,全国,181,64,117
152,东北虎林园,20220601,全国,全国,190,59,131
153,东北虎林园,20220602,全国,全国,192,66,126
154,东北虎林园,20220603,全国,全国,186,0,186
155,东北虎林园,20220604,全国,全国,218,63,155
156,东北虎林园,20220605,全国,全国,169,64,105
157,东北虎林园,20220606,全国,全国,180,63,117
158,东北虎林园,20220607,全国,全国,170,68,102
159,东北虎林园,20220608,全国,全国,164,68,96
160,东北虎林园,20220609,全国,全国,167,63,104
161,东北虎林园,20220610,全国,全国,168,66,102
162,东北虎林园,20220611,全国,全国,173,61,112
163,东北虎林园,20220612,全国,全国,168,68,100
164,东北虎林园,20220613,全国,全国,170,61,109
165,东北虎林园,20220614,全国,全国,170,64,106
166,东北虎林园,20220615,全国,全国,162,63,99
167,东北虎林园,20220616,全国,全国,169,61,108
168,东北虎林园,20220617,全国,全国,176,63,113
169,东北虎林园,20220618,全国,全国,244,64,180
170,东北虎林园,20220619,全国,全国,195,61,134
171,东北虎林园,20220620,全国,全国,186,63,123
172,东北虎林园,20220621,全国,全国,170,66,104
173,东北虎林园,20220622,全国,全国,175,66,109
174,东北虎林园,20220623,全国,全国,178,68,110
175,东北虎林园,20220624,全国,全国,187,74,113
176,东北虎林园,20220625,全国,全国,186,61,125
177,东北虎林园,20220626,全国,全国,185,59,126
178,东北虎林园,20220627,全国,全国,185,63,122
179,东北虎林园,20220628,全国,全国,203,82,121
180,东北虎林园,20220629,全国,全国,185,70,115
181,东北虎林园,20220630,全国,全国,199,80,119
182,东北虎林园,20220701,全国,全国,181,63,118
183,东北虎林园,20220702,全国,全国,191,66,125
184,东北虎林园,20220703,全国,全国,190,59,131
185,东北虎林园,20220704,全国,全国,197,63,134
186,东北虎林园,20220705,全国,全国,194,64,130
187,东北虎林园,20220706,全国,全国,205,70,135
188,东北虎林园,20220707,全国,全国,197,76,121
189,东北虎林园,20220708,全国,全国,220,76,144
190,东北虎林园,20220709,全国,全国,240,61,179
191,东北虎林园,20220710,全国,全国,202,61,141
192,东北虎林园,20220711,全国,全国,215,74,141
193,东北虎林园,20220712,全国,全国,212,61,151
194,东北虎林园,20220713,全国,全国,195,74,121
195,东北虎林园,20220714,全国,全国,191,70,121
196,东北虎林园,20220715,全国,全国,221,66,155
197,东北虎林园,20220716,全国,全国,232,70,162
198,东北虎林园,20220717,全国,全国,264,68,196
199,东北虎林园,20220718,全国,全国,210,66,144
200,东北虎林园,20220719,全国,全国,208,64,144
201,东北虎林园,20220720,全国,全国,246,66,180
202,东北虎林园,20220721,全国,全国,208,76,132
203,东北虎林园,20220722,全国,全国,209,74,135
204,东北虎林园,20220723,全国,全国,242,63,179
205,东北虎林园,20220724,全国,全国,216,59,157
206,东北虎林园,20220725,全国,全国,229,70,159
207,东北虎林园,20220726,全国,全国,227,70,157
208,东北虎林园,20220727,全国,全国,244,78,166
209,东北虎林园,20220728,全国,全国,246,76,170
210,东北虎林园,20220729,全国,全国,290,78,212
211,东北虎林园,20220730,全国,全国,322,72,250
212,东北虎林园,20220731,全国,全国,281,72,209
213,东北虎林园,20220801,全国,全国,267,74,193
214,东北虎林园,20220802,全国,全国,236,66,170
215,东北虎林园,20220803,全国,全国,237,72,165
216,东北虎林园,20220804,全国,全国,265,66,199
217,东北虎林园,20220805,全国,全国,301,76,225
218,东北虎林园,20220806,全国,全国,287,68,219
219,东北虎林园,20220807,全国,全国,278,59,219
220,东北虎林园,20220808,全国,全国,282,80,202
221,东北虎林园,20220809,全国,全国,255,68,187
222,东北虎林园,20220810,全国,全国,249,64,185
223,东北虎林园,20220811,全国,全国,249,83,166
224,东北虎林园,20220812,全国,全国,231,66,165
225,东北虎林园,20220813,全国,全国,263,64,199
226,东北虎林园,20220814,全国,全国,254,68,186
227,东北虎林园,20220815,全国,全国,240,70,170
228,东北虎林园,20220816,全国,全国,253,80,173
229,东北虎林园,20220817,全国,全国,273,87,186
230,东北虎林园,20220818,全国,全国,249,72,177
231,东北虎林园,20220819,全国,全国,211,68,143
232,东北虎林园,20220820,全国,全国,284,76,208
233,东北虎林园,20220821,全国,全国,238,64,174
234,东北虎林园,20220822,全国,全国,186,63,123
235,东北虎林园,20220823,全国,全国,211,66,145
236,东北虎林园,20220824,全国,全国,218,61,157
237,东北虎林园,20220825,全国,全国,230,70,160
238,东北虎林园,20220826,全国,全国,234,76,158
239,东北虎林园,20220827,全国,全国,229,61,168
240,东北虎林园,20220828,全国,全国,206,61,145
241,东北虎林园,20220829,全国,全国,179,70,109
242,东北虎林园,20220830,全国,全国,186,68,118
243,东北虎林园,20220831,全国,全国,172,72,100
244,东北虎林园,20220901,全国,全国,156,63,93
245,东北虎林园,20220902,全国,全国,152,70,82
246,东北虎林园,20220903,全国,全国,159,63,96
247,东北虎林园,20220904,全国,全国,146,59,87
248,东北虎林园,20220905,全国,全国,163,63,100
249,东北虎林园,20220906,全国,全国,148,61,87
250,东北虎林园,20220907,全国,全国,153,66,87
251,东北虎林园,20220908,全国,全国,158,61,97
252,东北虎林园,20220909,全国,全国,186,61,125
253,东北虎林园,20220910,全国,全国,192,70,122
254,东北虎林园,20220911,全国,全国,197,59,138
255,东北虎林园,20220912,全国,全国,194,64,130
256,东北虎林园,20220913,全国,全国,182,59,123
257,东北虎林园,20220914,全国,全国,167,61,106
258,东北虎林园,20220915,全国,全国,147,61,86
259,东北虎林园,20220916,全国,全国,168,64,104
260,东北虎林园,20220917,全国,全国,184,59,125
261,东北虎林园,20220918,全国,全国,176,64,112
262,东北虎林园,20220919,全国,全国,143,59,84
263,东北虎林园,20220920,全国,全国,141,59,82
264,东北虎林园,20220921,全国,全国,165,66,99
265,东北虎林园,20220922,全国,全国,162,70,92
266,东北虎林园,20220923,全国,全国,150,66,84
267,东北虎林园,20220924,全国,全国,99,0,99
268,东北虎林园,20220925,全国,全国,100,0,100
269,东北虎林园,20220926,全国,全国,155,64,91
270,东北虎林园,20220927,全国,全国,144,61,83
271,东北虎林园,20220928,全国,全国,143,59,84
272,东北虎林园,20220929,全国,全国,147,61,86
273,东北虎林园,20220930,全国,全国,174,68,106
274,东北虎林园,20221001,全国,全国,182,61,121
275,东北虎林园,20221002,全国,全国,151,0,151
276,东北虎林园,20221003,全国,全国,191,72,119
277,东北虎林园,20221004,全国,全国,138,0,138
278,东北虎林园,20221005,全国,全国,126,0,126
279,东北虎林园,20221006,全国,全国,108,0,108
280,东北虎林园,20221007,全国,全国,106,0,106
281,东北虎林园,20221008,全国,全国,139,70,69
282,东北虎林园,20221009,全国,全国,145,72,73
283,东北虎林园,20221010,全国,全国,150,59,91
284,东北虎林园,20221011,全国,全国,145,59,86
285,东北虎林园,20221012,全国,全国,163,72,91
286,东北虎林园,20221013,全国,全国,162,70,92
287,东北虎林园,20221014,全国,全国,139,59,80
288,东北虎林园,20221015,全国,全国,91,0,91
289,东北虎林园,20221016,全国,全国,87,0,87
290,东北虎林园,20221017,全国,全国,143,70,73
291,东北虎林园,20221018,全国,全国,163,66,97
292,东北虎林园,20221019,全国,全国,160,74,86
293,东北虎林园,20221020,全国,全国,158,66,92
294,东北虎林园,20221021,全国,全国,89,0,89
295,东北虎林园,20221022,全国,全国,159,59,100
296,东北虎林园,20221023,全国,全国,163,59,104
297,东北虎林园,20221024,全国,全国,91,0,91
298,东北虎林园,20221025,全国,全国,167,70,97
299,东北虎林园,20221026,全国,全国,148,61,87
300,东北虎林园,20221027,全国,全国,163,76,87
301,东北虎林园,20221028,全国,全国,150,59,91
302,东北虎林园,20221029,全国,全国,102,0,102
303,东北虎林园,20221030,全国,全国,82,0,82
304,东北虎林园,20221031,全国,全国,129,63,66
305,东北虎林园,20221101,全国,全国,147,61,86
306,东北虎林园,20221102,全国,全国,145,66,79
307,东北虎林园,20221103,全国,全国,131,61,70
308,东北虎林园,20221104,全国,全国,154,63,91
309,东北虎林园,20221105,全国,全国,151,59,92
310,东北虎林园,20221106,全国,全国,141,61,80
311,东北虎林园,20221107,全国,全国,141,63,78
312,东北虎林园,20221108,全国,全国,159,64,95
313,东北虎林园,20221109,全国,全国,161,64,97
314,东北虎林园,20221110,全国,全国,155,64,91
315,东北虎林园,20221111,全国,全国,151,72,79
316,东北虎林园,20221112,全国,全国,92,0,92
317,东北虎林园,20221113,全国,全国,151,59,92
318,东北虎林园,20221114,全国,全国,150,64,86
319,东北虎林园,20221115,全国,全国,132,59,73
320,东北虎林园,20221116,全国,全国,148,59,89
321,东北虎林园,20221117,全国,全国,157,64,93
322,东北虎林园,20221118,全国,全国,152,61,91
323,东北虎林园,20221119,全国,全国,163,61,102
324,东北虎林园,20221120,全国,全国,147,63,84
325,东北虎林园,20221121,全国,全国,150,61,89
326,东北虎林园,20221122,全国,全国,146,68,78
327,东北虎林园,20221123,全国,全国,76,0,76
328,东北虎林园,20221124,全国,全国,152,66,86
329,东北虎林园,20221125,全国,全国,148,66,82
330,东北虎林园,20221126,全国,全国,148,68,80
331,东北虎林园,20221127,全国,全国,145,61,84
332,东北虎林园,20221128,全国,全国,140,66,74
333,东北虎林园,20221129,全国,全国,150,63,87
334,东北虎林园,20221130,全国,全国,141,61,80
335,东北虎林园,20221201,全国,全国,161,66,95
336,东北虎林园,20221202,全国,全国,165,63,102
337,东北虎林园,20221203,全国,全国,80,0,80
338,东北虎林园,20221204,全国,全国,133,59,74
339,东北虎林园,20221205,全国,全国,147,61,86
340,东北虎林园,20221206,全国,全国,156,72,84
341,东北虎林园,20221207,全国,全国,150,64,86
342,东北虎林园,20221208,全国,全国,109,0,109
343,东北虎林园,20221209,全国,全国,158,66,92
344,东北虎林园,20221210,全国,全国,141,63,78
345,东北虎林园,20221211,全国,全国,155,63,92
346,东北虎林园,20221212,全国,全国,78,0,78
347,东北虎林园,20221213,全国,全国,145,61,84
348,东北虎林园,20221214,全国,全国,126,61,65
349,东北虎林园,20221215,全国,全国,150,59,91
350,东北虎林园,20221216,全国,全国,154,59,95
351,东北虎林园,20221217,全国,全国,97,0,97
352,东北虎林园,20221218,全国,全国,159,66,93
353,东北虎林园,20221219,全国,全国,174,64,110
354,东北虎林园,20221220,全国,全国,148,68,80
355,东北虎林园,20221221,全国,全国,149,66,83
356,东北虎林园,20221222,全国,全国,148,68,80
357,东北虎林园,20221223,全国,全国,141,61,80
358,东北虎林园,20221224,全国,全国,149,63,86
359,东北虎林园,20221225,全国,全国,151,59,92
360,东北虎林园,20221226,全国,全国,139,63,76
361,东北虎林园,20221227,全国,全国,149,63,86
362,东北虎林园,20221228,全国,全国,87,0,87
363,东北虎林园,20221229,全国,全国,152,66,86
364,东北虎林园,20221230,全国,全国,154,68,86
365,东北虎林园,20221231,全国,全国,140,61,79
366,东北虎林园,20230101,全国,全国,104,0,104
367,东北虎林园,20230102,全国,全国,157,61,96
368,东北虎林园,20230103,全国,全国,157,61,96
369,东北虎林园,20230104,全国,全国,177,80,97
370,东北虎林园,20230105,全国,全国,167,70,97
371,东北虎林园,20230106,全国,全国,194,82,112
372,东北虎林园,20230107,全国,全国,347,78,269
373,东北虎林园,20230108,全国,全国,297,76,221
374,东北虎林园,20230109,全国,全国,232,70,162
375,东北虎林园,20230110,全国,全国,233,78,155
376,东北虎林园,20230111,全国,全国,225,68,157
377,东北虎林园,20230112,全国,全国,192,61,131
378,东北虎林园,20230113,全国,全国,214,78,136
379,东北虎林园,20230114,全国,全国,227,72,155
380,东北虎林园,20230115,全国,全国,238,68,170
381,东北虎林园,20230116,全国,全国,208,72,136
382,东北虎林园,20230117,全国,全国,181,64,117
383,东北虎林园,20230118,全国,全国,199,64,135
384,东北虎林园,20230119,全国,全国,196,64,132
385,东北虎林园,20230120,全国,全国,189,66,123
386,东北虎林园,20230121,全国,全国,92,0,92
387,东北虎林园,20230122,全国,全国,183,61,122
388,东北虎林园,20230123,全国,全国,245,63,182
389,东北虎林园,20230124,全国,全国,199,61,138
390,东北虎林园,20230125,全国,全国,225,63,162
391,东北虎林园,20230126,全国,全国,248,66,182
392,东北虎林园,20230127,全国,全国,210,61,149
393,东北虎林园,20230128,全国,全国,228,70,158
394,东北虎林园,20230129,全国,全国,174,0,174
395,东北虎林园,20230130,全国,全国,208,63,145
396,东北虎林园,20230131,全国,全国,230,70,160
397,东北虎林园,20230201,全国,全国,224,64,160
398,东北虎林园,20230202,全国,全国,210,66,144
399,东北虎林园,20230203,全国,全国,199,63,136
400,东北虎林园,20230204,全国,全国,203,59,144
401,东北虎林园,20230205,全国,全国,184,61,123
402,东北虎林园,20230206,全国,全国,215,83,132
403,东北虎林园,20230207,全国,全国,169,59,110
404,东北虎林园,20230208,全国,全国,217,76,141
405,东北虎林园,20230209,全国,全国,200,68,132
406,东北虎林园,20230210,全国,全国,185,63,122
407,东北虎林园,20230211,全国,全国,148,0,148
408,东北虎林园,20230212,全国,全国,210,59,151
409,东北虎林园,20230213,全国,全国,171,66,105
410,东北虎林园,20230214,全国,全国,192,74,118
411,东北虎林园,20230215,全国,全国,195,74,121
412,东北虎林园,20230216,全国,全国,211,72,139
413,东北虎林园,20230217,全国,全国,187,64,123
414,东北虎林园,20230218,全国,全国,206,70,136
415,东北虎林园,20230219,全国,全国,189,59,130
416,东北虎林园,20230220,全国,全国,172,63,109
417,东北虎林园,20230221,全国,全国,194,76,118
418,东北虎林园,20230222,全国,全国,176,63,113
419,东北虎林园,20230223,全国,全国,172,72,100
420,东北虎林园,20230224,全国,全国,197,66,131
421,东北虎林园,20230225,全国,全国,174,59,115
422,东北虎林园,20230226,全国,全国,207,66,141
423,东北虎林园,20230227,全国,全国,171,76,95
424,东北虎林园,20230228,全国,全国,189,63,126
425,东北虎林园,20230301,全国,全国,191,63,128
426,东北虎林园,20230302,全国,全国,193,68,125
427,东北虎林园,20230303,全国,全国,201,78,123
428,东北虎林园,20230304,全国,全国,265,64,201
429,东北虎林园,20230305,全国,全国,230,64,166
430,东北虎林园,20230306,全国,全国,223,72,151
431,东北虎林园,20230307,全国,全国,251,74,177
432,东北虎林园,20230308,全国,全国,265,70,195
433,东北虎林园,20230309,全国,全国,215,66,149
434,东北虎林园,20230310,全国,全国,314,72,242
435,东北虎林园,20230311,全国,全国,594,82,512
436,东北虎林园,20230312,全国,全国,500,78,422
437,东北虎林园,20230313,全国,全国,394,85,309
438,东北虎林园,20230314,全国,全国,316,68,248
439,东北虎林园,20230315,全国,全国,332,80,252
440,东北虎林园,20230316,全国,全国,291,72,219
441,东北虎林园,20230317,全国,全国,283,72,211
442,东北虎林园,20230318,全国,全国,324,64,260
443,东北虎林园,20230319,全国,全国,336,72,264
444,东北虎林园,20230320,全国,全国,258,68,190
445,东北虎林园,20230321,全国,全国,270,85,185
446,东北虎林园,20230322,全国,全国,266,87,179
447,东北虎林园,20230323,全国,全国,250,72,178
448,东北虎林园,20230324,全国,全国,269,72,197
449,东北虎林园,20230325,全国,全国,286,61,225
450,东北虎林园,20230326,全国,全国,274,66,208
451,东北虎林园,20230327,全国,全国,273,74,199
452,东北虎林园,20230328,全国,全国,238,72,166
453,东北虎林园,20230329,全国,全国,240,63,177
454,东北虎林园,20230330,全国,全国,269,70,199
455,东北虎林园,20230331,全国,全国,267,78,189
456,东北虎林园,20230401,全国,全国,269,61,208
457,东北虎林园,20230402,全国,全国,310,64,246
458,东北虎林园,20230403,全国,全国,259,70,189
459,东北虎林园,20230404,全国,全国,279,64,215
460,东北虎林园,20230405,全国,全国,298,70,228
461,东北虎林园,20230406,全国,全国,253,76,177
462,东北虎林园,20230407,全国,全国,264,80,184
463,东北虎林园,20230408,全国,全国,251,61,190
464,东北虎林园,20230409,全国,全国,265,72,193
465,东北虎林园,20230410,全国,全国,202,72,130
466,东北虎林园,20230411,全国,全国,230,76,154
467,东北虎林园,20230412,全国,全国,204,72,132
468,东北虎林园,20230413,全国,全国,221,66,155
469,东北虎林园,20230414,全国,全国,242,68,174
470,东北虎林园,20230415,全国,全国,259,66,193
471,东北虎林园,20230416,全国,全国,174,0,174
472,东北虎林园,20230417,全国,全国,246,72,174
473,东北虎林园,20230418,全国,全国,236,70,166
474,东北虎林园,20230419,全国,全国,247,82,165
475,东北虎林园,20230420,全国,全国,247,85,162
476,东北虎林园,20230421,全国,全国,277,85,192
477,东北虎林园,20230422,全国,全国,252,74,178
478,东北虎林园,20230423,全国,全国,222,70,152
479,东北虎林园,20230424,全国,全国,279,80,199
480,东北虎林园,20230425,全国,全国,259,78,181
481,东北虎林园,20230426,全国,全国,283,80,203
482,东北虎林园,20230427,全国,全国,283,66,217
483,东北虎林园,20230428,全国,全国,362,82,280
484,东北虎林园,20230429,全国,全国,459,68,391
485,东北虎林园,20230430,全国,全国,627,74,553
486,东北虎林园,20230501,全国,全国,831,66,765
487,东北虎林园,20230502,全国,全国,550,63,487
488,东北虎林园,20230503,全国,全国,351,83,268
489,东北虎林园,20230504,全国,全国,260,80,180
490,东北虎林园,20230505,全国,全国,222,70,152
491,东北虎林园,20230506,全国,全国,249,72,177
492,东北虎林园,20230507,全国,全国,249,59,190
493,东北虎林园,20230508,全国,全国,191,72,119
494,东北虎林园,20230509,全国,全国,223,66,157
495,东北虎林园,20230510,全国,全国,221,70,151
496,东北虎林园,20230511,全国,全国,215,74,141
497,东北虎林园,20230512,全国,全国,192,70,122
498,东北虎林园,20230513,全国,全国,231,61,170
499,东北虎林园,20230514,全国,全国,240,59,181
500,东北虎林园,20230515,全国,全国,206,78,128
501,东北虎林园,20230516,全国,全国,197,74,123
502,东北虎林园,20230517,全国,全国,211,68,143
503,东北虎林园,20230518,全国,全国,204,70,134
504,东北虎林园,20230519,全国,全国,198,64,134
505,东北虎林园,20230520,全国,全国,204,61,143
506,东北虎林园,20230521,全国,全国,211,59,152
507,东北虎林园,20230522,全国,全国,210,66,144
508,东北虎林园,20230523,全国,全国,213,59,154
509,东北虎林园,20230524,全国,全国,222,78,144
510,东北虎林园,20230525,全国,全国,211,80,131
511,东北虎林园,20230526,全国,全国,187,70,117
512,东北虎林园,20230527,全国,全国,214,63,151
513,东北虎林园,20230528,全国,全国,151,0,151
514,东北虎林园,20230529,全国,全国,217,66,151
515,东北虎林园,20230530,全国,全国,200,74,126
516,东北虎林园,20230531,全国,全国,215,72,143
517,东北虎林园,20230601,全国,全国,202,64,138
518,东北虎林园,20230602,全国,全国,216,91,125
519,东北虎林园,20230603,全国,全国,214,63,151
520,东北虎林园,20230604,全国,全国,218,59,159
521,东北虎林园,20230605,全国,全国,188,78,110
522,东北虎林园,20230606,全国,全国,211,66,145
523,东北虎林园,20230607,全国,全国,207,66,141
524,东北虎林园,20230608,全国,全国,222,78,144
525,东北虎林园,20230609,全国,全国,219,70,149
526,东北虎林园,20230610,全国,全国,238,74,164
527,东北虎林园,20230611,全国,全国,212,61,151
528,东北虎林园,20230612,全国,全国,238,72,166
529,东北虎林园,20230613,全国,全国,251,89,162
530,东北虎林园,20230614,全国,全国,222,78,144
531,东北虎林园,20230615,全国,全国,228,70,158
532,东北虎林园,20230616,全国,全国,204,72,132
533,东北虎林园,20230617,全国,全国,205,64,141
534,东北虎林园,20230618,全国,全国,223,61,162
535,东北虎林园,20230619,全国,全国,200,64,136
536,东北虎林园,20230620,全国,全国,222,78,144
537,东北虎林园,20230621,全国,全国,254,80,174
538,东北虎林园,20230622,全国,全国,280,74,206
539,东北虎林园,20230623,全国,全国,251,66,185
540,东北虎林园,20230624,全国,全国,225,61,164
541,东北虎林园,20230625,全国,全国,228,76,152
542,东北虎林园,20230626,全国,全国,227,82,145
543,东北虎林园,20230627,全国,全国,243,76,167
544,东北虎林园,20230628,全国,全国,223,74,149
545,东北虎林园,20230629,全国,全国,232,80,152
546,东北虎林园,20230630,全国,全国,242,66,176
547,东北虎林园,20230701,全国,全国,236,70,166
548,东北虎林园,20230702,全国,全国,233,63,170
549,东北虎林园,20230703,全国,全国,231,70,161
550,东北虎林园,20230704,全国,全国,258,85,173
551,东北虎林园,20230705,全国,全国,229,85,144
552,东北虎林园,20230706,全国,全国,253,83,170
553,东北虎林园,20230707,全国,全国,267,78,189
554,东北虎林园,20230708,全国,全国,283,74,209
555,东北虎林园,20230709,全国,全国,274,66,208
556,东北虎林园,20230710,全国,全国,288,76,212
557,东北虎林园,20230711,全国,全国,278,66,212
558,东北虎林园,20230712,全国,全国,281,76,205
559,东北虎林园,20230713,全国,全国,289,74,215
560,东北虎林园,20230714,全国,全国,251,72,179
561,东北虎林园,20230715,全国,全国,261,76,185
562,东北虎林园,20230716,全国,全国,296,74,222
563,东北虎林园,20230717,全国,全国,311,87,224
564,东北虎林园,20230718,全国,全国,310,82,228
565,东北虎林园,20230719,全国,全国,300,83,217
566,东北虎林园,20230720,全国,全国,278,78,200
567,东北虎林园,20230721,全国,全国,342,97,245
568,东北虎林园,20230722,全国,全国,343,72,271
569,东北虎林园,20230723,全国,全国,345,68,277
570,东北虎林园,20230724,全国,全国,325,91,234
571,东北虎林园,20230725,全国,全国,358,83,275
572,东北虎林园,20230726,全国,全国,383,85,298
573,东北虎林园,20230727,全国,全国,363,83,280
574,东北虎林园,20230728,全国,全国,337,80,257
575,东北虎林园,20230729,全国,全国,418,72,346
576,东北虎林园,20230730,全国,全国,424,72,352
577,东北虎林园,20230731,全国,全国,382,82,300
578,东北虎林园,20230801,全国,全国,366,74,292
579,东北虎林园,20230802,全国,全国,306,97,209
580,东北虎林园,20230803,全国,全国,352,78,274
581,东北虎林园,20230804,全国,全国,360,72,288
582,东北虎林园,20230805,全国,全国,373,70,303
583,东北虎林园,20230806,全国,全国,400,80,320
584,东北虎林园,20230807,全国,全国,385,93,292
585,东北虎林园,20230808,全国,全国,334,82,252
586,东北虎林园,20230809,全国,全国,331,72,259
587,东北虎林园,20230810,全国,全国,306,72,234
588,东北虎林园,20230811,全国,全国,280,66,214
589,东北虎林园,20230812,全国,全国,315,80,235
590,东北虎林园,20230813,全国,全国,297,72,225
591,东北虎林园,20230814,全国,全国,331,76,255
592,东北虎林园,20230815,全国,全国,308,74,234
593,东北虎林园,20230816,全国,全国,343,97,246
594,东北虎林园,20230817,全国,全国,285,76,209
595,东北虎林园,20230818,全国,全国,299,85,214
596,东北虎林园,20230819,全国,全国,349,74,275
597,东北虎林园,20230820,全国,全国,271,70,201
598,东北虎林园,20230821,全国,全国,289,97,192
599,东北虎林园,20230822,全国,全国,256,66,190
600,东北虎林园,20230823,全国,全国,267,74,193
601,东北虎林园,20230824,全国,全国,273,72,201
602,东北虎林园,20230825,全国,全国,285,70,215
603,东北虎林园,20230826,全国,全国,278,70,208
604,东北虎林园,20230827,全国,全国,284,76,208
605,东北虎林园,20230828,全国,全国,245,74,171
606,东北虎林园,20230829,全国,全国,245,80,165
607,东北虎林园,20230830,全国,全国,250,68,182
608,东北虎林园,20230831,全国,全国,266,74,192
609,东北虎林园,20230901,全国,全国,241,64,177
610,东北虎林园,20230902,全国,全国,227,72,155
611,东北虎林园,20230903,全国,全国,224,61,163
612,东北虎林园,20230904,全国,全国,223,82,141
613,东北虎林园,20230905,全国,全国,215,80,135
614,东北虎林园,20230906,全国,全国,201,78,123
615,东北虎林园,20230907,全国,全国,199,74,125
616,东北虎林园,20230908,全国,全国,232,83,149
617,东北虎林园,20230909,全国,全国,213,59,154
618,东北虎林园,20230910,全国,全国,219,70,149
619,东北虎林园,20230911,全国,全国,207,85,122
620,东北虎林园,20230912,全国,全国,226,91,135
621,东北虎林园,20230913,全国,全国,238,83,155
622,东北虎林园,20230914,全国,全国,225,74,151
623,东北虎林园,20230915,全国,全国,226,83,143
624,东北虎林园,20230916,全国,全国,236,66,170
625,东北虎林园,20230917,全国,全国,247,66,181
626,东北虎林园,20230918,全国,全国,219,78,141
627,东北虎林园,20230919,全国,全国,199,91,108
628,东北虎林园,20230920,全国,全国,214,80,134
629,东北虎林园,20230921,全国,全国,227,89,138
630,东北虎林园,20230922,全国,全国,229,80,149
631,东北虎林园,20230923,全国,全国,203,59,144
632,东北虎林园,20230924,全国,全国,217,63,154
633,东北虎林园,20230925,全国,全国,223,82,141
634,东北虎林园,20230926,全国,全国,202,72,130
635,东北虎林园,20230927,全国,全国,218,80,138
636,东北虎林园,20230928,全国,全国,268,89,179
637,东北虎林园,20230929,全国,全国,284,63,221
638,东北虎林园,20230930,全国,全国,368,76,292
639,东北虎林园,20231001,全国,全国,436,63,373
640,东北虎林园,20231002,全国,全国,423,64,359
641,东北虎林园,20231003,全国,全国,398,68,330
642,东北虎林园,20231004,全国,全国,371,68,303
643,东北虎林园,20231005,全国,全国,293,59,234
644,东北虎林园,20231006,全国,全国,271,82,189
645,东北虎林园,20231007,全国,全国,193,74,119
646,东北虎林园,20231008,全国,全国,211,76,135
647,东北虎林园,20231009,全国,全国,201,80,121
648,东北虎林园,20231010,全国,全国,205,83,122
649,东北虎林园,20231011,全国,全国,200,82,118
650,东北虎林园,20231012,全国,全国,217,83,134
651,东北虎林园,20231013,全国,全国,206,72,134
652,东北虎林园,20231014,全国,全国,214,66,148
653,东北虎林园,20231015,全国,全国,211,68,143
654,东北虎林园,20231016,全国,全国,180,70,110
655,东北虎林园,20231017,全国,全国,191,82,109
656,东北虎林园,20231018,全国,全国,191,78,113
657,东北虎林园,20231019,全国,全国,176,74,102
658,东北虎林园,20231020,全国,全国,189,85,104
659,东北虎林园,20231021,全国,全国,172,59,113
660,东北虎林园,20231022,全国,全国,206,70,136
661,东北虎林园,20231023,全国,全国,191,87,104
662,东北虎林园,20231024,全国,全国,173,82,91
663,东北虎林园,20231025,全国,全国,184,72,112
664,东北虎林园,20231026,全国,全国,171,80,91
665,东北虎林园,20231027,全国,全国,194,95,99
666,东北虎林园,20231028,全国,全国,189,61,128
667,东北虎林园,20231029,全国,全国,181,63,118
668,东北虎林园,20231030,全国,全国,188,76,112
669,东北虎林园,20231031,全国,全国,159,63,96
670,东北虎林园,20231101,全国,全国,178,66,112
671,东北虎林园,20231102,全国,全国,157,74,83
672,东北虎林园,20231103,全国,全国,182,87,95
673,东北虎林园,20231104,全国,全国,185,64,121
674,东北虎林园,20231105,全国,全国,155,59,96
675,东北虎林园,20231106,全国,全国,182,78,104
676,东北虎林园,20231107,全国,全国,187,82,105
677,东北虎林园,20231108,全国,全国,205,83,122
678,东北虎林园,20231109,全国,全国,234,93,141
679,东北虎林园,20231110,全国,全国,237,89,148
680,东北虎林园,20231111,全国,全国,205,80,125
681,东北虎林园,20231112,全国,全国,227,78,149
682,东北虎林园,20231113,全国,全国,205,93,112
683,东北虎林园,20231114,全国,全国,205,80,125
684,东北虎林园,20231115,全国,全国,212,91,121
685,东北虎林园,20231116,全国,全国,209,83,126
686,东北虎林园,20231117,全国,全国,209,87,122
687,东北虎林园,20231118,全国,全国,187,64,123
688,东北虎林园,20231119,全国,全国,229,70,159
689,东北虎林园,20231120,全国,全国,203,78,125
690,东北虎林园,20231121,全国,全国,234,99,135
691,东北虎林园,20231122,全国,全国,197,89,108
692,东北虎林园,20231123,全国,全国,240,102,138
693,东北虎林园,20231124,全国,全国,216,99,117
694,东北虎林园,20231125,全国,全国,205,82,123
695,东北虎林园,20231126,全国,全国,191,78,113
696,东北虎林园,20231127,全国,全国,216,85,131
697,东北虎林园,20231128,全国,全国,276,118,158
698,东北虎林园,20231129,全国,全国,222,87,135
699,东北虎林园,20231130,全国,全国,219,72,147
700,东北虎林园,20231201,全国,全国,217,85,132
701,东北虎林园,20231202,全国,全国,211,66,145
702,东北虎林园,20231203,全国,全国,225,74,151
703,东北虎林园,20231204,全国,全国,220,89,131
704,东北虎林园,20231205,全国,全国,242,85,157
705,东北虎林园,20231206,全国,全国,229,93,136
706,东北虎林园,20231207,全国,全国,254,99,155
707,东北虎林园,20231208,全国,全国,246,85,161
708,东北虎林园,20231209,全国,全国,217,68,149
709,东北虎林园,20231210,全国,全国,225,70,155
710,东北虎林园,20231211,全国,全国,246,108,138
711,东北虎林园,20231212,全国,全国,193,85,108
712,东北虎林园,20231213,全国,全国,225,82,143
713,东北虎林园,20231214,全国,全国,272,99,173
714,东北虎林园,20231215,全国,全国,223,87,136
715,东北虎林园,20231216,全国,全国,231,87,144
716,东北虎林园,20231217,全国,全国,221,76,145
717,东北虎林园,20231218,全国,全国,262,108,154
718,东北虎林园,20231219,全国,全国,261,87,174
719,东北虎林园,20231220,全国,全国,233,82,151
720,东北虎林园,20231221,全国,全国,278,95,183
721,东北虎林园,20231222,全国,全国,221,63,158
722,东北虎林园,20231223,全国,全国,252,93,159
723,东北虎林园,20231224,全国,全国,267,89,178
724,东北虎林园,20231225,全国,全国,288,93,195
725,东北虎林园,20231226,全国,全国,282,87,195
726,东北虎林园,20231227,全国,全国,275,78,197
727,东北虎林园,20231228,全国,全国,291,106,185
728,东北虎林园,20231229,全国,全国,350,102,248
729,东北虎林园,20231230,全国,全国,347,83,264
730,东北虎林园,20231231,全国,全国,304,68,236
731,东北虎林园,20240101,全国,全国,282,64,218
732,东北虎林园,20240102,全国,全国,327,108,219
733,东北虎林园,20240103,全国,全国,406,140,266
734,东北虎林园,20240104,全国,全国,485,186,299
735,东北虎林园,20240105,全国,全国,478,165,313
736,东北虎林园,20240106,全国,全国,435,91,344
737,东北虎林园,20240107,全国,全国,428,121,307
738,东北虎林园,20240108,全国,全国,444,148,296
739,东北虎林园,20240109,全国,全国,375,127,248
740,东北虎林园,20240110,全国,全国,391,131,260
741,东北虎林园,20240111,全国,全国,352,125,227
742,东北虎林园,20240112,全国,全国,387,133,254
743,东北虎林园,20240113,全国,全国,359,89,270
744,东北虎林园,20240114,全国,全国,336,97,239
745,东北虎林园,20240115,全国,全国,348,101,247
746,东北虎林园,20240116,全国,全国,318,104,214
747,东北虎林园,20240117,全国,全国,337,101,236
748,东北虎林园,20240118,全国,全国,325,106,219
749,东北虎林园,20240119,全国,全国,336,89,247
750,东北虎林园,20240120,全国,全国,349,82,267
751,东北虎林园,20240121,全国,全国,349,74,275
752,东北虎林园,20240122,全国,全国,327,93,234
753,东北虎林园,20240123,全国,全国,356,101,255
754,东北虎林园,20240124,全国,全国,340,95,245
755,东北虎林园,20240125,全国,全国,376,116,260
756,东北虎林园,20240126,全国,全国,347,93,254
757,东北虎林园,20240127,全国,全国,364,70,294
758,东北虎林园,20240128,全国,全国,332,63,269
759,东北虎林园,20240129,全国,全国,390,102,288
760,东北虎林园,20240130,全国,全国,364,93,271
761,东北虎林园,20240131,全国,全国,330,91,239
762,东北虎林园,20240201,全国,全国,315,72,243
763,东北虎林园,20240202,全国,全国,330,89,241
764,东北虎林园,20240203,全国,全国,318,76,242
765,东北虎林园,20240204,全国,全国,332,93,239
766,东北虎林园,20240205,全国,全国,313,89,224
767,东北虎林园,20240206,全国,全国,354,80,274
768,东北虎林园,20240207,全国,全国,317,85,232
769,东北虎林园,20240208,全国,全国,284,78,206
770,东北虎林园,20240209,全国,全国,227,59,168
771,东北虎林园,20240210,全国,全国,280,59,221
772,东北虎林园,20240211,全国,全国,393,63,330
773,东北虎林园,20240212,全国,全国,530,64,466
774,东北虎林园,20240213,全国,全国,667,61,606
775,东北虎林园,20240214,全国,全国,692,72,620
776,东北虎林园,20240215,全国,全国,539,74,465
777,东北虎林园,20240216,全国,全国,479,74,405
778,东北虎林园,20240217,全国,全国,479,68,411
779,东北虎林园,20240218,全国,全国,372,87,285
780,东北虎林园,20240219,全国,全国,336,70,266
781,东北虎林园,20240220,全国,全国,321,68,253
782,东北虎林园,20240221,全国,全国,232,66,166
783,东北虎林园,20240222,全国,全国,272,85,187
784,东北虎林园,20240223,全国,全国,255,76,179
785,东北虎林园,20240224,全国,全国,239,59,180
786,东北虎林园,20240225,全国,全国,250,72,178
787,东北虎林园,20240226,全国,全国,238,70,168
788,东北虎林园,20240227,全国,全国,230,89,141
789,东北虎林园,20240228,全国,全国,204,76,128
790,东北虎林园,20240229,全国,全国,198,72,126
791,东北虎林园,20240301,全国,全国,189,61,128
792,东北虎林园,20240302,全国,全国,191,63,128
793,东北虎林园,20240303,全国,全国,217,66,151
794,东北虎林园,20240304,全国,全国,210,72,138
795,东北虎林园,20240305,全国,全国,180,78,102
796,东北虎林园,20240306,全国,全国,198,72,126
797,东北虎林园,20240307,全国,全国,222,70,152
798,东北虎林园,20240308,全国,全国,233,82,151
799,东北虎林园,20240309,全国,全国,205,74,131
800,东北虎林园,20240310,全国,全国,196,70,126
801,东北虎林园,20240311,全国,全国,184,76,108
802,东北虎林园,20240312,全国,全国,183,66,117
803,东北虎林园,20240313,全国,全国,189,72,117
804,东北虎林园,20240314,全国,全国,208,83,125
805,东北虎林园,20240315,全国,全国,162,66,96
806,东北虎林园,20240316,全国,全国,187,70,117
807,东北虎林园,20240317,全国,全国,186,61,125
808,东北虎林园,20240318,全国,全国,171,85,86
809,东北虎林园,20240319,全国,全国,189,72,117
810,东北虎林园,20240320,全国,全国,193,74,119
811,东北虎林园,20240321,全国,全国,168,72,96
812,东北虎林园,20240322,全国,全国,172,66,106
813,东北虎林园,20240323,全国,全国,208,64,144
814,东北虎林园,20240324,全国,全国,141,0,141
815,东北虎林园,20240325,全国,全国,186,68,118
816,东北虎林园,20240326,全国,全国,176,74,102
817,东北虎林园,20240327,全国,全国,182,72,110
818,东北虎林园,20240328,全国,全国,204,85,119
819,东北虎林园,20240329,全国,全国,201,80,121
820,东北虎林园,20240330,全国,全国,176,68,108
821,东北虎林园,20240331,全国,全国,206,63,143
822,东北虎林园,20240401,全国,全国,202,72,130
823,东北虎林园,20240402,全国,全国,206,74,132
824,东北虎林园,20240403,全国,全国,245,68,177
825,东北虎林园,20240404,全国,全国,288,66,222
826,东北虎林园,20240405,全国,全国,322,66,256
827,东北虎林园,20240406,全国,全国,237,74,163
828,东北虎林园,20240407,全国,全国,223,78,145
829,东北虎林园,20240408,全国,全国,202,85,117
830,东北虎林园,20240409,全国,全国,189,74,115
831,东北虎林园,20240410,全国,全国,189,74,115
832,东北虎林园,20240411,全国,全国,192,66,126
833,东北虎林园,20240412,全国,全国,217,82,135
834,东北虎林园,20240413,全国,全国,207,64,143
835,东北虎林园,20240414,全国,全国,231,76,155
836,东北虎林园,20240415,全国,全国,211,68,143
837,东北虎林园,20240416,全国,全国,216,72,144
838,东北虎林园,20240417,全国,全国,215,70,145
839,东北虎林园,20240418,全国,全国,198,68,130
840,东北虎林园,20240419,全国,全国,203,68,135
841,东北虎林园,20240420,全国,全国,214,63,151
842,东北虎林园,20240421,全国,全国,228,63,165
843,东北虎林园,20240422,全国,全国,224,70,154
844,东北虎林园,20240423,全国,全国,212,68,144
845,东北虎林园,20240424,全国,全国,259,97,162
846,东北虎林园,20240425,全国,全国,229,72,157
847,东北虎林园,20240426,全国,全国,213,72,141
848,东北虎林园,20240427,全国,全国,242,63,179
849,东北虎林园,20240428,全国,全国,230,68,162
850,东北虎林园,20240429,全国,全国,250,87,163
851,东北虎林园,20240430,全国,全国,330,99,231
1,哈尔滨伏尔加庄园,20220101,全国,全国,71,0,71
2,哈尔滨伏尔加庄园,20220102,全国,全国,84,0,84
3,哈尔滨伏尔加庄园,20220103,全国,全国,128,61,67
4,哈尔滨伏尔加庄园,20220104,全国,全国,124,59,65
5,哈尔滨伏尔加庄园,20220105,全国,全国,59,59,0
6,哈尔滨伏尔加庄园,20220106,全国,全国,74,0,74
7,哈尔滨伏尔加庄园,20220107,全国,全国,150,66,84
8,哈尔滨伏尔加庄园,20220108,全国,全国,82,0,82
9,哈尔滨伏尔加庄园,20220109,全国,全国,137,59,78
10,哈尔滨伏尔加庄园,20220110,全国,全国,69,0,69
11,哈尔滨伏尔加庄园,20220111,全国,全国,126,61,65
12,哈尔滨伏尔加庄园,20220112,全国,全国,130,61,69
13,哈尔滨伏尔加庄园,20220113,全国,全国,66,0,66
14,哈尔滨伏尔加庄园,20220114,全国,全国,124,59,65
15,哈尔滨伏尔加庄园,20220115,全国,全国,122,59,63
16,哈尔滨伏尔加庄园,20220116,全国,全国,133,64,69
17,哈尔滨伏尔加庄园,20220117,全国,全国,132,59,73
18,哈尔滨伏尔加庄园,20220118,全国,全国,120,59,61
19,哈尔滨伏尔加庄园,20220119,全国,全国,129,64,65
20,哈尔滨伏尔加庄园,20220120,全国,全国,128,63,65
21,哈尔滨伏尔加庄园,20220121,全国,全国,0,0,0
22,哈尔滨伏尔加庄园,20220122,全国,全国,61,0,61
23,哈尔滨伏尔加庄园,20220123,全国,全国,65,0,65
24,哈尔滨伏尔加庄园,20220124,全国,全国,0,0,0
25,哈尔滨伏尔加庄园,20220125,全国,全国,65,0,65
26,哈尔滨伏尔加庄园,20220126,全国,全国,122,59,63
27,哈尔滨伏尔加庄园,20220127,全国,全国,0,0,0
28,哈尔滨伏尔加庄园,20220128,全国,全国,137,59,78
29,哈尔滨伏尔加庄园,20220129,全国,全国,128,59,69
30,哈尔滨伏尔加庄园,20220130,全国,全国,0,0,0
31,哈尔滨伏尔加庄园,20220131,全国,全国,63,0,63
32,哈尔滨伏尔加庄园,20220201,全国,全国,76,0,76
33,哈尔滨伏尔加庄园,20220202,全国,全国,73,0,73
34,哈尔滨伏尔加庄园,20220203,全国,全国,70,0,70
35,哈尔滨伏尔加庄园,20220204,全国,全国,135,59,76
36,哈尔滨伏尔加庄园,20220205,全国,全国,73,0,73
37,哈尔滨伏尔加庄园,20220206,全国,全国,125,59,66
38,哈尔滨伏尔加庄园,20220207,全国,全国,126,59,67
39,哈尔滨伏尔加庄园,20220208,全国,全国,125,59,66
40,哈尔滨伏尔加庄园,20220209,全国,全国,67,0,67
41,哈尔滨伏尔加庄园,20220210,全国,全国,71,0,71
42,哈尔滨伏尔加庄园,20220211,全国,全国,124,59,65
43,哈尔滨伏尔加庄园,20220212,全国,全国,71,0,71
44,哈尔滨伏尔加庄园,20220213,全国,全国,70,0,70
45,哈尔滨伏尔加庄园,20220214,全国,全国,69,0,69
46,哈尔滨伏尔加庄园,20220215,全国,全国,65,0,65
47,哈尔滨伏尔加庄园,20220216,全国,全国,73,0,73
48,哈尔滨伏尔加庄园,20220217,全国,全国,76,0,76
49,哈尔滨伏尔加庄园,20220218,全国,全国,65,0,65
50,哈尔滨伏尔加庄园,20220219,全国,全国,84,0,84
51,哈尔滨伏尔加庄园,20220220,全国,全国,135,59,76
52,哈尔滨伏尔加庄园,20220221,全国,全国,79,0,79
53,哈尔滨伏尔加庄园,20220222,全国,全国,65,0,65
54,哈尔滨伏尔加庄园,20220223,全国,全国,128,59,69
55,哈尔滨伏尔加庄园,20220224,全国,全国,82,0,82
56,哈尔滨伏尔加庄园,20220225,全国,全国,76,0,76
57,哈尔滨伏尔加庄园,20220226,全国,全国,69,0,69
58,哈尔滨伏尔加庄园,20220227,全国,全国,78,0,78
59,哈尔滨伏尔加庄园,20220228,全国,全国,66,0,66
60,哈尔滨伏尔加庄园,20220301,全国,全国,129,64,65
61,哈尔滨伏尔加庄园,20220302,全国,全国,129,59,70
62,哈尔滨伏尔加庄园,20220303,全国,全国,66,0,66
63,哈尔滨伏尔加庄园,20220304,全国,全国,128,59,69
64,哈尔滨伏尔加庄园,20220305,全国,全国,65,0,65
65,哈尔滨伏尔加庄园,20220306,全国,全国,130,59,71
66,哈尔滨伏尔加庄园,20220307,全国,全国,128,59,69
67,哈尔滨伏尔加庄园,20220308,全国,全国,69,0,69
68,哈尔滨伏尔加庄园,20220309,全国,全国,128,59,69
69,哈尔滨伏尔加庄园,20220310,全国,全国,66,0,66
70,哈尔滨伏尔加庄园,20220311,全国,全国,61,0,61
71,哈尔滨伏尔加庄园,20220312,全国,全国,70,0,70
72,哈尔滨伏尔加庄园,20220313,全国,全国,130,59,71
73,哈尔滨伏尔加庄园,20220314,全国,全国,70,0,70
74,哈尔滨伏尔加庄园,20220315,全国,全国,65,0,65
75,哈尔滨伏尔加庄园,20220316,全国,全国,128,59,69
76,哈尔滨伏尔加庄园,20220317,全国,全国,63,0,63
77,哈尔滨伏尔加庄园,20220318,全国,全国,0,0,0
78,哈尔滨伏尔加庄园,20220319,全国,全国,63,0,63
79,哈尔滨伏尔加庄园,20220320,全国,全国,67,0,67
80,哈尔滨伏尔加庄园,20220321,全国,全国,124,59,65
81,哈尔滨伏尔加庄园,20220322,全国,全国,61,0,61
82,哈尔滨伏尔加庄园,20220323,全国,全国,65,0,65
83,哈尔滨伏尔加庄园,20220324,全国,全国,125,59,66
84,哈尔滨伏尔加庄园,20220325,全国,全国,70,0,70
85,哈尔滨伏尔加庄园,20220326,全国,全国,126,59,67
86,哈尔滨伏尔加庄园,20220327,全国,全国,63,0,63
87,哈尔滨伏尔加庄园,20220328,全国,全国,65,0,65
88,哈尔滨伏尔加庄园,20220329,全国,全国,124,59,65
89,哈尔滨伏尔加庄园,20220330,全国,全国,63,0,63
90,哈尔滨伏尔加庄园,20220331,全国,全国,67,0,67
91,哈尔滨伏尔加庄园,20220401,全国,全国,66,0,66
92,哈尔滨伏尔加庄园,20220402,全国,全国,61,0,61
93,哈尔滨伏尔加庄园,20220403,全国,全国,65,0,65
94,哈尔滨伏尔加庄园,20220404,全国,全国,66,0,66
95,哈尔滨伏尔加庄园,20220405,全国,全国,122,59,63
96,哈尔滨伏尔加庄园,20220406,全国,全国,65,0,65
97,哈尔滨伏尔加庄园,20220407,全国,全国,74,0,74
98,哈尔滨伏尔加庄园,20220408,全国,全国,59,59,0
99,哈尔滨伏尔加庄园,20220409,全国,全国,67,0,67
100,哈尔滨伏尔加庄园,20220410,全国,全国,131,61,70
101,哈尔滨伏尔加庄园,20220411,全国,全国,129,59,70
102,哈尔滨伏尔加庄园,20220412,全国,全国,63,0,63
103,哈尔滨伏尔加庄园,20220413,全国,全国,65,0,65
104,哈尔滨伏尔加庄园,20220414,全国,全国,122,59,63
105,哈尔滨伏尔加庄园,20220415,全国,全国,63,0,63
106,哈尔滨伏尔加庄园,20220416,全国,全国,63,0,63
107,哈尔滨伏尔加庄园,20220417,全国,全国,124,59,65
108,哈尔滨伏尔加庄园,20220418,全国,全国,61,0,61
109,哈尔滨伏尔加庄园,20220419,全国,全国,66,0,66
110,哈尔滨伏尔加庄园,20220420,全国,全国,0,0,0
111,哈尔滨伏尔加庄园,20220421,全国,全国,66,0,66
112,哈尔滨伏尔加庄园,20220422,全国,全国,126,63,63
113,哈尔滨伏尔加庄园,20220423,全国,全国,126,63,63
114,哈尔滨伏尔加庄园,20220424,全国,全国,0,0,0
115,哈尔滨伏尔加庄园,20220425,全国,全国,131,61,70
116,哈尔滨伏尔加庄园,20220426,全国,全国,67,0,67
117,哈尔滨伏尔加庄园,20220427,全国,全国,65,0,65
118,哈尔滨伏尔加庄园,20220428,全国,全国,63,0,63
119,哈尔滨伏尔加庄园,20220429,全国,全国,124,61,63
120,哈尔滨伏尔加庄园,20220430,全国,全国,63,0,63
121,哈尔滨伏尔加庄园,20220501,全国,全国,70,0,70
122,哈尔滨伏尔加庄园,20220502,全国,全国,135,59,76
123,哈尔滨伏尔加庄园,20220503,全国,全国,61,0,61
124,哈尔滨伏尔加庄园,20220504,全国,全国,65,0,65
125,哈尔滨伏尔加庄园,20220505,全国,全国,63,63,0
126,哈尔滨伏尔加庄园,20220506,全国,全国,59,59,0
127,哈尔滨伏尔加庄园,20220507,全国,全国,76,0,76
128,哈尔滨伏尔加庄园,20220508,全国,全国,63,0,63
129,哈尔滨伏尔加庄园,20220509,全国,全国,71,0,71
130,哈尔滨伏尔加庄园,20220510,全国,全国,71,0,71
131,哈尔滨伏尔加庄园,20220511,全国,全国,141,59,82
132,哈尔滨伏尔加庄园,20220512,全国,全国,61,0,61
133,哈尔滨伏尔加庄园,20220513,全国,全国,147,63,84
134,哈尔滨伏尔加庄园,20220514,全国,全国,70,0,70
135,哈尔滨伏尔加庄园,20220515,全国,全国,78,0,78
136,哈尔滨伏尔加庄园,20220516,全国,全国,69,0,69
137,哈尔滨伏尔加庄园,20220517,全国,全国,74,0,74
138,哈尔滨伏尔加庄园,20220518,全国,全国,71,0,71
139,哈尔滨伏尔加庄园,20220519,全国,全国,130,61,69
140,哈尔滨伏尔加庄园,20220520,全国,全国,80,0,80
141,哈尔滨伏尔加庄园,20220521,全国,全国,73,0,73
142,哈尔滨伏尔加庄园,20220522,全国,全国,67,0,67
143,哈尔滨伏尔加庄园,20220523,全国,全国,66,0,66
144,哈尔滨伏尔加庄园,20220524,全国,全国,71,0,71
145,哈尔滨伏尔加庄园,20220525,全国,全国,65,0,65
146,哈尔滨伏尔加庄园,20220526,全国,全国,125,59,66
147,哈尔滨伏尔加庄园,20220527,全国,全国,66,0,66
148,哈尔滨伏尔加庄园,20220528,全国,全国,73,0,73
149,哈尔滨伏尔加庄园,20220529,全国,全国,130,61,69
150,哈尔滨伏尔加庄园,20220530,全国,全国,70,0,70
151,哈尔滨伏尔加庄园,20220531,全国,全国,70,0,70
152,哈尔滨伏尔加庄园,20220601,全国,全国,126,59,67
153,哈尔滨伏尔加庄园,20220602,全国,全国,91,0,91
154,哈尔滨伏尔加庄园,20220603,全国,全国,82,0,82
155,哈尔滨伏尔加庄园,20220604,全国,全国,89,0,89
156,哈尔滨伏尔加庄园,20220605,全国,全国,69,0,69
157,哈尔滨伏尔加庄园,20220606,全国,全国,150,61,89
158,哈尔滨伏尔加庄园,20220607,全国,全国,95,0,95
159,哈尔滨伏尔加庄园,20220608,全国,全国,148,59,89
160,哈尔滨伏尔加庄园,20220609,全国,全国,144,70,74
161,哈尔滨伏尔加庄园,20220610,全国,全国,93,0,93
162,哈尔滨伏尔加庄园,20220611,全国,全国,78,0,78
163,哈尔滨伏尔加庄园,20220612,全国,全国,97,0,97
164,哈尔滨伏尔加庄园,20220613,全国,全国,146,64,82
165,哈尔滨伏尔加庄园,20220614,全国,全国,69,0,69
166,哈尔滨伏尔加庄园,20220615,全国,全国,76,0,76
167,哈尔滨伏尔加庄园,20220616,全国,全国,135,59,76
168,哈尔滨伏尔加庄园,20220617,全国,全国,137,63,74
169,哈尔滨伏尔加庄园,20220618,全国,全国,79,0,79
170,哈尔滨伏尔加庄园,20220619,全国,全国,97,0,97
171,哈尔滨伏尔加庄园,20220620,全国,全国,150,61,89
172,哈尔滨伏尔加庄园,20220621,全国,全国,141,59,82
173,哈尔滨伏尔加庄园,20220622,全国,全国,150,61,89
174,哈尔滨伏尔加庄园,20220623,全国,全国,83,0,83
175,哈尔滨伏尔加庄园,20220624,全国,全国,141,59,82
176,哈尔滨伏尔加庄园,20220625,全国,全国,82,0,82
177,哈尔滨伏尔加庄园,20220626,全国,全国,76,0,76
178,哈尔滨伏尔加庄园,20220627,全国,全国,150,59,91
179,哈尔滨伏尔加庄园,20220628,全国,全国,165,61,104
180,哈尔滨伏尔加庄园,20220629,全国,全国,148,61,87
181,哈尔滨伏尔加庄园,20220630,全国,全国,165,63,102
182,哈尔滨伏尔加庄园,20220701,全国,全国,142,59,83
183,哈尔滨伏尔加庄园,20220702,全国,全国,86,0,86
184,哈尔滨伏尔加庄园,20220703,全国,全国,109,0,109
185,哈尔滨伏尔加庄园,20220704,全国,全国,154,63,91
186,哈尔滨伏尔加庄园,20220705,全国,全国,169,59,110
187,哈尔滨伏尔加庄园,20220706,全国,全国,152,66,86
188,哈尔滨伏尔加庄园,20220707,全国,全国,163,61,102
189,哈尔滨伏尔加庄园,20220708,全国,全国,145,59,86
190,哈尔滨伏尔加庄园,20220709,全国,全国,106,0,106
191,哈尔滨伏尔加庄园,20220710,全国,全国,109,0,109
192,哈尔滨伏尔加庄园,20220711,全国,全国,178,66,112
193,哈尔滨伏尔加庄园,20220712,全国,全国,218,63,155
194,哈尔滨伏尔加庄园,20220713,全国,全国,179,61,118
195,哈尔滨伏尔加庄园,20220714,全国,全国,212,61,151
196,哈尔滨伏尔加庄园,20220715,全国,全国,215,70,145
197,哈尔滨伏尔加庄园,20220716,全国,全国,191,61,130
198,哈尔滨伏尔加庄园,20220717,全国,全国,219,59,160
199,哈尔滨伏尔加庄园,20220718,全国,全国,211,59,152
200,哈尔滨伏尔加庄园,20220719,全国,全国,191,66,125
201,哈尔滨伏尔加庄园,20220720,全国,全国,217,59,158
202,哈尔滨伏尔加庄园,20220721,全国,全国,229,72,157
203,哈尔滨伏尔加庄园,20220722,全国,全国,206,72,134
204,哈尔滨伏尔加庄园,20220723,全国,全国,208,64,144
205,哈尔滨伏尔加庄园,20220724,全国,全国,210,59,151
206,哈尔滨伏尔加庄园,20220725,全国,全国,195,61,134
207,哈尔滨伏尔加庄园,20220726,全国,全国,187,59,128
208,哈尔滨伏尔加庄园,20220727,全国,全国,211,59,152
209,哈尔滨伏尔加庄园,20220728,全国,全国,219,72,147
210,哈尔滨伏尔加庄园,20220729,全国,全国,180,61,119
211,哈尔滨伏尔加庄园,20220730,全国,全国,206,59,147
212,哈尔滨伏尔加庄园,20220731,全国,全国,125,0,125
213,哈尔滨伏尔加庄园,20220801,全国,全国,198,63,135
214,哈尔滨伏尔加庄园,20220802,全国,全国,198,64,134
215,哈尔滨伏尔加庄园,20220803,全国,全国,185,64,121
216,哈尔滨伏尔加庄园,20220804,全国,全国,211,70,141
217,哈尔滨伏尔加庄园,20220805,全国,全国,196,64,132
218,哈尔滨伏尔加庄园,20220806,全国,全国,148,0,148
219,哈尔滨伏尔加庄园,20220807,全国,全国,118,0,118
220,哈尔滨伏尔加庄园,20220808,全国,全国,214,63,151
221,哈尔滨伏尔加庄园,20220809,全国,全国,184,66,118
222,哈尔滨伏尔加庄园,20220810,全国,全国,167,61,106
223,哈尔滨伏尔加庄园,20220811,全国,全国,145,0,145
224,哈尔滨伏尔加庄园,20220812,全国,全国,209,61,148
225,哈尔滨伏尔加庄园,20220813,全国,全国,203,64,139
226,哈尔滨伏尔加庄园,20220814,全国,全国,178,59,119
227,哈尔滨伏尔加庄园,20220815,全国,全国,184,59,125
228,哈尔滨伏尔加庄园,20220816,全国,全国,181,59,122
229,哈尔滨伏尔加庄园,20220817,全国,全国,187,61,126
230,哈尔滨伏尔加庄园,20220818,全国,全国,189,63,126
231,哈尔滨伏尔加庄园,20220819,全国,全国,126,0,126
232,哈尔滨伏尔加庄园,20220820,全国,全国,184,63,121
233,哈尔滨伏尔加庄园,20220821,全国,全国,110,0,110
234,哈尔滨伏尔加庄园,20220822,全国,全国,171,63,108
235,哈尔滨伏尔加庄园,20220823,全国,全国,204,70,134
236,哈尔滨伏尔加庄园,20220824,全国,全国,105,0,105
237,哈尔滨伏尔加庄园,20220825,全国,全国,159,59,100
238,哈尔滨伏尔加庄园,20220826,全国,全国,165,59,106
239,哈尔滨伏尔加庄园,20220827,全国,全国,122,0,122
240,哈尔滨伏尔加庄园,20220828,全国,全国,139,59,80
241,哈尔滨伏尔加庄园,20220829,全国,全国,74,0,74
242,哈尔滨伏尔加庄园,20220830,全国,全国,139,61,78
243,哈尔滨伏尔加庄园,20220831,全国,全国,132,61,71
244,哈尔滨伏尔加庄园,20220901,全国,全国,130,61,69
245,哈尔滨伏尔加庄园,20220902,全国,全国,69,0,69
246,哈尔滨伏尔加庄园,20220903,全国,全国,67,0,67
247,哈尔滨伏尔加庄园,20220904,全国,全国,71,0,71
248,哈尔滨伏尔加庄园,20220905,全国,全国,69,0,69
249,哈尔滨伏尔加庄园,20220906,全国,全国,128,61,67
250,哈尔滨伏尔加庄园,20220907,全国,全国,135,59,76
251,哈尔滨伏尔加庄园,20220908,全国,全国,92,0,92
252,哈尔滨伏尔加庄园,20220909,全国,全国,80,0,80
253,哈尔滨伏尔加庄园,20220910,全国,全国,167,59,108
254,哈尔滨伏尔加庄园,20220911,全国,全国,167,63,104
255,哈尔滨伏尔加庄园,20220912,全国,全国,96,0,96
256,哈尔滨伏尔加庄园,20220913,全国,全国,158,63,95
257,哈尔滨伏尔加庄园,20220914,全国,全国,141,59,82
258,哈尔滨伏尔加庄园,20220915,全国,全国,141,61,80
259,哈尔滨伏尔加庄园,20220916,全国,全国,141,59,82
260,哈尔滨伏尔加庄园,20220917,全国,全国,113,0,113
261,哈尔滨伏尔加庄园,20220918,全国,全国,161,66,95
262,哈尔滨伏尔加庄园,20220919,全国,全国,146,59,87
263,哈尔滨伏尔加庄园,20220920,全国,全国,150,61,89
264,哈尔滨伏尔加庄园,20220921,全国,全国,91,0,91
265,哈尔滨伏尔加庄园,20220922,全国,全国,136,63,73
266,哈尔滨伏尔加庄园,20220923,全国,全国,137,59,78
267,哈尔滨伏尔加庄园,20220924,全国,全国,126,59,67
268,哈尔滨伏尔加庄园,20220925,全国,全国,73,0,73
269,哈尔滨伏尔加庄园,20220926,全国,全国,131,64,67
270,哈尔滨伏尔加庄园,20220927,全国,全国,76,0,76
271,哈尔滨伏尔加庄园,20220928,全国,全国,134,64,70
272,哈尔滨伏尔加庄园,20220929,全国,全国,137,61,76
273,哈尔滨伏尔加庄园,20220930,全国,全国,148,68,80
274,哈尔滨伏尔加庄园,20221001,全国,全国,141,59,82
275,哈尔滨伏尔加庄园,20221002,全国,全国,80,0,80
276,哈尔滨伏尔加庄园,20221003,全国,全国,130,59,71
277,哈尔滨伏尔加庄园,20221004,全国,全国,87,0,87
278,哈尔滨伏尔加庄园,20221005,全国,全国,76,0,76
279,哈尔滨伏尔加庄园,20221006,全国,全国,82,0,82
280,哈尔滨伏尔加庄园,20221007,全国,全国,148,59,89
281,哈尔滨伏尔加庄园,20221008,全国,全国,132,61,71
282,哈尔滨伏尔加庄园,20221009,全国,全国,135,59,76
283,哈尔滨伏尔加庄园,20221010,全国,全国,76,0,76
284,哈尔滨伏尔加庄园,20221011,全国,全国,76,0,76
285,哈尔滨伏尔加庄园,20221012,全国,全国,140,70,70
286,哈尔滨伏尔加庄园,20221013,全国,全国,131,64,67
287,哈尔滨伏尔加庄园,20221014,全国,全国,61,61,0
288,哈尔滨伏尔加庄园,20221015,全国,全国,66,0,66
289,哈尔滨伏尔加庄园,20221016,全国,全国,66,0,66
290,哈尔滨伏尔加庄园,20221017,全国,全国,128,61,67
291,哈尔滨伏尔加庄园,20221018,全国,全国,146,66,80
292,哈尔滨伏尔加庄园,20221019,全国,全国,139,59,80
293,哈尔滨伏尔加庄园,20221020,全国,全国,78,0,78
294,哈尔滨伏尔加庄园,20221021,全国,全国,129,59,70
295,哈尔滨伏尔加庄园,20221022,全国,全国,95,0,95
296,哈尔滨伏尔加庄园,20221023,全国,全国,87,0,87
297,哈尔滨伏尔加庄园,20221024,全国,全国,73,0,73
298,哈尔滨伏尔加庄园,20221025,全国,全国,76,0,76
299,哈尔滨伏尔加庄园,20221026,全国,全国,74,0,74
300,哈尔滨伏尔加庄园,20221027,全国,全国,79,0,79
301,哈尔滨伏尔加庄园,20221028,全国,全国,132,63,69
302,哈尔滨伏尔加庄园,20221029,全国,全国,135,59,76
303,哈尔滨伏尔加庄园,20221030,全国,全国,79,0,79
304,哈尔滨伏尔加庄园,20221031,全国,全国,76,0,76
305,哈尔滨伏尔加庄园,20221101,全国,全国,80,0,80
306,哈尔滨伏尔加庄园,20221102,全国,全国,76,0,76
307,哈尔滨伏尔加庄园,20221103,全国,全国,135,61,74
308,哈尔滨伏尔加庄园,20221104,全国,全国,130,63,67
309,哈尔滨伏尔加庄园,20221105,全国,全国,66,0,66
310,哈尔滨伏尔加庄园,20221106,全国,全国,86,0,86
311,哈尔滨伏尔加庄园,20221107,全国,全国,140,61,79
312,哈尔滨伏尔加庄园,20221108,全国,全国,69,0,69
313,哈尔滨伏尔加庄园,20221109,全国,全国,126,59,67
314,哈尔滨伏尔加庄园,20221110,全国,全国,134,64,70
315,哈尔滨伏尔加庄园,20221111,全国,全国,69,0,69
316,哈尔滨伏尔加庄园,20221112,全国,全国,66,0,66
317,哈尔滨伏尔加庄园,20221113,全国,全国,144,61,83
318,哈尔滨伏尔加庄园,20221114,全国,全国,69,0,69
319,哈尔滨伏尔加庄园,20221115,全国,全国,61,0,61
320,哈尔滨伏尔加庄园,20221116,全国,全国,82,0,82
321,哈尔滨伏尔加庄园,20221117,全国,全国,139,66,73
322,哈尔滨伏尔加庄园,20221118,全国,全国,133,59,74
323,哈尔滨伏尔加庄园,20221119,全国,全国,66,0,66
324,哈尔滨伏尔加庄园,20221120,全国,全国,74,0,74
325,哈尔滨伏尔加庄园,20221121,全国,全国,63,0,63
326,哈尔滨伏尔加庄园,20221122,全国,全国,126,61,65
327,哈尔滨伏尔加庄园,20221123,全国,全国,128,61,67
328,哈尔滨伏尔加庄园,20221124,全国,全国,69,0,69
329,哈尔滨伏尔加庄园,20221125,全国,全国,134,61,73
330,哈尔滨伏尔加庄园,20221126,全国,全国,65,0,65
331,哈尔滨伏尔加庄园,20221127,全国,全国,130,64,66
332,哈尔滨伏尔加庄园,20221128,全国,全国,65,0,65
333,哈尔滨伏尔加庄园,20221129,全国,全国,120,59,61
334,哈尔滨伏尔加庄园,20221130,全国,全国,66,0,66
335,哈尔滨伏尔加庄园,20221201,全国,全国,122,61,61
336,哈尔滨伏尔加庄园,20221202,全国,全国,128,59,69
337,哈尔滨伏尔加庄园,20221203,全国,全国,65,0,65
338,哈尔滨伏尔加庄园,20221204,全国,全国,0,0,0
339,哈尔滨伏尔加庄园,20221205,全国,全国,125,59,66
340,哈尔滨伏尔加庄园,20221206,全国,全国,66,0,66
341,哈尔滨伏尔加庄园,20221207,全国,全国,134,61,73
342,哈尔滨伏尔加庄园,20221208,全国,全国,135,59,76
343,哈尔滨伏尔加庄园,20221209,全国,全国,141,59,82
344,哈尔滨伏尔加庄园,20221210,全国,全国,0,0,0
345,哈尔滨伏尔加庄园,20221211,全国,全国,73,0,73
346,哈尔滨伏尔加庄园,20221212,全国,全国,134,61,73
347,哈尔滨伏尔加庄园,20221213,全国,全国,130,59,71
348,哈尔滨伏尔加庄园,20221214,全国,全国,126,61,65
349,哈尔滨伏尔加庄园,20221215,全国,全国,74,0,74
350,哈尔滨伏尔加庄园,20221216,全国,全国,69,0,69
351,哈尔滨伏尔加庄园,20221217,全国,全国,0,0,0
352,哈尔滨伏尔加庄园,20221218,全国,全国,124,61,63
353,哈尔滨伏尔加庄园,20221219,全国,全国,137,63,74
354,哈尔滨伏尔加庄园,20221220,全国,全国,73,0,73
355,哈尔滨伏尔加庄园,20221221,全国,全国,127,61,66
356,哈尔滨伏尔加庄园,20221222,全国,全国,126,59,67
357,哈尔滨伏尔加庄园,20221223,全国,全国,126,61,65
358,哈尔滨伏尔加庄园,20221224,全国,全国,73,0,73
359,哈尔滨伏尔加庄园,20221225,全国,全国,67,0,67
360,哈尔滨伏尔加庄园,20221226,全国,全国,130,59,71
361,哈尔滨伏尔加庄园,20221227,全国,全国,130,59,71
362,哈尔滨伏尔加庄园,20221228,全国,全国,73,0,73
363,哈尔滨伏尔加庄园,20221229,全国,全国,134,63,71
364,哈尔滨伏尔加庄园,20221230,全国,全国,133,59,74
365,哈尔滨伏尔加庄园,20221231,全国,全国,137,61,76
366,哈尔滨伏尔加庄园,20230101,全国,全国,63,0,63
367,哈尔滨伏尔加庄园,20230102,全国,全国,127,61,66
368,哈尔滨伏尔加庄园,20230103,全国,全国,71,0,71
369,哈尔滨伏尔加庄园,20230104,全国,全国,139,59,80
370,哈尔滨伏尔加庄园,20230105,全国,全国,141,63,78
371,哈尔滨伏尔加庄园,20230106,全国,全国,142,64,78
372,哈尔滨伏尔加庄园,20230107,全国,全国,148,61,87
373,哈尔滨伏尔加庄园,20230108,全国,全国,109,0,109
374,哈尔滨伏尔加庄园,20230109,全国,全国,149,66,83
375,哈尔滨伏尔加庄园,20230110,全国,全国,146,70,76
376,哈尔滨伏尔加庄园,20230111,全国,全国,163,70,93
377,哈尔滨伏尔加庄园,20230112,全国,全国,163,63,100
378,哈尔滨伏尔加庄园,20230113,全国,全国,83,0,83
379,哈尔滨伏尔加庄园,20230114,全国,全国,84,0,84
380,哈尔滨伏尔加庄园,20230115,全国,全国,91,0,91
381,哈尔滨伏尔加庄园,20230116,全国,全国,145,66,79
382,哈尔滨伏尔加庄园,20230117,全国,全国,139,68,71
383,哈尔滨伏尔加庄园,20230118,全国,全国,143,63,80
384,哈尔滨伏尔加庄园,20230119,全国,全国,153,64,89
385,哈尔滨伏尔加庄园,20230120,全国,全国,130,63,67
386,哈尔滨伏尔加庄园,20230121,全国,全国,78,0,78
387,哈尔滨伏尔加庄园,20230122,全国,全国,91,0,91
388,哈尔滨伏尔加庄园,20230123,全国,全国,165,61,104
389,哈尔滨伏尔加庄园,20230124,全国,全国,112,0,112
390,哈尔滨伏尔加庄园,20230125,全国,全国,180,59,121
391,哈尔滨伏尔加庄园,20230126,全国,全国,119,0,119
392,哈尔滨伏尔加庄园,20230127,全国,全国,164,59,105
393,哈尔滨伏尔加庄园,20230128,全国,全国,106,0,106
394,哈尔滨伏尔加庄园,20230129,全国,全国,163,64,99
395,哈尔滨伏尔加庄园,20230130,全国,全国,150,63,87
396,哈尔滨伏尔加庄园,20230131,全国,全国,214,63,151
397,哈尔滨伏尔加庄园,20230201,全国,全国,191,72,119
398,哈尔滨伏尔加庄园,20230202,全国,全国,172,63,109
399,哈尔滨伏尔加庄园,20230203,全国,全国,160,68,92
400,哈尔滨伏尔加庄园,20230204,全国,全国,147,61,86
401,哈尔滨伏尔加庄园,20230205,全国,全国,146,59,87
402,哈尔滨伏尔加庄园,20230206,全国,全国,145,61,84
403,哈尔滨伏尔加庄园,20230207,全国,全国,163,70,93
404,哈尔滨伏尔加庄园,20230208,全国,全国,152,61,91
405,哈尔滨伏尔加庄园,20230209,全国,全国,154,59,95
406,哈尔滨伏尔加庄园,20230210,全国,全国,156,63,93
407,哈尔滨伏尔加庄园,20230211,全国,全国,159,70,89
408,哈尔滨伏尔加庄园,20230212,全国,全国,95,0,95
409,哈尔滨伏尔加庄园,20230213,全国,全国,149,63,86
410,哈尔滨伏尔加庄园,20230214,全国,全国,143,64,79
411,哈尔滨伏尔加庄园,20230215,全国,全国,142,59,83
412,哈尔滨伏尔加庄园,20230216,全国,全国,151,72,79
413,哈尔滨伏尔加庄园,20230217,全国,全国,137,61,76
414,哈尔滨伏尔加庄园,20230218,全国,全国,99,0,99
415,哈尔滨伏尔加庄园,20230219,全国,全国,82,0,82
416,哈尔滨伏尔加庄园,20230220,全国,全国,141,59,82
417,哈尔滨伏尔加庄园,20230221,全国,全国,137,63,74
418,哈尔滨伏尔加庄园,20230222,全国,全国,134,64,70
419,哈尔滨伏尔加庄园,20230223,全国,全国,137,61,76
420,哈尔滨伏尔加庄园,20230224,全国,全国,140,64,76
421,哈尔滨伏尔加庄园,20230225,全国,全国,134,61,73
422,哈尔滨伏尔加庄园,20230226,全国,全国,84,0,84
423,哈尔滨伏尔加庄园,20230227,全国,全国,141,63,78
424,哈尔滨伏尔加庄园,20230228,全国,全国,69,0,69
425,哈尔滨伏尔加庄园,20230301,全国,全国,132,61,71
426,哈尔滨伏尔加庄园,20230302,全国,全国,137,66,71
427,哈尔滨伏尔加庄园,20230303,全国,全国,141,61,80
428,哈尔滨伏尔加庄园,20230304,全国,全国,91,0,91
429,哈尔滨伏尔加庄园,20230305,全国,全国,138,59,79
430,哈尔滨伏尔加庄园,20230306,全国,全国,135,59,76
431,哈尔滨伏尔加庄园,20230307,全国,全国,132,59,73
432,哈尔滨伏尔加庄园,20230308,全国,全国,69,0,69
433,哈尔滨伏尔加庄园,20230309,全国,全国,143,61,82
434,哈尔滨伏尔加庄园,20230310,全国,全国,69,0,69
435,哈尔滨伏尔加庄园,20230311,全国,全国,78,0,78
436,哈尔滨伏尔加庄园,20230312,全国,全国,82,0,82
437,哈尔滨伏尔加庄园,20230313,全国,全国,76,0,76
438,哈尔滨伏尔加庄园,20230314,全国,全国,132,59,73
439,哈尔滨伏尔加庄园,20230315,全国,全国,145,66,79
440,哈尔滨伏尔加庄园,20230316,全国,全国,78,0,78
441,哈尔滨伏尔加庄园,20230317,全国,全国,80,0,80
442,哈尔滨伏尔加庄园,20230318,全国,全国,135,61,74
443,哈尔滨伏尔加庄园,20230319,全国,全国,83,0,83
444,哈尔滨伏尔加庄园,20230320,全国,全国,70,0,70
445,哈尔滨伏尔加庄园,20230321,全国,全国,140,64,76
446,哈尔滨伏尔加庄园,20230322,全国,全国,127,66,61
447,哈尔滨伏尔加庄园,20230323,全国,全国,73,0,73
448,哈尔滨伏尔加庄园,20230324,全国,全国,137,59,78
449,哈尔滨伏尔加庄园,20230325,全国,全国,126,61,65
450,哈尔滨伏尔加庄园,20230326,全国,全国,80,0,80
451,哈尔滨伏尔加庄园,20230327,全国,全国,137,61,76
452,哈尔滨伏尔加庄园,20230328,全国,全国,139,68,71
453,哈尔滨伏尔加庄园,20230329,全国,全国,143,61,82
454,哈尔滨伏尔加庄园,20230330,全国,全国,147,63,84
455,哈尔滨伏尔加庄园,20230331,全国,全国,133,59,74
456,哈尔滨伏尔加庄园,20230401,全国,全国,135,59,76
457,哈尔滨伏尔加庄园,20230402,全国,全国,86,0,86
458,哈尔滨伏尔加庄园,20230403,全国,全国,153,61,92
459,哈尔滨伏尔加庄园,20230404,全国,全国,145,59,86
460,哈尔滨伏尔加庄园,20230405,全国,全国,76,0,76
461,哈尔滨伏尔加庄园,20230406,全国,全国,132,59,73
462,哈尔滨伏尔加庄园,20230407,全国,全国,135,59,76
463,哈尔滨伏尔加庄园,20230408,全国,全国,86,0,86
464,哈尔滨伏尔加庄园,20230409,全国,全国,154,59,95
465,哈尔滨伏尔加庄园,20230410,全国,全国,148,61,87
466,哈尔滨伏尔加庄园,20230411,全国,全国,157,61,96
467,哈尔滨伏尔加庄园,20230412,全国,全国,143,63,80
468,哈尔滨伏尔加庄园,20230413,全国,全国,139,63,76
469,哈尔滨伏尔加庄园,20230414,全国,全国,138,59,79
470,哈尔滨伏尔加庄园,20230415,全国,全国,82,0,82
471,哈尔滨伏尔加庄园,20230416,全国,全国,91,0,91
472,哈尔滨伏尔加庄园,20230417,全国,全国,158,66,92
473,哈尔滨伏尔加庄园,20230418,全国,全国,95,0,95
474,哈尔滨伏尔加庄园,20230419,全国,全国,156,59,97
475,哈尔滨伏尔加庄园,20230420,全国,全国,172,72,100
476,哈尔滨伏尔加庄园,20230421,全国,全国,143,59,84
477,哈尔滨伏尔加庄园,20230422,全国,全国,165,63,102
478,哈尔滨伏尔加庄园,20230423,全国,全国,167,63,104
479,哈尔滨伏尔加庄园,20230424,全国,全国,174,61,113
480,哈尔滨伏尔加庄园,20230425,全国,全国,169,61,108
481,哈尔滨伏尔加庄园,20230426,全国,全国,160,61,99
482,哈尔滨伏尔加庄园,20230427,全国,全国,181,72,109
483,哈尔滨伏尔加庄园,20230428,全国,全国,225,68,157
484,哈尔滨伏尔加庄园,20230429,全国,全国,155,0,155
485,哈尔滨伏尔加庄园,20230430,全国,全国,147,0,147
486,哈尔滨伏尔加庄园,20230501,全国,全国,229,59,170
487,哈尔滨伏尔加庄园,20230502,全国,全国,138,0,138
488,哈尔滨伏尔加庄园,20230503,全国,全国,110,0,110
489,哈尔滨伏尔加庄园,20230504,全国,全国,152,66,86
490,哈尔滨伏尔加庄园,20230505,全国,全国,89,0,89
491,哈尔滨伏尔加庄园,20230506,全国,全国,138,59,79
492,哈尔滨伏尔加庄园,20230507,全国,全国,143,59,84
493,哈尔滨伏尔加庄园,20230508,全国,全国,142,63,79
494,哈尔滨伏尔加庄园,20230509,全国,全国,132,61,71
495,哈尔滨伏尔加庄园,20230510,全国,全国,91,0,91
496,哈尔滨伏尔加庄园,20230511,全国,全国,133,59,74
497,哈尔滨伏尔加庄园,20230512,全国,全国,130,61,69
498,哈尔滨伏尔加庄园,20230513,全国,全国,83,0,83
499,哈尔滨伏尔加庄园,20230514,全国,全国,155,68,87
500,哈尔滨伏尔加庄园,20230515,全国,全国,150,61,89
501,哈尔滨伏尔加庄园,20230516,全国,全国,149,63,86
502,哈尔滨伏尔加庄园,20230517,全国,全国,137,59,78
503,哈尔滨伏尔加庄园,20230518,全国,全国,170,68,102
504,哈尔滨伏尔加庄园,20230519,全国,全国,151,64,87
505,哈尔滨伏尔加庄园,20230520,全国,全国,96,0,96
506,哈尔滨伏尔加庄园,20230521,全国,全国,73,0,73
507,哈尔滨伏尔加庄园,20230522,全国,全国,138,59,79
508,哈尔滨伏尔加庄园,20230523,全国,全国,140,61,79
509,哈尔滨伏尔加庄园,20230524,全国,全国,145,61,84
510,哈尔滨伏尔加庄园,20230525,全国,全国,168,66,102
511,哈尔滨伏尔加庄园,20230526,全国,全国,177,64,113
512,哈尔滨伏尔加庄园,20230527,全国,全国,87,0,87
513,哈尔滨伏尔加庄园,20230528,全国,全国,89,0,89
514,哈尔滨伏尔加庄园,20230529,全国,全国,191,66,125
515,哈尔滨伏尔加庄园,20230530,全国,全国,194,68,126
516,哈尔滨伏尔加庄园,20230531,全国,全国,166,66,100
517,哈尔滨伏尔加庄园,20230601,全国,全国,150,61,89
518,哈尔滨伏尔加庄园,20230602,全国,全国,160,63,97
519,哈尔滨伏尔加庄园,20230603,全国,全国,95,0,95
520,哈尔滨伏尔加庄园,20230604,全国,全国,176,59,117
521,哈尔滨伏尔加庄园,20230605,全国,全国,181,64,117
522,哈尔滨伏尔加庄园,20230606,全国,全国,95,0,95
523,哈尔滨伏尔加庄园,20230607,全国,全国,174,61,113
524,哈尔滨伏尔加庄园,20230608,全国,全国,178,68,110
525,哈尔滨伏尔加庄园,20230609,全国,全国,93,0,93
526,哈尔滨伏尔加庄园,20230610,全国,全国,112,0,112
527,哈尔滨伏尔加庄园,20230611,全国,全国,160,63,97
528,哈尔滨伏尔加庄园,20230612,全国,全国,173,63,110
529,哈尔滨伏尔加庄园,20230613,全国,全国,198,59,139
530,哈尔滨伏尔加庄园,20230614,全国,全国,204,76,128
531,哈尔滨伏尔加庄园,20230615,全国,全国,80,0,80
532,哈尔滨伏尔加庄园,20230616,全国,全国,178,61,117
533,哈尔滨伏尔加庄园,20230617,全国,全国,117,0,117
534,哈尔滨伏尔加庄园,20230618,全国,全国,191,59,132
535,哈尔滨伏尔加庄园,20230619,全国,全国,185,63,122
536,哈尔滨伏尔加庄园,20230620,全国,全国,189,59,130
537,哈尔滨伏尔加庄园,20230621,全国,全国,183,66,117
538,哈尔滨伏尔加庄园,20230622,全国,全国,128,0,128
539,哈尔滨伏尔加庄园,20230623,全国,全国,134,0,134
540,哈尔滨伏尔加庄园,20230624,全国,全国,174,59,115
541,哈尔滨伏尔加庄园,20230625,全国,全国,160,63,97
542,哈尔滨伏尔加庄园,20230626,全国,全国,163,63,100
543,哈尔滨伏尔加庄园,20230627,全国,全国,144,64,80
544,哈尔滨伏尔加庄园,20230628,全国,全国,151,59,92
545,哈尔滨伏尔加庄园,20230629,全国,全国,109,0,109
546,哈尔滨伏尔加庄园,20230630,全国,全国,163,63,100
547,哈尔滨伏尔加庄园,20230701,全国,全国,164,59,105
548,哈尔滨伏尔加庄园,20230702,全国,全国,171,59,112
549,哈尔滨伏尔加庄园,20230703,全国,全国,180,70,110
550,哈尔滨伏尔加庄园,20230704,全国,全国,170,64,106
551,哈尔滨伏尔加庄园,20230705,全国,全国,176,66,110
552,哈尔滨伏尔加庄园,20230706,全国,全国,183,66,117
553,哈尔滨伏尔加庄园,20230707,全国,全国,191,68,123
554,哈尔滨伏尔加庄园,20230708,全国,全国,194,59,135
555,哈尔滨伏尔加庄园,20230709,全国,全国,197,61,136
556,哈尔滨伏尔加庄园,20230710,全国,全国,174,66,108
557,哈尔滨伏尔加庄园,20230711,全国,全国,197,72,125
558,哈尔滨伏尔加庄园,20230712,全国,全国,185,66,119
559,哈尔滨伏尔加庄园,20230713,全国,全国,200,61,139
560,哈尔滨伏尔加庄园,20230714,全国,全国,172,59,113
561,哈尔滨伏尔加庄园,20230715,全国,全国,194,68,126
562,哈尔滨伏尔加庄园,20230716,全国,全国,210,74,136
563,哈尔滨伏尔加庄园,20230717,全国,全国,188,63,125
564,哈尔滨伏尔加庄园,20230718,全国,全国,219,68,151
565,哈尔滨伏尔加庄园,20230719,全国,全国,209,68,141
566,哈尔滨伏尔加庄园,20230720,全国,全国,206,63,143
567,哈尔滨伏尔加庄园,20230721,全国,全国,192,66,126
568,哈尔滨伏尔加庄园,20230722,全国,全国,193,63,130
569,哈尔滨伏尔加庄园,20230723,全国,全国,195,59,136
570,哈尔滨伏尔加庄园,20230724,全国,全国,212,76,136
571,哈尔滨伏尔加庄园,20230725,全国,全国,211,70,141
572,哈尔滨伏尔加庄园,20230726,全国,全国,207,64,143
573,哈尔滨伏尔加庄园,20230727,全国,全国,226,68,158
574,哈尔滨伏尔加庄园,20230728,全国,全国,200,68,132
575,哈尔滨伏尔加庄园,20230729,全国,全国,223,64,159
576,哈尔滨伏尔加庄园,20230730,全国,全国,229,59,170
577,哈尔滨伏尔加庄园,20230731,全国,全国,220,63,157
578,哈尔滨伏尔加庄园,20230801,全国,全国,211,68,143
579,哈尔滨伏尔加庄园,20230802,全国,全国,216,64,152
580,哈尔滨伏尔加庄园,20230803,全国,全国,208,70,138
581,哈尔滨伏尔加庄园,20230804,全国,全国,194,64,130
582,哈尔滨伏尔加庄园,20230805,全国,全国,222,61,161
583,哈尔滨伏尔加庄园,20230806,全国,全国,248,63,185
584,哈尔滨伏尔加庄园,20230807,全国,全国,207,59,148
585,哈尔滨伏尔加庄园,20230808,全国,全国,190,64,126
586,哈尔滨伏尔加庄园,20230809,全国,全国,189,63,126
587,哈尔滨伏尔加庄园,20230810,全国,全国,178,59,119
588,哈尔滨伏尔加庄园,20230811,全国,全国,112,0,112
589,哈尔滨伏尔加庄园,20230812,全国,全国,169,64,105
590,哈尔滨伏尔加庄园,20230813,全国,全国,113,0,113
591,哈尔滨伏尔加庄园,20230814,全国,全国,199,61,138
592,哈尔滨伏尔加庄园,20230815,全国,全国,191,68,123
593,哈尔滨伏尔加庄园,20230816,全国,全国,181,66,115
594,哈尔滨伏尔加庄园,20230817,全国,全国,159,63,96
595,哈尔滨伏尔加庄园,20230818,全国,全国,202,68,134
596,哈尔滨伏尔加庄园,20230819,全国,全国,177,59,118
597,哈尔滨伏尔加庄园,20230820,全国,全国,174,61,113
598,哈尔滨伏尔加庄园,20230821,全国,全国,195,72,123
599,哈尔滨伏尔加庄园,20230822,全国,全国,117,0,117
600,哈尔滨伏尔加庄园,20230823,全国,全国,154,59,95
601,哈尔滨伏尔加庄园,20230824,全国,全国,178,68,110
602,哈尔滨伏尔加庄园,20230825,全国,全国,189,64,125
603,哈尔滨伏尔加庄园,20230826,全国,全国,173,61,112
604,哈尔滨伏尔加庄园,20230827,全国,全国,169,64,105
605,哈尔滨伏尔加庄园,20230828,全国,全国,168,59,109
606,哈尔滨伏尔加庄园,20230829,全国,全国,148,64,84
607,哈尔滨伏尔加庄园,20230830,全国,全国,145,61,84
608,哈尔滨伏尔加庄园,20230831,全国,全国,159,68,91
609,哈尔滨伏尔加庄园,20230901,全国,全国,159,66,93
610,哈尔滨伏尔加庄园,20230902,全国,全国,158,59,99
611,哈尔滨伏尔加庄园,20230903,全国,全国,151,59,92
612,哈尔滨伏尔加庄园,20230904,全国,全国,150,63,87
613,哈尔滨伏尔加庄园,20230905,全国,全国,158,61,97
614,哈尔滨伏尔加庄园,20230906,全国,全国,84,0,84
615,哈尔滨伏尔加庄园,20230907,全国,全国,168,68,100
616,哈尔滨伏尔加庄园,20230908,全国,全国,169,64,105
617,哈尔滨伏尔加庄园,20230909,全国,全国,166,70,96
618,哈尔滨伏尔加庄园,20230910,全国,全国,178,61,117
619,哈尔滨伏尔加庄园,20230911,全国,全国,174,66,108
620,哈尔滨伏尔加庄园,20230912,全国,全国,87,0,87
621,哈尔滨伏尔加庄园,20230913,全国,全国,155,64,91
622,哈尔滨伏尔加庄园,20230914,全国,全国,153,64,89
623,哈尔滨伏尔加庄园,20230915,全国,全国,166,66,100
624,哈尔滨伏尔加庄园,20230916,全国,全国,162,63,99
625,哈尔滨伏尔加庄园,20230917,全国,全国,100,0,100
626,哈尔滨伏尔加庄园,20230918,全国,全国,165,66,99
627,哈尔滨伏尔加庄园,20230919,全国,全国,150,63,87
628,哈尔滨伏尔加庄园,20230920,全国,全国,160,64,96
629,哈尔滨伏尔加庄园,20230921,全国,全国,162,66,96
630,哈尔滨伏尔加庄园,20230922,全国,全国,176,85,91
631,哈尔滨伏尔加庄园,20230923,全国,全国,163,61,102
632,哈尔滨伏尔加庄园,20230924,全国,全国,177,68,109
633,哈尔滨伏尔加庄园,20230925,全国,全国,170,66,104
634,哈尔滨伏尔加庄园,20230926,全国,全国,170,66,104
635,哈尔滨伏尔加庄园,20230927,全国,全国,160,68,92
636,哈尔滨伏尔加庄园,20230928,全国,全国,199,63,136
637,哈尔滨伏尔加庄园,20230929,全国,全国,138,0,138
638,哈尔滨伏尔加庄园,20230930,全国,全国,193,0,193
639,哈尔滨伏尔加庄园,20231001,全国,全国,228,61,167
640,哈尔滨伏尔加庄园,20231002,全国,全国,219,59,160
641,哈尔滨伏尔加庄园,20231003,全国,全国,224,61,163
642,哈尔滨伏尔加庄园,20231004,全国,全国,119,0,119
643,哈尔滨伏尔加庄园,20231005,全国,全国,173,61,112
644,哈尔滨伏尔加庄园,20231006,全国,全国,155,59,96
645,哈尔滨伏尔加庄园,20231007,全国,全国,166,64,102
646,哈尔滨伏尔加庄园,20231008,全国,全国,84,0,84
647,哈尔滨伏尔加庄园,20231009,全国,全国,144,61,83
648,哈尔滨伏尔加庄园,20231010,全国,全国,135,59,76
649,哈尔滨伏尔加庄园,20231011,全国,全国,150,63,87
650,哈尔滨伏尔加庄园,20231012,全国,全国,150,59,91
651,哈尔滨伏尔加庄园,20231013,全国,全国,137,63,74
652,哈尔滨伏尔加庄园,20231014,全国,全国,138,59,79
653,哈尔滨伏尔加庄园,20231015,全国,全国,145,61,84
654,哈尔滨伏尔加庄园,20231016,全国,全国,147,64,83
655,哈尔滨伏尔加庄园,20231017,全国,全国,149,63,86
656,哈尔滨伏尔加庄园,20231018,全国,全国,149,63,86
657,哈尔滨伏尔加庄园,20231019,全国,全国,149,66,83
658,哈尔滨伏尔加庄园,20231020,全国,全国,137,64,73
659,哈尔滨伏尔加庄园,20231021,全国,全国,71,0,71
660,哈尔滨伏尔加庄园,20231022,全国,全国,139,59,80
661,哈尔滨伏尔加庄园,20231023,全国,全国,134,68,66
662,哈尔滨伏尔加庄园,20231024,全国,全国,130,59,71
663,哈尔滨伏尔加庄园,20231025,全国,全国,152,74,78
664,哈尔滨伏尔加庄园,20231026,全国,全国,127,66,61
665,哈尔滨伏尔加庄园,20231027,全国,全国,139,59,80
666,哈尔滨伏尔加庄园,20231028,全国,全国,78,0,78
667,哈尔滨伏尔加庄园,20231029,全国,全国,137,64,73
668,哈尔滨伏尔加庄园,20231030,全国,全国,74,0,74
669,哈尔滨伏尔加庄园,20231031,全国,全国,126,63,63
670,哈尔滨伏尔加庄园,20231101,全国,全国,135,61,74
671,哈尔滨伏尔加庄园,20231102,全国,全国,128,63,65
672,哈尔滨伏尔加庄园,20231103,全国,全国,156,72,84
673,哈尔滨伏尔加庄园,20231104,全国,全国,126,61,65
674,哈尔滨伏尔加庄园,20231105,全国,全国,130,63,67
675,哈尔滨伏尔加庄园,20231106,全国,全国,137,63,74
676,哈尔滨伏尔加庄园,20231107,全国,全国,63,63,0
677,哈尔滨伏尔加庄园,20231108,全国,全国,136,70,66
678,哈尔滨伏尔加庄园,20231109,全国,全国,142,66,76
679,哈尔滨伏尔加庄园,20231110,全国,全国,142,68,74
680,哈尔滨伏尔加庄园,20231111,全国,全国,130,59,71
681,哈尔滨伏尔加庄园,20231112,全国,全国,83,0,83
682,哈尔滨伏尔加庄园,20231113,全国,全国,147,76,71
683,哈尔滨伏尔加庄园,20231114,全国,全国,142,63,79
684,哈尔滨伏尔加庄园,20231115,全国,全国,136,66,70
685,哈尔滨伏尔加庄园,20231116,全国,全国,137,61,76
686,哈尔滨伏尔加庄园,20231117,全国,全国,133,59,74
687,哈尔滨伏尔加庄园,20231118,全国,全国,138,64,74
688,哈尔滨伏尔加庄园,20231119,全国,全国,141,59,82
689,哈尔滨伏尔加庄园,20231120,全国,全国,146,64,82
690,哈尔滨伏尔加庄园,20231121,全国,全国,149,70,79
691,哈尔滨伏尔加庄园,20231122,全国,全国,159,72,87
692,哈尔滨伏尔加庄园,20231123,全国,全国,126,59,67
693,哈尔滨伏尔加庄园,20231124,全国,全国,157,66,91
694,哈尔滨伏尔加庄园,20231125,全国,全国,137,59,78
695,哈尔滨伏尔加庄园,20231126,全国,全国,83,0,83
696,哈尔滨伏尔加庄园,20231127,全国,全国,141,63,78
697,哈尔滨伏尔加庄园,20231128,全国,全国,149,66,83
698,哈尔滨伏尔加庄园,20231129,全国,全国,145,66,79
699,哈尔滨伏尔加庄园,20231130,全国,全国,151,64,87
700,哈尔滨伏尔加庄园,20231201,全国,全国,156,70,86
701,哈尔滨伏尔加庄园,20231202,全国,全国,132,59,73
702,哈尔滨伏尔加庄园,20231203,全国,全国,76,0,76
703,哈尔滨伏尔加庄园,20231204,全国,全国,152,68,84
704,哈尔滨伏尔加庄园,20231205,全国,全国,150,70,80
705,哈尔滨伏尔加庄园,20231206,全国,全国,159,66,93
706,哈尔滨伏尔加庄园,20231207,全国,全国,143,70,73
707,哈尔滨伏尔加庄园,20231208,全国,全国,152,68,84
708,哈尔滨伏尔加庄园,20231209,全国,全国,159,59,100
709,哈尔滨伏尔加庄园,20231210,全国,全国,142,59,83
710,哈尔滨伏尔加庄园,20231211,全国,全国,156,74,82
711,哈尔滨伏尔加庄园,20231212,全国,全国,142,68,74
712,哈尔滨伏尔加庄园,20231213,全国,全国,140,64,76
713,哈尔滨伏尔加庄园,20231214,全国,全国,159,66,93
714,哈尔滨伏尔加庄园,20231215,全国,全国,169,70,99
715,哈尔滨伏尔加庄园,20231216,全国,全国,145,59,86
716,哈尔滨伏尔加庄园,20231217,全国,全国,173,61,112
717,哈尔滨伏尔加庄园,20231218,全国,全国,175,76,99
718,哈尔滨伏尔加庄园,20231219,全国,全国,170,66,104
719,哈尔滨伏尔加庄园,20231220,全国,全国,172,72,100
720,哈尔滨伏尔加庄园,20231221,全国,全国,176,70,106
721,哈尔滨伏尔加庄园,20231222,全国,全国,176,72,104
722,哈尔滨伏尔加庄园,20231223,全国,全国,171,66,105
723,哈尔滨伏尔加庄园,20231224,全国,全国,150,59,91
724,哈尔滨伏尔加庄园,20231225,全国,全国,108,0,108
725,哈尔滨伏尔加庄园,20231226,全国,全国,197,76,121
726,哈尔滨伏尔加庄园,20231227,全国,全国,216,72,144
727,哈尔滨伏尔加庄园,20231228,全国,全国,191,72,119
728,哈尔滨伏尔加庄园,20231229,全国,全国,182,80,102
729,哈尔滨伏尔加庄园,20231230,全国,全国,182,64,118
730,哈尔滨伏尔加庄园,20231231,全国,全国,184,61,123
731,哈尔滨伏尔加庄园,20240101,全国,全国,181,63,118
732,哈尔滨伏尔加庄园,20240102,全国,全国,181,85,96
733,哈尔滨伏尔加庄园,20240103,全国,全国,207,82,125
734,哈尔滨伏尔加庄园,20240104,全国,全国,385,110,275
735,哈尔滨伏尔加庄园,20240105,全国,全国,338,102,236
736,哈尔滨伏尔加庄园,20240106,全国,全国,268,85,183
737,哈尔滨伏尔加庄园,20240107,全国,全国,332,91,241
738,哈尔滨伏尔加庄园,20240108,全国,全国,272,102,170
739,哈尔滨伏尔加庄园,20240109,全国,全国,237,101,136
740,哈尔滨伏尔加庄园,20240110,全国,全国,241,93,148
741,哈尔滨伏尔加庄园,20240111,全国,全国,208,85,123
742,哈尔滨伏尔加庄园,20240112,全国,全国,218,82,136
743,哈尔滨伏尔加庄园,20240113,全国,全国,231,68,163
744,哈尔滨伏尔加庄园,20240114,全国,全国,222,74,148
745,哈尔滨伏尔加庄园,20240115,全国,全国,210,76,134
746,哈尔滨伏尔加庄园,20240116,全国,全国,201,89,112
747,哈尔滨伏尔加庄园,20240117,全国,全国,193,68,125
748,哈尔滨伏尔加庄园,20240118,全国,全国,203,72,131
749,哈尔滨伏尔加庄园,20240119,全国,全国,179,64,115
750,哈尔滨伏尔加庄园,20240120,全国,全国,167,59,108
751,哈尔滨伏尔加庄园,20240121,全国,全国,188,66,122
752,哈尔滨伏尔加庄园,20240122,全国,全国,179,66,113
753,哈尔滨伏尔加庄园,20240123,全国,全国,193,72,121
754,哈尔滨伏尔加庄园,20240124,全国,全国,205,74,131
755,哈尔滨伏尔加庄园,20240125,全国,全国,184,66,118
756,哈尔滨伏尔加庄园,20240126,全国,全国,203,68,135
757,哈尔滨伏尔加庄园,20240127,全国,全国,195,63,132
758,哈尔滨伏尔加庄园,20240128,全国,全国,134,0,134
759,哈尔滨伏尔加庄园,20240129,全国,全国,204,63,141
760,哈尔滨伏尔加庄园,20240130,全国,全国,175,66,109
761,哈尔滨伏尔加庄园,20240131,全国,全国,174,68,106
762,哈尔滨伏尔加庄园,20240201,全国,全国,199,68,131
763,哈尔滨伏尔加庄园,20240202,全国,全国,178,61,117
764,哈尔滨伏尔加庄园,20240203,全国,全国,134,0,134
765,哈尔滨伏尔加庄园,20240204,全国,全国,164,68,96
766,哈尔滨伏尔加庄园,20240205,全国,全国,176,66,110
767,哈尔滨伏尔加庄园,20240206,全国,全国,117,0,117
768,哈尔滨伏尔加庄园,20240207,全国,全国,159,59,100
769,哈尔滨伏尔加庄园,20240208,全国,全国,171,66,105
770,哈尔滨伏尔加庄园,20240209,全国,全国,86,0,86
771,哈尔滨伏尔加庄园,20240210,全国,全国,118,0,118
772,哈尔滨伏尔加庄园,20240211,全国,全国,149,0,149
773,哈尔滨伏尔加庄园,20240212,全国,全国,157,0,157
774,哈尔滨伏尔加庄园,20240213,全国,全国,212,0,212
775,哈尔滨伏尔加庄园,20240214,全国,全国,181,0,181
776,哈尔滨伏尔加庄园,20240215,全国,全国,234,66,168
777,哈尔滨伏尔加庄园,20240216,全国,全国,230,63,167
778,哈尔滨伏尔加庄园,20240217,全国,全国,206,59,147
779,哈尔滨伏尔加庄园,20240218,全国,全国,196,64,132
780,哈尔滨伏尔加庄园,20240219,全国,全国,164,68,96
781,哈尔滨伏尔加庄园,20240220,全国,全国,163,63,100
782,哈尔滨伏尔加庄园,20240221,全国,全国,142,64,78
783,哈尔滨伏尔加庄园,20240222,全国,全国,141,59,82
784,哈尔滨伏尔加庄园,20240223,全国,全国,134,63,71
785,哈尔滨伏尔加庄园,20240224,全国,全国,76,0,76
786,哈尔滨伏尔加庄园,20240225,全国,全国,76,0,76
787,哈尔滨伏尔加庄园,20240226,全国,全国,145,59,86
788,哈尔滨伏尔加庄园,20240227,全国,全国,142,59,83
789,哈尔滨伏尔加庄园,20240228,全国,全国,147,68,79
790,哈尔滨伏尔加庄园,20240229,全国,全国,71,0,71
791,哈尔滨伏尔加庄园,20240301,全国,全国,71,0,71
792,哈尔滨伏尔加庄园,20240302,全国,全国,82,0,82
793,哈尔滨伏尔加庄园,20240303,全国,全国,69,0,69
794,哈尔滨伏尔加庄园,20240304,全国,全国,141,61,80
795,哈尔滨伏尔加庄园,20240305,全国,全国,142,68,74
796,哈尔滨伏尔加庄园,20240306,全国,全国,74,0,74
797,哈尔滨伏尔加庄园,20240307,全国,全国,127,61,66
798,哈尔滨伏尔加庄园,20240308,全国,全国,127,61,66
799,哈尔滨伏尔加庄园,20240309,全国,全国,124,59,65
800,哈尔滨伏尔加庄园,20240310,全国,全国,135,59,76
801,哈尔滨伏尔加庄园,20240311,全国,全国,133,66,67
802,哈尔滨伏尔加庄园,20240312,全国,全国,126,59,67
803,哈尔滨伏尔加庄园,20240313,全国,全国,130,63,67
804,哈尔滨伏尔加庄园,20240314,全国,全国,137,59,78
805,哈尔滨伏尔加庄园,20240315,全国,全国,65,0,65
806,哈尔滨伏尔加庄园,20240316,全国,全国,131,68,63
807,哈尔滨伏尔加庄园,20240317,全国,全国,124,59,65
808,哈尔滨伏尔加庄园,20240318,全国,全国,73,0,73
809,哈尔滨伏尔加庄园,20240319,全国,全国,127,61,66
810,哈尔滨伏尔加庄园,20240320,全国,全国,137,63,74
811,哈尔滨伏尔加庄园,20240321,全国,全国,61,0,61
812,哈尔滨伏尔加庄园,20240322,全国,全国,59,59,0
813,哈尔滨伏尔加庄园,20240323,全国,全国,130,59,71
814,哈尔滨伏尔加庄园,20240324,全国,全国,65,0,65
815,哈尔滨伏尔加庄园,20240325,全国,全国,63,63,0
816,哈尔滨伏尔加庄园,20240326,全国,全国,126,59,67
817,哈尔滨伏尔加庄园,20240327,全国,全国,126,61,65
818,哈尔滨伏尔加庄园,20240328,全国,全国,133,66,67
819,哈尔滨伏尔加庄园,20240329,全国,全国,132,61,71
820,哈尔滨伏尔加庄园,20240330,全国,全国,70,0,70
821,哈尔滨伏尔加庄园,20240331,全国,全国,67,0,67
822,哈尔滨伏尔加庄园,20240401,全国,全国,140,61,79
823,哈尔滨伏尔加庄园,20240402,全国,全国,140,64,76
824,哈尔滨伏尔加庄园,20240403,全国,全国,139,59,80
825,哈尔滨伏尔加庄园,20240404,全国,全国,100,0,100
826,哈尔滨伏尔加庄园,20240405,全国,全国,82,0,82
827,哈尔滨伏尔加庄园,20240406,全国,全国,76,0,76
828,哈尔滨伏尔加庄园,20240407,全国,全国,142,64,78
829,哈尔滨伏尔加庄园,20240408,全国,全国,132,59,73
830,哈尔滨伏尔加庄园,20240409,全国,全国,139,66,73
831,哈尔滨伏尔加庄园,20240410,全国,全国,133,57,76
832,哈尔滨伏尔加庄园,20240411,全国,全国,134,64,70
833,哈尔滨伏尔加庄园,20240412,全国,全国,139,63,76
834,哈尔滨伏尔加庄园,20240413,全国,全国,133,57,76
835,哈尔滨伏尔加庄园,20240414,全国,全国,137,57,80
836,哈尔滨伏尔加庄园,20240415,全国,全国,148,74,74
837,哈尔滨伏尔加庄园,20240416,全国,全国,128,61,67
838,哈尔滨伏尔加庄园,20240417,全国,全国,143,61,82
839,哈尔滨伏尔加庄园,20240418,全国,全国,142,63,79
840,哈尔滨伏尔加庄园,20240419,全国,全国,146,68,78
841,哈尔滨伏尔加庄园,20240420,全国,全国,137,59,78
842,哈尔滨伏尔加庄园,20240421,全国,全国,83,0,83
843,哈尔滨伏尔加庄园,20240422,全国,全国,147,61,86
844,哈尔滨伏尔加庄园,20240423,全国,全国,156,64,92
845,哈尔滨伏尔加庄园,20240424,全国,全国,152,63,89
846,哈尔滨伏尔加庄园,20240425,全国,全国,146,59,87
847,哈尔滨伏尔加庄园,20240426,全国,全国,150,63,87
848,哈尔滨伏尔加庄园,20240427,全国,全国,169,59,110
849,哈尔滨伏尔加庄园,20240428,全国,全国,189,76,113
850,哈尔滨伏尔加庄园,20240429,全国,全国,163,59,104
851,哈尔滨伏尔加庄园,20240430,全国,全国,225,74,151
1,北方森林动物园,20220101,全国,全国,0,0,0
2,北方森林动物园,20220102,全国,全国,0,0,0
3,北方森林动物园,20220103,全国,全国,61,0,61
4,北方森林动物园,20220104,全国,全国,0,0,0
5,北方森林动物园,20220105,全国,全国,0,0,0
6,北方森林动物园,20220106,全国,全国,61,0,61
7,北方森林动物园,20220107,全国,全国,59,59,0
8,北方森林动物园,20220108,全国,全国,0,0,0
9,北方森林动物园,20220109,全国,全国,0,0,0
10,北方森林动物园,20220110,全国,全国,0,0,0
11,北方森林动物园,20220111,全国,全国,0,0,0
12,北方森林动物园,20220112,全国,全国,61,0,61
13,北方森林动物园,20220113,全国,全国,59,59,0
14,北方森林动物园,20220114,全国,全国,0,0,0
15,北方森林动物园,20220115,全国,全国,0,0,0
16,北方森林动物园,20220116,全国,全国,0,0,0
17,北方森林动物园,20220117,全国,全国,0,0,0
18,北方森林动物园,20220118,全国,全国,0,0,0
19,北方森林动物园,20220119,全国,全国,0,0,0
20,北方森林动物园,20220120,全国,全国,59,59,0
21,北方森林动物园,20220121,全国,全国,0,0,0
22,北方森林动物园,20220122,全国,全国,0,0,0
23,北方森林动物园,20220123,全国,全国,0,0,0
24,北方森林动物园,20220124,全国,全国,0,0,0
25,北方森林动物园,20220125,全国,全国,0,0,0
26,北方森林动物园,20220126,全国,全国,0,0,0
27,北方森林动物园,20220127,全国,全国,0,0,0
28,北方森林动物园,20220128,全国,全国,0,0,0
29,北方森林动物园,20220129,全国,全国,0,0,0
30,北方森林动物园,20220130,全国,全国,59,59,0
31,北方森林动物园,20220131,全国,全国,0,0,0
32,北方森林动物园,20220201,全国,全国,0,0,0
33,北方森林动物园,20220202,全国,全国,0,0,0
34,北方森林动物园,20220203,全国,全国,63,0,63
35,北方森林动物园,20220204,全国,全国,59,59,0
36,北方森林动物园,20220205,全国,全国,0,0,0
37,北方森林动物园,20220206,全国,全国,0,0,0
38,北方森林动物园,20220207,全国,全国,0,0,0
39,北方森林动物园,20220208,全国,全国,124,59,65
40,北方森林动物园,20220209,全国,全国,0,0,0
41,北方森林动物园,20220210,全国,全国,59,59,0
42,北方森林动物园,20220211,全国,全国,0,0,0
43,北方森林动物园,20220212,全国,全国,71,0,71
44,北方森林动物园,20220213,全国,全国,69,0,69
45,北方森林动物园,20220214,全国,全国,65,0,65
46,北方森林动物园,20220215,全国,全国,61,0,61
47,北方森林动物园,20220216,全国,全国,126,61,65
48,北方森林动物园,20220217,全国,全国,0,0,0
49,北方森林动物园,20220218,全国,全国,67,0,67
50,北方森林动物园,20220219,全国,全国,65,0,65
51,北方森林动物园,20220220,全国,全国,0,0,0
52,北方森林动物园,20220221,全国,全国,0,0,0
53,北方森林动物园,20220222,全国,全国,126,59,67
54,北方森林动物园,20220223,全国,全国,0,0,0
55,北方森林动物园,20220224,全国,全国,124,61,63
56,北方森林动物园,20220225,全国,全国,69,0,69
57,北方森林动物园,20220226,全国,全国,70,0,70
58,北方森林动物园,20220227,全国,全国,70,0,70
59,北方森林动物园,20220228,全国,全国,65,0,65
60,北方森林动物园,20220301,全国,全国,61,0,61
61,北方森林动物园,20220302,全国,全国,0,0,0
62,北方森林动物园,20220303,全国,全国,0,0,0
63,北方森林动物园,20220304,全国,全国,0,0,0
64,北方森林动物园,20220305,全国,全国,0,0,0
65,北方森林动物园,20220306,全国,全国,0,0,0
66,北方森林动物园,20220307,全国,全国,70,0,70
67,北方森林动物园,20220308,全国,全国,59,59,0
68,北方森林动物园,20220309,全国,全国,141,61,80
69,北方森林动物园,20220310,全国,全国,127,61,66
70,北方森林动物园,20220311,全国,全国,61,0,61
71,北方森林动物园,20220312,全国,全国,65,0,65
72,北方森林动物园,20220313,全国,全国,0,0,0
73,北方森林动物园,20220314,全国,全国,65,0,65
74,北方森林动物园,20220315,全国,全国,59,59,0
75,北方森林动物园,20220316,全国,全国,61,0,61
76,北方森林动物园,20220317,全国,全国,0,0,0
77,北方森林动物园,20220318,全国,全国,61,0,61
78,北方森林动物园,20220319,全国,全国,0,0,0
79,北方森林动物园,20220320,全国,全国,0,0,0
80,北方森林动物园,20220321,全国,全国,67,0,67
81,北方森林动物园,20220322,全国,全国,59,59,0
82,北方森林动物园,20220323,全国,全国,120,59,61
83,北方森林动物园,20220324,全国,全国,0,0,0
84,北方森林动物园,20220325,全国,全国,73,0,73
85,北方森林动物园,20220326,全国,全国,66,0,66
86,北方森林动物园,20220327,全国,全国,61,0,61
87,北方森林动物园,20220328,全国,全国,0,0,0
88,北方森林动物园,20220329,全国,全国,69,0,69
89,北方森林动物园,20220330,全国,全国,0,0,0
90,北方森林动物园,20220331,全国,全国,70,0,70
91,北方森林动物园,20220401,全国,全国,63,0,63
92,北方森林动物园,20220402,全国,全国,63,0,63
93,北方森林动物园,20220403,全国,全国,0,0,0
94,北方森林动物园,20220404,全国,全国,76,0,76
95,北方森林动物园,20220405,全国,全国,0,0,0
96,北方森林动物园,20220406,全国,全国,0,0,0
97,北方森林动物园,20220407,全国,全国,61,0,61
98,北方森林动物园,20220408,全国,全国,0,0,0
99,北方森林动物园,20220409,全国,全国,63,0,63
100,北方森林动物园,20220410,全国,全国,69,0,69
101,北方森林动物园,20220411,全国,全国,127,61,66
102,北方森林动物园,20220412,全国,全国,139,63,76
103,北方森林动物园,20220413,全国,全国,127,61,66
104,北方森林动物园,20220414,全国,全国,124,61,63
105,北方森林动物园,20220415,全国,全国,0,0,0
106,北方森林动物园,20220416,全国,全国,0,0,0
107,北方森林动物园,20220417,全国,全国,66,0,66
108,北方森林动物园,20220418,全国,全国,61,61,0
109,北方森林动物园,20220419,全国,全国,67,0,67
110,北方森林动物园,20220420,全国,全国,122,59,63
111,北方森林动物园,20220421,全国,全国,61,0,61
112,北方森林动物园,20220422,全国,全国,0,0,0
113,北方森林动物园,20220423,全国,全国,63,0,63
114,北方森林动物园,20220424,全国,全国,84,0,84
115,北方森林动物园,20220425,全国,全国,65,0,65
116,北方森林动物园,20220426,全国,全国,70,0,70
117,北方森林动物园,20220427,全国,全国,66,0,66
118,北方森林动物园,20220428,全国,全国,73,0,73
119,北方森林动物园,20220429,全国,全国,76,0,76
120,北方森林动物园,20220430,全国,全国,80,0,80
121,北方森林动物园,20220501,全国,全国,76,0,76
122,北方森林动物园,20220502,全国,全国,132,59,73
123,北方森林动物园,20220503,全国,全国,69,0,69
124,北方森林动物园,20220504,全国,全国,65,0,65
125,北方森林动物园,20220505,全国,全国,82,0,82
126,北方森林动物园,20220506,全国,全国,139,59,80
127,北方森林动物园,20220507,全国,全国,86,0,86
128,北方森林动物园,20220508,全国,全国,78,0,78
129,北方森林动物园,20220509,全国,全国,91,0,91
130,北方森林动物园,20220510,全国,全国,74,0,74
131,北方森林动物园,20220511,全国,全国,86,0,86
132,北方森林动物园,20220512,全国,全国,167,63,104
133,北方森林动物园,20220513,全国,全国,159,59,100
134,北方森林动物园,20220514,全国,全国,187,59,128
135,北方森林动物园,20220515,全国,全国,168,59,109
136,北方森林动物园,20220516,全国,全国,188,70,118
137,北方森林动物园,20220517,全国,全国,165,66,99
138,北方森林动物园,20220518,全国,全国,173,61,112
139,北方森林动物园,20220519,全国,全国,197,61,136
140,北方森林动物园,20220520,全国,全国,188,63,125
141,北方森林动物园,20220521,全国,全国,151,0,151
142,北方森林动物园,20220522,全国,全国,154,0,154
143,北方森林动物园,20220523,全国,全国,167,63,104
144,北方森林动物园,20220524,全国,全国,96,0,96
145,北方森林动物园,20220525,全国,全国,145,59,86
146,北方森林动物园,20220526,全国,全国,147,64,83
147,北方森林动物园,20220527,全国,全国,135,0,135
148,北方森林动物园,20220528,全国,全国,141,0,141
149,北方森林动物园,20220529,全国,全国,105,0,105
150,北方森林动物园,20220530,全国,全国,163,59,104
151,北方森林动物园,20220531,全国,全国,241,63,178
152,北方森林动物园,20220601,全国,全国,247,61,186
153,北方森林动物园,20220602,全国,全国,281,64,217
154,北方森林动物园,20220603,全国,全国,303,0,303
155,北方森林动物园,20220604,全国,全国,286,59,227
156,北方森林动物园,20220605,全国,全国,181,59,122
157,北方森林动物园,20220606,全国,全国,171,63,108
158,北方森林动物园,20220607,全国,全国,154,59,95
159,北方森林动物园,20220608,全国,全国,113,0,113
160,北方森林动物园,20220609,全国,全国,172,64,108
161,北方森林动物园,20220610,全国,全国,171,61,110
162,北方森林动物园,20220611,全国,全国,138,0,138
163,北方森林动物园,20220612,全国,全国,193,61,132
164,北方森林动物园,20220613,全国,全国,71,0,71
165,北方森林动物园,20220614,全国,全国,165,61,104
166,北方森林动物园,20220615,全国,全国,167,59,108
167,北方森林动物园,20220616,全国,全国,150,59,91
168,北方森林动物园,20220617,全国,全国,134,0,134
169,北方森林动物园,20220618,全国,全国,182,59,123
170,北方森林动物园,20220619,全国,全国,138,0,138
171,北方森林动物园,20220620,全国,全国,97,0,97
172,北方森林动物园,20220621,全国,全国,100,0,100
173,北方森林动物园,20220622,全国,全国,147,61,86
174,北方森林动物园,20220623,全国,全国,92,0,92
175,北方森林动物园,20220624,全国,全国,112,0,112
176,北方森林动物园,20220625,全国,全国,99,0,99
177,北方森林动物园,20220626,全国,全国,119,0,119
178,北方森林动物园,20220627,全国,全国,165,63,102
179,北方森林动物园,20220628,全国,全国,178,59,119
180,北方森林动物园,20220629,全国,全国,176,63,113
181,北方森林动物园,20220630,全国,全国,165,61,104
182,北方森林动物园,20220701,全国,全国,177,59,118
183,北方森林动物园,20220702,全国,全国,182,61,121
184,北方森林动物园,20220703,全国,全国,144,0,144
185,北方森林动物园,20220704,全国,全国,169,59,110
186,北方森林动物园,20220705,全国,全国,172,64,108
187,北方森林动物园,20220706,全国,全国,166,61,105
188,北方森林动物园,20220707,全国,全国,177,68,109
189,北方森林动物园,20220708,全国,全国,176,66,110
190,北方森林动物园,20220709,全国,全国,143,0,143
191,北方森林动物园,20220710,全国,全国,176,0,176
192,北方森林动物园,20220711,全国,全国,172,64,108
193,北方森林动物园,20220712,全国,全国,134,0,134
194,北方森林动物园,20220713,全国,全国,177,59,118
195,北方森林动物园,20220714,全国,全国,149,0,149
196,北方森林动物园,20220715,全国,全国,231,66,165
197,北方森林动物园,20220716,全国,全国,149,0,149
198,北方森林动物园,20220717,全国,全国,184,0,184
199,北方森林动物园,20220718,全国,全国,183,61,122
200,北方森林动物园,20220719,全国,全国,213,61,152
201,北方森林动物园,20220720,全国,全国,181,59,122
202,北方森林动物园,20220721,全国,全国,219,59,160
203,北方森林动物园,20220722,全国,全国,224,59,165
204,北方森林动物园,20220723,全国,全国,234,61,173
205,北方森林动物园,20220724,全国,全国,237,63,174
206,北方森林动物园,20220725,全国,全国,233,63,170
207,北方森林动物园,20220726,全国,全国,213,59,154
208,北方森林动物园,20220727,全国,全国,193,61,132
209,北方森林动物园,20220728,全国,全国,213,64,149
210,北方森林动物园,20220729,全国,全国,215,63,152
211,北方森林动物园,20220730,全国,全国,237,61,176
212,北方森林动物园,20220731,全国,全国,235,59,176
213,北方森林动物园,20220801,全国,全国,230,63,167
214,北方森林动物园,20220802,全国,全国,176,0,176
215,北方森林动物园,20220803,全国,全国,205,61,144
216,北方森林动物园,20220804,全国,全国,241,68,173
217,北方森林动物园,20220805,全国,全国,237,63,174
218,北方森林动物园,20220806,全国,全国,251,59,192
219,北方森林动物园,20220807,全国,全国,192,0,192
220,北方森林动物园,20220808,全国,全国,215,63,152
221,北方森林动物园,20220809,全国,全国,202,61,141
222,北方森林动物园,20220810,全国,全国,220,59,161
223,北方森林动物园,20220811,全国,全国,216,59,157
224,北方森林动物园,20220812,全国,全国,216,59,157
225,北方森林动物园,20220813,全国,全国,241,61,180
226,北方森林动物园,20220814,全国,全国,233,59,174
227,北方森林动物园,20220815,全国,全国,135,0,135
228,北方森林动物园,20220816,全国,全国,164,0,164
229,北方森林动物园,20220817,全国,全国,203,64,139
230,北方森林动物园,20220818,全国,全国,134,0,134
231,北方森林动物园,20220819,全国,全国,178,61,117
232,北方森林动物园,20220820,全国,全国,250,61,189
233,北方森林动物园,20220821,全国,全国,136,0,136
234,北方森林动物园,20220822,全国,全国,150,61,89
235,北方森林动物园,20220823,全国,全国,182,61,121
236,北方森林动物园,20220824,全国,全国,175,63,112
237,北方森林动物园,20220825,全国,全国,96,0,96
238,北方森林动物园,20220826,全国,全国,169,63,106
239,北方森林动物园,20220827,全国,全国,121,0,121
240,北方森林动物园,20220828,全国,全国,109,0,109
241,北方森林动物园,20220829,全国,全国,126,61,65
242,北方森林动物园,20220830,全国,全国,70,0,70
243,北方森林动物园,20220831,全国,全国,0,0,0
244,北方森林动物园,20220901,全国,全国,0,0,0
245,北方森林动物园,20220902,全国,全国,65,0,65
246,北方森林动物园,20220903,全国,全国,73,0,73
247,北方森林动物园,20220904,全国,全国,66,0,66
248,北方森林动物园,20220905,全国,全国,61,61,0
249,北方森林动物园,20220906,全国,全国,122,61,61
250,北方森林动物园,20220907,全国,全国,73,0,73
251,北方森林动物园,20220908,全国,全国,138,59,79
252,北方森林动物园,20220909,全国,全国,171,66,105
253,北方森林动物园,20220910,全国,全国,117,0,117
254,北方森林动物园,20220911,全国,全国,222,59,163
255,北方森林动物园,20220912,全国,全国,115,0,115
256,北方森林动物园,20220913,全国,全国,150,59,91
257,北方森林动物园,20220914,全国,全国,139,59,80
258,北方森林动物园,20220915,全国,全国,84,0,84
259,北方森林动物园,20220916,全国,全国,87,0,87
260,北方森林动物园,20220917,全国,全国,96,0,96
261,北方森林动物园,20220918,全国,全国,99,0,99
262,北方森林动物园,20220919,全国,全国,141,59,82
263,北方森林动物园,20220920,全国,全国,67,0,67
264,北方森林动物园,20220921,全国,全国,125,59,66
265,北方森林动物园,20220922,全国,全国,73,0,73
266,北方森林动物园,20220923,全国,全国,128,59,69
267,北方森林动物园,20220924,全国,全国,86,0,86
268,北方森林动物园,20220925,全国,全国,80,0,80
269,北方森林动物园,20220926,全国,全国,74,0,74
270,北方森林动物园,20220927,全国,全国,86,0,86
271,北方森林动物园,20220928,全国,全国,80,0,80
272,北方森林动物园,20220929,全国,全国,152,61,91
273,北方森林动物园,20220930,全国,全国,216,68,148
274,北方森林动物园,20221001,全国,全国,187,0,187
275,北方森林动物园,20221002,全国,全国,179,0,179
276,北方森林动物园,20221003,全国,全国,105,0,105
277,北方森林动物园,20221004,全国,全国,122,0,122
278,北方森林动物园,20221005,全国,全国,97,0,97
279,北方森林动物园,20221006,全国,全国,84,0,84
280,北方森林动物园,20221007,全国,全国,96,0,96
281,北方森林动物园,20221008,全国,全国,76,0,76
282,北方森林动物园,20221009,全国,全国,126,59,67
283,北方森林动物园,20221010,全国,全国,126,59,67
284,北方森林动物园,20221011,全国,全国,61,0,61
285,北方森林动物园,20221012,全国,全国,61,0,61
286,北方森林动物园,20221013,全国,全国,80,0,80
287,北方森林动物园,20221014,全国,全国,69,0,69
288,北方森林动物园,20221015,全国,全国,132,59,73
289,北方森林动物园,20221016,全国,全国,74,0,74
290,北方森林动物园,20221017,全国,全国,67,0,67
291,北方森林动物园,20221018,全国,全国,70,0,70
292,北方森林动物园,20221019,全国,全国,61,0,61
293,北方森林动物园,20221020,全国,全国,0,0,0
294,北方森林动物园,20221021,全国,全国,66,0,66
295,北方森林动物园,20221022,全国,全国,69,0,69
296,北方森林动物园,20221023,全国,全国,65,0,65
297,北方森林动物园,20221024,全国,全国,0,0,0
298,北方森林动物园,20221025,全国,全国,0,0,0
299,北方森林动物园,20221026,全国,全国,69,0,69
300,北方森林动物园,20221027,全国,全国,63,0,63
301,北方森林动物园,20221028,全国,全国,0,0,0
302,北方森林动物园,20221029,全国,全国,71,0,71
303,北方森林动物园,20221030,全国,全国,66,0,66
304,北方森林动物园,20221031,全国,全国,0,0,0
305,北方森林动物园,20221101,全国,全国,66,0,66
306,北方森林动物园,20221102,全国,全国,59,59,0
307,北方森林动物园,20221103,全国,全国,65,0,65
308,北方森林动物园,20221104,全国,全国,63,0,63
309,北方森林动物园,20221105,全国,全国,66,0,66
310,北方森林动物园,20221106,全国,全国,0,0,0
311,北方森林动物园,20221107,全国,全国,0,0,0
312,北方森林动物园,20221108,全国,全国,61,0,61
313,北方森林动物园,20221109,全国,全国,63,0,63
314,北方森林动物园,20221110,全国,全国,63,0,63
315,北方森林动物园,20221111,全国,全国,0,0,0
316,北方森林动物园,20221112,全国,全国,122,59,63
317,北方森林动物园,20221113,全国,全国,71,0,71
318,北方森林动物园,20221114,全国,全国,61,0,61
319,北方森林动物园,20221115,全国,全国,0,0,0
320,北方森林动物园,20221116,全国,全国,0,0,0
321,北方森林动物园,20221117,全国,全国,61,0,61
322,北方森林动物园,20221118,全国,全国,0,0,0
323,北方森林动物园,20221119,全国,全国,69,0,69
324,北方森林动物园,20221120,全国,全国,0,0,0
325,北方森林动物园,20221121,全国,全国,66,0,66
326,北方森林动物园,20221122,全国,全国,61,0,61
327,北方森林动物园,20221123,全国,全国,0,0,0
328,北方森林动物园,20221124,全国,全国,0,0,0
329,北方森林动物园,20221125,全国,全国,0,0,0
330,北方森林动物园,20221126,全国,全国,0,0,0
331,北方森林动物园,20221127,全国,全国,70,0,70
332,北方森林动物园,20221128,全国,全国,0,0,0
333,北方森林动物园,20221129,全国,全国,63,0,63
334,北方森林动物园,20221130,全国,全国,65,0,65
335,北方森林动物园,20221201,全国,全国,0,0,0
336,北方森林动物园,20221202,全国,全国,0,0,0
337,北方森林动物园,20221203,全国,全国,61,0,61
338,北方森林动物园,20221204,全国,全国,0,0,0
339,北方森林动物园,20221205,全国,全国,0,0,0
340,北方森林动物园,20221206,全国,全国,120,59,61
341,北方森林动物园,20221207,全国,全国,0,0,0
342,北方森林动物园,20221208,全国,全国,0,0,0
343,北方森林动物园,20221209,全国,全国,67,0,67
344,北方森林动物园,20221210,全国,全国,65,0,65
345,北方森林动物园,20221211,全国,全国,0,0,0
346,北方森林动物园,20221212,全国,全国,0,0,0
347,北方森林动物园,20221213,全国,全国,66,0,66
348,北方森林动物园,20221214,全国,全国,66,0,66
349,北方森林动物园,20221215,全国,全国,63,0,63
350,北方森林动物园,20221216,全国,全国,61,0,61
351,北方森林动物园,20221217,全国,全国,61,0,61
352,北方森林动物园,20221218,全国,全国,63,0,63
353,北方森林动物园,20221219,全国,全国,0,0,0
354,北方森林动物园,20221220,全国,全国,0,0,0
355,北方森林动物园,20221221,全国,全国,59,59,0
356,北方森林动物园,20221222,全国,全国,0,0,0
357,北方森林动物园,20221223,全国,全国,0,0,0
358,北方森林动物园,20221224,全国,全国,65,0,65
359,北方森林动物园,20221225,全国,全国,61,0,61
360,北方森林动物园,20221226,全国,全国,122,61,61
361,北方森林动物园,20221227,全国,全国,65,0,65
362,北方森林动物园,20221228,全国,全国,67,0,67
363,北方森林动物园,20221229,全国,全国,0,0,0
364,北方森林动物园,20221230,全国,全国,0,0,0
365,北方森林动物园,20221231,全国,全国,0,0,0
366,北方森林动物园,20230101,全国,全国,0,0,0
367,北方森林动物园,20230102,全国,全国,63,0,63
368,北方森林动物园,20230103,全国,全国,122,61,61
369,北方森林动物园,20230104,全国,全国,61,0,61
370,北方森林动物园,20230105,全国,全国,61,0,61
371,北方森林动物园,20230106,全国,全国,0,0,0
372,北方森林动物园,20230107,全国,全国,63,0,63
373,北方森林动物园,20230108,全国,全国,0,0,0
374,北方森林动物园,20230109,全国,全国,0,0,0
375,北方森林动物园,20230110,全国,全国,120,59,61
376,北方森林动物园,20230111,全国,全国,125,59,66
377,北方森林动物园,20230112,全国,全国,61,0,61
378,北方森林动物园,20230113,全国,全国,0,0,0
379,北方森林动物园,20230114,全国,全国,0,0,0
380,北方森林动物园,20230115,全国,全国,0,0,0
381,北方森林动物园,20230116,全国,全国,63,0,63
382,北方森林动物园,20230117,全国,全国,0,0,0
383,北方森林动物园,20230118,全国,全国,0,0,0
384,北方森林动物园,20230119,全国,全国,65,0,65
385,北方森林动物园,20230120,全国,全国,0,0,0
386,北方森林动物园,20230121,全国,全国,0,0,0
387,北方森林动物园,20230122,全国,全国,66,0,66
388,北方森林动物园,20230123,全国,全国,70,0,70
389,北方森林动物园,20230124,全国,全国,69,0,69
390,北方森林动物园,20230125,全国,全国,71,0,71
391,北方森林动物园,20230126,全国,全国,126,59,67
392,北方森林动物园,20230127,全国,全国,0,0,0
393,北方森林动物园,20230128,全国,全国,66,0,66
394,北方森林动物园,20230129,全国,全国,73,0,73
395,北方森林动物园,20230130,全国,全国,67,0,67
396,北方森林动物园,20230131,全国,全国,127,61,66
397,北方森林动物园,20230201,全国,全国,67,0,67
398,北方森林动物园,20230202,全国,全国,124,59,65
399,北方森林动物园,20230203,全国,全国,73,0,73
400,北方森林动物园,20230204,全国,全国,65,0,65
401,北方森林动物园,20230205,全国,全国,124,59,65
402,北方森林动物园,20230206,全国,全国,66,0,66
403,北方森林动物园,20230207,全国,全国,61,61,0
404,北方森林动物园,20230208,全国,全国,65,0,65
405,北方森林动物园,20230209,全国,全国,0,0,0
406,北方森林动物园,20230210,全国,全国,63,0,63
407,北方森林动物园,20230211,全国,全国,122,59,63
408,北方森林动物园,20230212,全国,全国,67,0,67
409,北方森林动物园,20230213,全国,全国,69,0,69
410,北方森林动物园,20230214,全国,全国,0,0,0
411,北方森林动物园,20230215,全国,全国,0,0,0
412,北方森林动物园,20230216,全国,全国,61,0,61
413,北方森林动物园,20230217,全国,全国,59,59,0
414,北方森林动物园,20230218,全国,全国,65,0,65
415,北方森林动物园,20230219,全国,全国,122,59,63
416,北方森林动物园,20230220,全国,全国,0,0,0
417,北方森林动物园,20230221,全国,全国,0,0,0
418,北方森林动物园,20230222,全国,全国,126,59,67
419,北方森林动物园,20230223,全国,全国,67,0,67
420,北方森林动物园,20230224,全国,全国,61,0,61
421,北方森林动物园,20230225,全国,全国,132,59,73
422,北方森林动物园,20230226,全国,全国,69,0,69
423,北方森林动物园,20230227,全国,全国,133,64,69
424,北方森林动物园,20230228,全国,全国,124,63,61
425,北方森林动物园,20230301,全国,全国,66,0,66
426,北方森林动物园,20230302,全国,全国,71,0,71
427,北方森林动物园,20230303,全国,全国,70,0,70
428,北方森林动物园,20230304,全国,全国,122,59,63
429,北方森林动物园,20230305,全国,全国,67,0,67
430,北方森林动物园,20230306,全国,全国,65,0,65
431,北方森林动物园,20230307,全国,全国,71,0,71
432,北方森林动物园,20230308,全国,全国,126,59,67
433,北方森林动物园,20230309,全国,全国,76,0,76
434,北方森林动物园,20230310,全国,全国,132,63,69
435,北方森林动物园,20230311,全国,全国,124,59,65
436,北方森林动物园,20230312,全国,全国,74,0,74
437,北方森林动物园,20230313,全国,全国,78,0,78
438,北方森林动物园,20230314,全国,全国,130,59,71
439,北方森林动物园,20230315,全国,全国,67,0,67
440,北方森林动物园,20230316,全国,全国,135,61,74
441,北方森林动物园,20230317,全国,全国,78,0,78
442,北方森林动物园,20230318,全国,全国,80,0,80
443,北方森林动物园,20230319,全国,全国,138,59,79
444,北方森林动物园,20230320,全国,全国,139,61,78
445,北方森林动物园,20230321,全国,全国,74,0,74
446,北方森林动物园,20230322,全国,全国,148,59,89
447,北方森林动物园,20230323,全国,全国,78,0,78
448,北方森林动物园,20230324,全国,全国,105,0,105
449,北方森林动物园,20230325,全国,全国,82,0,82
450,北方森林动物园,20230326,全国,全国,71,0,71
451,北方森林动物园,20230327,全国,全国,146,59,87
452,北方森林动物园,20230328,全国,全国,86,0,86
453,北方森林动物园,20230329,全国,全国,132,61,71
454,北方森林动物园,20230330,全国,全国,153,61,92
455,北方森林动物园,20230331,全国,全国,154,63,91
456,北方森林动物园,20230401,全国,全国,78,0,78
457,北方森林动物园,20230402,全国,全国,158,59,99
458,北方森林动物园,20230403,全国,全国,145,59,86
459,北方森林动物园,20230404,全国,全国,166,64,102
460,北方森林动物园,20230405,全国,全国,109,0,109
461,北方森林动物园,20230406,全国,全国,148,59,89
462,北方森林动物园,20230407,全国,全国,83,0,83
463,北方森林动物园,20230408,全国,全国,178,63,115
464,北方森林动物园,20230409,全国,全国,97,0,97
465,北方森林动物园,20230410,全国,全国,173,61,112
466,北方森林动物园,20230411,全国,全国,193,74,119
467,北方森林动物园,20230412,全国,全国,189,66,123
468,北方森林动物园,20230413,全国,全国,195,70,125
469,北方森林动物园,20230414,全国,全国,189,70,119
470,北方森林动物园,20230415,全国,全国,214,63,151
471,北方森林动物园,20230416,全国,全国,154,0,154
472,北方森林动物园,20230417,全国,全国,197,61,136
473,北方森林动物园,20230418,全国,全国,198,64,134
474,北方森林动物园,20230419,全国,全国,190,59,131
475,北方森林动物园,20230420,全国,全国,169,61,108
476,北方森林动物园,20230421,全国,全国,214,63,151
477,北方森林动物园,20230422,全国,全国,217,59,158
478,北方森林动物园,20230423,全国,全国,227,76,151
479,北方森林动物园,20230424,全国,全国,229,72,157
480,北方森林动物园,20230425,全国,全国,223,63,160
481,北方森林动物园,20230426,全国,全国,247,68,179
482,北方森林动物园,20230427,全国,全国,323,80,243
483,北方森林动物园,20230428,全国,全国,381,80,301
484,北方森林动物园,20230429,全国,全国,454,61,393
485,北方森林动物园,20230430,全国,全国,669,70,599
486,北方森林动物园,20230501,全国,全国,937,82,855
487,北方森林动物园,20230502,全国,全国,623,59,564
488,北方森林动物园,20230503,全国,全国,353,61,292
489,北方森林动物园,20230504,全国,全国,226,64,162
490,北方森林动物园,20230505,全国,全国,211,66,145
491,北方森林动物园,20230506,全国,全国,209,61,148
492,北方森林动物园,20230507,全国,全国,159,0,159
493,北方森林动物园,20230508,全国,全国,171,59,112
494,北方森林动物园,20230509,全国,全国,167,63,104
495,北方森林动物园,20230510,全国,全国,175,66,109
496,北方森林动物园,20230511,全国,全国,187,59,128
497,北方森林动物园,20230512,全国,全国,110,0,110
498,北方森林动物园,20230513,全国,全国,154,0,154
499,北方森林动物园,20230514,全国,全国,134,0,134
500,北方森林动物园,20230515,全国,全国,187,59,128
501,北方森林动物园,20230516,全国,全国,182,64,118
502,北方森林动物园,20230517,全国,全国,149,0,149
503,北方森林动物园,20230518,全国,全国,180,59,121
504,北方森林动物园,20230519,全国,全国,123,0,123
505,北方森林动物园,20230520,全国,全国,145,0,145
506,北方森林动物园,20230521,全国,全国,143,0,143
507,北方森林动物园,20230522,全国,全国,109,0,109
508,北方森林动物园,20230523,全国,全国,112,0,112
509,北方森林动物园,20230524,全国,全国,227,63,164
510,北方森林动物园,20230525,全国,全国,230,68,162
511,北方森林动物园,20230526,全国,全国,227,61,166
512,北方森林动物园,20230527,全国,全国,232,59,173
513,北方森林动物园,20230528,全国,全国,231,61,170
514,北方森林动物园,20230529,全国,全国,170,0,170
515,北方森林动物园,20230530,全国,全国,234,72,162
516,北方森林动物园,20230531,全国,全国,233,63,170
517,北方森林动物园,20230601,全国,全国,228,61,167
518,北方森林动物园,20230602,全国,全国,194,63,131
519,北方森林动物园,20230603,全国,全国,260,59,201
520,北方森林动物园,20230604,全国,全国,179,0,179
521,北方森林动物园,20230605,全国,全国,179,0,179
522,北方森林动物园,20230606,全国,全国,132,0,132
523,北方森林动物园,20230607,全国,全国,192,61,131
524,北方森林动物园,20230608,全国,全国,154,59,95
525,北方森林动物园,20230609,全国,全国,204,61,143
526,北方森林动物园,20230610,全国,全国,152,0,152
527,北方森林动物园,20230611,全国,全国,155,0,155
528,北方森林动物园,20230612,全国,全国,118,0,118
529,北方森林动物园,20230613,全国,全国,163,61,102
530,北方森林动物园,20230614,全国,全国,108,0,108
531,北方森林动物园,20230615,全国,全国,156,59,97
532,北方森林动物园,20230616,全国,全国,164,59,105
533,北方森林动物园,20230617,全国,全国,157,0,157
534,北方森林动物园,20230618,全国,全国,157,0,157
535,北方森林动物园,20230619,全国,全国,174,59,115
536,北方森林动物园,20230620,全国,全国,105,0,105
537,北方森林动物园,20230621,全国,全国,195,63,132
538,北方森林动物园,20230622,全国,全国,282,63,219
539,北方森林动物园,20230623,全国,全国,214,0,214
540,北方森林动物园,20230624,全国,全国,199,64,135
541,北方森林动物园,20230625,全国,全国,182,61,121
542,北方森林动物园,20230626,全国,全国,152,61,91
543,北方森林动物园,20230627,全国,全国,158,63,95
544,北方森林动物园,20230628,全国,全国,91,0,91
545,北方森林动物园,20230629,全国,全国,92,0,92
546,北方森林动物园,20230630,全国,全国,158,63,95
547,北方森林动物园,20230701,全国,全国,182,59,123
548,北方森林动物园,20230702,全国,全国,197,61,136
549,北方森林动物园,20230703,全国,全国,96,0,96
550,北方森林动物园,20230704,全国,全国,152,61,91
551,北方森林动物园,20230705,全国,全国,159,64,95
552,北方森林动物园,20230706,全国,全国,156,59,97
553,北方森林动物园,20230707,全国,全国,115,0,115
554,北方森林动物园,20230708,全国,全国,181,63,118
555,北方森林动物园,20230709,全国,全国,93,0,93
556,北方森林动物园,20230710,全国,全国,92,0,92
557,北方森林动物园,20230711,全国,全国,113,0,113
558,北方森林动物园,20230712,全国,全国,157,61,96
559,北方森林动物园,20230713,全国,全国,167,59,108
560,北方森林动物园,20230714,全国,全国,104,0,104
561,北方森林动物园,20230715,全国,全国,87,0,87
562,北方森林动物园,20230716,全国,全国,121,0,121
563,北方森林动物园,20230717,全国,全国,166,64,102
564,北方森林动物园,20230718,全国,全国,93,0,93
565,北方森林动物园,20230719,全国,全国,187,64,123
566,北方森林动物园,20230720,全国,全国,191,61,130
567,北方森林动物园,20230721,全国,全国,169,61,108
568,北方森林动物园,20230722,全国,全国,139,0,139
569,北方森林动物园,20230723,全国,全国,115,0,115
570,北方森林动物园,20230724,全国,全国,93,0,93
571,北方森林动物园,20230725,全国,全国,173,63,110
572,北方森林动物园,20230726,全国,全国,197,59,138
573,北方森林动物园,20230727,全国,全国,122,0,122
574,北方森林动物园,20230728,全国,全国,182,59,123
575,北方森林动物园,20230729,全国,全国,220,59,161
576,北方森林动物园,20230730,全国,全国,231,61,170
577,北方森林动物园,20230731,全国,全国,227,61,166
578,北方森林动物园,20230801,全国,全国,190,59,131
579,北方森林动物园,20230802,全国,全国,96,0,96
580,北方森林动物园,20230803,全国,全国,165,63,102
581,北方森林动物园,20230804,全国,全国,160,68,92
582,北方森林动物园,20230805,全国,全国,154,63,91
583,北方森林动物园,20230806,全国,全国,147,0,147
584,北方森林动物园,20230807,全国,全国,122,0,122
585,北方森林动物园,20230808,全国,全国,108,0,108
586,北方森林动物园,20230809,全国,全国,113,0,113
587,北方森林动物园,20230810,全国,全国,159,59,100
588,北方森林动物园,20230811,全国,全国,173,63,110
589,北方森林动物园,20230812,全国,全国,159,59,100
590,北方森林动物园,20230813,全国,全国,106,0,106
591,北方森林动物园,20230814,全国,全国,185,66,119
592,北方森林动物园,20230815,全国,全国,143,0,143
593,北方森林动物园,20230816,全国,全国,148,0,148
594,北方森林动物园,20230817,全国,全国,185,59,126
595,北方森林动物园,20230818,全国,全国,139,0,139
596,北方森林动物园,20230819,全国,全国,220,59,161
597,北方森林动物园,20230820,全国,全国,144,0,144
598,北方森林动物园,20230821,全国,全国,105,0,105
599,北方森林动物园,20230822,全国,全国,189,61,128
600,北方森林动物园,20230823,全国,全国,171,59,112
601,北方森林动物园,20230824,全国,全国,180,63,117
602,北方森林动物园,20230825,全国,全国,168,59,109
603,北方森林动物园,20230826,全国,全国,182,59,123
604,北方森林动物园,20230827,全国,全国,163,0,163
605,北方森林动物园,20230828,全国,全国,160,63,97
606,北方森林动物园,20230829,全国,全国,84,0,84
607,北方森林动物园,20230830,全国,全国,134,61,73
608,北方森林动物园,20230831,全国,全国,99,0,99
609,北方森林动物园,20230901,全国,全国,148,59,89
610,北方森林动物园,20230902,全国,全国,169,59,110
611,北方森林动物园,20230903,全国,全国,108,0,108
612,北方森林动物园,20230904,全国,全国,76,0,76
613,北方森林动物园,20230905,全国,全国,148,70,78
614,北方森林动物园,20230906,全国,全国,139,61,78
615,北方森林动物园,20230907,全国,全国,140,70,70
616,北方森林动物园,20230908,全国,全国,175,63,112
617,北方森林动物园,20230909,全国,全国,208,59,149
618,北方森林动物园,20230910,全国,全国,135,0,135
619,北方森林动物园,20230911,全国,全国,86,0,86
620,北方森林动物园,20230912,全国,全国,80,0,80
621,北方森林动物园,20230913,全国,全国,155,59,96
622,北方森林动物园,20230914,全国,全国,155,63,92
623,北方森林动物园,20230915,全国,全国,165,63,102
624,北方森林动物园,20230916,全国,全国,168,59,109
625,北方森林动物园,20230917,全国,全国,121,0,121
626,北方森林动物园,20230918,全国,全国,78,0,78
627,北方森林动物园,20230919,全国,全国,141,59,82
628,北方森林动物园,20230920,全国,全国,141,59,82
629,北方森林动物园,20230921,全国,全国,154,59,95
630,北方森林动物园,20230922,全国,全国,168,66,102
631,北方森林动物园,20230923,全国,全国,184,72,112
632,北方森林动物园,20230924,全国,全国,89,0,89
633,北方森林动物园,20230925,全国,全国,172,64,108
634,北方森林动物园,20230926,全国,全国,205,66,139
635,北方森林动物园,20230927,全国,全国,199,68,131
636,北方森林动物园,20230928,全国,全国,215,74,141
637,北方森林动物园,20230929,全国,全国,187,0,187
638,北方森林动物园,20230930,全国,全国,311,61,250
639,北方森林动物园,20231001,全国,全国,372,63,309
640,北方森林动物园,20231002,全国,全国,383,64,319
641,北方森林动物园,20231003,全国,全国,221,0,221
642,北方森林动物园,20231004,全国,全国,280,59,221
643,北方森林动物园,20231005,全国,全国,230,59,171
644,北方森林动物园,20231006,全国,全国,191,59,132
645,北方森林动物园,20231007,全国,全国,91,0,91
646,北方森林动物园,20231008,全国,全国,84,0,84
647,北方森林动物园,20231009,全国,全国,74,0,74
648,北方森林动物园,20231010,全国,全国,73,0,73
649,北方森林动物园,20231011,全国,全国,67,0,67
650,北方森林动物园,20231012,全国,全国,125,59,66
651,北方森林动物园,20231013,全国,全国,141,59,82
652,北方森林动物园,20231014,全国,全国,105,0,105
653,北方森林动物园,20231015,全国,全国,86,0,86
654,北方森林动物园,20231016,全国,全国,70,0,70
655,北方森林动物园,20231017,全国,全国,124,61,63
656,北方森林动物园,20231018,全国,全国,132,61,71
657,北方森林动物园,20231019,全国,全国,66,0,66
658,北方森林动物园,20231020,全国,全国,70,0,70
659,北方森林动物园,20231021,全国,全国,78,0,78
660,北方森林动物园,20231022,全国,全国,129,59,70
661,北方森林动物园,20231023,全国,全国,66,0,66
662,北方森林动物园,20231024,全国,全国,76,0,76
663,北方森林动物园,20231025,全国,全国,124,59,65
664,北方森林动物园,20231026,全国,全国,61,0,61
665,北方森林动物园,20231027,全国,全国,66,0,66
666,北方森林动物园,20231028,全国,全国,71,0,71
667,北方森林动物园,20231029,全国,全国,76,0,76
668,北方森林动物园,20231030,全国,全国,61,0,61
669,北方森林动物园,20231031,全国,全国,65,0,65
670,北方森林动物园,20231101,全国,全国,61,0,61
671,北方森林动物园,20231102,全国,全国,0,0,0
672,北方森林动物园,20231103,全国,全国,61,61,0
673,北方森林动物园,20231104,全国,全国,59,59,0
674,北方森林动物园,20231105,全国,全国,0,0,0
675,北方森林动物园,20231106,全国,全国,0,0,0
676,北方森林动物园,20231107,全国,全国,0,0,0
677,北方森林动物园,20231108,全国,全国,0,0,0
678,北方森林动物园,20231109,全国,全国,0,0,0
679,北方森林动物园,20231110,全国,全国,0,0,0
680,北方森林动物园,20231111,全国,全国,0,0,0
681,北方森林动物园,20231112,全国,全国,0,0,0
682,北方森林动物园,20231113,全国,全国,61,61,0
683,北方森林动物园,20231114,全国,全国,0,0,0
684,北方森林动物园,20231115,全国,全国,0,0,0
685,北方森林动物园,20231116,全国,全国,0,0,0
686,北方森林动物园,20231117,全国,全国,59,59,0
687,北方森林动物园,20231118,全国,全国,0,0,0
688,北方森林动物园,20231119,全国,全国,61,0,61
689,北方森林动物园,20231120,全国,全国,126,61,65
690,北方森林动物园,20231121,全国,全国,0,0,0
691,北方森林动物园,20231122,全国,全国,0,0,0
692,北方森林动物园,20231123,全国,全国,0,0,0
693,北方森林动物园,20231124,全国,全国,61,0,61
694,北方森林动物园,20231125,全国,全国,0,0,0
695,北方森林动物园,20231126,全国,全国,0,0,0
696,北方森林动物园,20231127,全国,全国,61,61,0
697,北方森林动物园,20231128,全国,全国,0,0,0
698,北方森林动物园,20231129,全国,全国,63,0,63
699,北方森林动物园,20231130,全国,全国,67,0,67
700,北方森林动物园,20231201,全国,全国,0,0,0
701,北方森林动物园,20231202,全国,全国,61,0,61
702,北方森林动物园,20231203,全国,全国,0,0,0
703,北方森林动物园,20231204,全国,全国,0,0,0
704,北方森林动物园,20231205,全国,全国,0,0,0
705,北方森林动物园,20231206,全国,全国,63,0,63
706,北方森林动物园,20231207,全国,全国,64,64,0
707,北方森林动物园,20231208,全国,全国,61,0,61
708,北方森林动物园,20231209,全国,全国,61,0,61
709,北方森林动物园,20231210,全国,全国,0,0,0
710,北方森林动物园,20231211,全国,全国,59,59,0
711,北方森林动物园,20231212,全国,全国,0,0,0
712,北方森林动物园,20231213,全国,全国,0,0,0
713,北方森林动物园,20231214,全国,全国,0,0,0
714,北方森林动物园,20231215,全国,全国,0,0,0
715,北方森林动物园,20231216,全国,全国,65,0,65
716,北方森林动物园,20231217,全国,全国,0,0,0
717,北方森林动物园,20231218,全国,全国,59,59,0
718,北方森林动物园,20231219,全国,全国,0,0,0
719,北方森林动物园,20231220,全国,全国,0,0,0
720,北方森林动物园,20231221,全国,全国,65,0,65
721,北方森林动物园,20231222,全国,全国,59,59,0
722,北方森林动物园,20231223,全国,全国,61,0,61
723,北方森林动物园,20231224,全国,全国,0,0,0
724,北方森林动物园,20231225,全国,全国,0,0,0
725,北方森林动物园,20231226,全国,全国,0,0,0
726,北方森林动物园,20231227,全国,全国,0,0,0
727,北方森林动物园,20231228,全国,全国,0,0,0
728,北方森林动物园,20231229,全国,全国,0,0,0
729,北方森林动物园,20231230,全国,全国,120,59,61
730,北方森林动物园,20231231,全国,全国,63,0,63
731,北方森林动物园,20240101,全国,全国,0,0,0
732,北方森林动物园,20240102,全国,全国,59,59,0
733,北方森林动物园,20240103,全国,全国,0,0,0
734,北方森林动物园,20240104,全国,全国,63,0,63
735,北方森林动物园,20240105,全国,全国,0,0,0
736,北方森林动物园,20240106,全国,全国,124,59,65
737,北方森林动物园,20240107,全国,全国,67,0,67
738,北方森林动物园,20240108,全国,全国,0,0,0
739,北方森林动物园,20240109,全国,全国,59,59,0
740,北方森林动物园,20240110,全国,全国,66,0,66
741,北方森林动物园,20240111,全国,全国,61,61,0
742,北方森林动物园,20240112,全国,全国,0,0,0
743,北方森林动物园,20240113,全国,全国,0,0,0
744,北方森林动物园,20240114,全国,全国,59,59,0
745,北方森林动物园,20240115,全国,全国,0,0,0
746,北方森林动物园,20240116,全国,全国,61,0,61
747,北方森林动物园,20240117,全国,全国,65,0,65
748,北方森林动物园,20240118,全国,全国,61,0,61
749,北方森林动物园,20240119,全国,全国,0,0,0
750,北方森林动物园,20240120,全国,全国,0,0,0
751,北方森林动物园,20240121,全国,全国,66,0,66
752,北方森林动物园,20240122,全国,全国,120,59,61
753,北方森林动物园,20240123,全国,全国,0,0,0
754,北方森林动物园,20240124,全国,全国,63,63,0
755,北方森林动物园,20240125,全国,全国,0,0,0
756,北方森林动物园,20240126,全国,全国,126,59,67
757,北方森林动物园,20240127,全国,全国,0,0,0
758,北方森林动物园,20240128,全国,全国,0,0,0
759,北方森林动物园,20240129,全国,全国,129,59,70
760,北方森林动物园,20240130,全国,全国,59,59,0
761,北方森林动物园,20240131,全国,全国,59,59,0
762,北方森林动物园,20240201,全国,全国,0,0,0
763,北方森林动物园,20240202,全国,全国,0,0,0
764,北方森林动物园,20240203,全国,全国,0,0,0
765,北方森林动物园,20240204,全国,全国,0,0,0
766,北方森林动物园,20240205,全国,全国,61,61,0
767,北方森林动物园,20240206,全国,全国,59,59,0
768,北方森林动物园,20240207,全国,全国,126,61,65
769,北方森林动物园,20240208,全国,全国,63,0,63
770,北方森林动物园,20240209,全国,全国,0,0,0
771,北方森林动物园,20240210,全国,全国,65,0,65
772,北方森林动物园,20240211,全国,全国,129,59,70
773,北方森林动物园,20240212,全国,全国,61,0,61
774,北方森林动物园,20240213,全国,全国,65,0,65
775,北方森林动物园,20240214,全国,全国,127,64,63
776,北方森林动物园,20240215,全国,全国,83,0,83
777,北方森林动物园,20240216,全国,全国,67,0,67
778,北方森林动物园,20240217,全国,全国,66,0,66
779,北方森林动物园,20240218,全国,全国,67,0,67
780,北方森林动物园,20240219,全国,全国,0,0,0
781,北方森林动物园,20240220,全国,全国,65,0,65
782,北方森林动物园,20240221,全国,全国,63,0,63
783,北方森林动物园,20240222,全国,全国,0,0,0
784,北方森林动物园,20240223,全国,全国,61,0,61
785,北方森林动物园,20240224,全国,全国,65,0,65
786,北方森林动物园,20240225,全国,全国,63,0,63
787,北方森林动物园,20240226,全国,全国,61,0,61
788,北方森林动物园,20240227,全国,全国,61,0,61
789,北方森林动物园,20240228,全国,全国,65,0,65
790,北方森林动物园,20240229,全国,全国,65,0,65
791,北方森林动物园,20240301,全国,全国,0,0,0
792,北方森林动物园,20240302,全国,全国,80,0,80
793,北方森林动物园,20240303,全国,全国,120,59,61
794,北方森林动物园,20240304,全国,全国,61,0,61
795,北方森林动物园,20240305,全国,全国,66,0,66
796,北方森林动物园,20240306,全国,全国,0,0,0
797,北方森林动物园,20240307,全国,全国,66,0,66
798,北方森林动物园,20240308,全国,全国,65,0,65
799,北方森林动物园,20240309,全国,全国,78,0,78
800,北方森林动物园,20240310,全国,全国,132,61,71
801,北方森林动物园,20240311,全国,全国,59,59,0
802,北方森林动物园,20240312,全国,全国,67,0,67
803,北方森林动物园,20240313,全国,全国,65,0,65
804,北方森林动物园,20240314,全国,全国,67,0,67
805,北方森林动物园,20240315,全国,全国,67,0,67
806,北方森林动物园,20240316,全国,全国,67,0,67
807,北方森林动物园,20240317,全国,全国,65,0,65
808,北方森林动物园,20240318,全国,全国,66,0,66
809,北方森林动物园,20240319,全国,全国,74,0,74
810,北方森林动物园,20240320,全国,全国,66,0,66
811,北方森林动物园,20240321,全国,全国,61,0,61
812,北方森林动物园,20240322,全国,全国,63,0,63
813,北方森林动物园,20240323,全国,全国,126,59,67
814,北方森林动物园,20240324,全国,全国,137,59,78
815,北方森林动物园,20240325,全国,全国,156,63,93
816,北方森林动物园,20240326,全国,全国,145,63,82
817,北方森林动物园,20240327,全国,全国,135,68,67
818,北方森林动物园,20240328,全国,全国,133,59,74
819,北方森林动物园,20240329,全国,全国,146,63,83
820,北方森林动物园,20240330,全国,全国,69,0,69
821,北方森林动物园,20240331,全国,全国,71,0,71
822,北方森林动物园,20240401,全国,全国,137,63,74
823,北方森林动物园,20240402,全国,全国,149,63,86
824,北方森林动物园,20240403,全国,全国,200,78,122
825,北方森林动物园,20240404,全国,全国,208,59,149
826,北方森林动物园,20240405,全国,全国,204,61,143
827,北方森林动物园,20240406,全国,全国,108,0,108
828,北方森林动物园,20240407,全国,全国,148,59,89
829,北方森林动物园,20240408,全国,全国,128,59,69
830,北方森林动物园,20240409,全国,全国,137,61,76
831,北方森林动物园,20240410,全国,全国,76,0,76
832,北方森林动物园,20240411,全国,全国,146,66,80
833,北方森林动物园,20240412,全国,全国,79,0,79
834,北方森林动物园,20240413,全国,全国,165,57,108
835,北方森林动物园,20240414,全国,全国,87,0,87
836,北方森林动物园,20240415,全国,全国,135,57,78
837,北方森林动物园,20240416,全国,全国,128,57,71
838,北方森林动物园,20240417,全国,全国,140,57,83
839,北方森林动物园,20240418,全国,全国,160,61,99
840,北方森林动物园,20240419,全国,全国,153,61,92
841,北方森林动物园,20240420,全国,全国,169,59,110
842,北方森林动物园,20240421,全国,全国,121,0,121
843,北方森林动物园,20240422,全国,全国,163,57,106
844,北方森林动物园,20240423,全国,全国,160,63,97
845,北方森林动物园,20240424,全国,全国,108,0,108
846,北方森林动物园,20240425,全国,全国,167,61,106
847,北方森林动物园,20240426,全国,全国,186,68,118
848,北方森林动物园,20240427,全国,全国,163,0,163
849,北方森林动物园,20240428,全国,全国,217,66,151
850,北方森林动物园,20240429,全国,全国,216,61,155
851,北方森林动物园,20240430,全国,全国,353,82,271
1,萧红故居,20220101,全国,全国,61,0,61
2,萧红故居,20220102,全国,全国,128,59,69
3,萧红故居,20220103,全国,全国,67,0,67
4,萧红故居,20220104,全国,全国,125,59,66
5,萧红故居,20220105,全国,全国,65,0,65
6,萧红故居,20220106,全国,全国,59,59,0
7,萧红故居,20220107,全国,全国,67,0,67
8,萧红故居,20220108,全国,全国,79,0,79
9,萧红故居,20220109,全国,全国,65,0,65
10,萧红故居,20220110,全国,全国,0,0,0
11,萧红故居,20220111,全国,全国,124,59,65
12,萧红故居,20220112,全国,全国,65,0,65
13,萧红故居,20220113,全国,全国,134,63,71
14,萧红故居,20220114,全国,全国,130,61,69
15,萧红故居,20220115,全国,全国,66,0,66
16,萧红故居,20220116,全国,全国,66,0,66
17,萧红故居,20220117,全国,全国,63,0,63
18,萧红故居,20220118,全国,全国,137,59,78
19,萧红故居,20220119,全国,全国,124,61,63
20,萧红故居,20220120,全国,全国,66,0,66
21,萧红故居,20220121,全国,全国,128,59,69
22,萧红故居,20220122,全国,全国,67,0,67
23,萧红故居,20220123,全国,全国,79,0,79
24,萧红故居,20220124,全国,全国,70,0,70
25,萧红故居,20220125,全国,全国,0,0,0
26,萧红故居,20220126,全国,全国,65,0,65
27,萧红故居,20220127,全国,全国,129,59,70
28,萧红故居,20220128,全国,全国,80,0,80
29,萧红故居,20220129,全国,全国,70,0,70
30,萧红故居,20220130,全国,全国,73,0,73
31,萧红故居,20220131,全国,全国,67,0,67
32,萧红故居,20220201,全国,全国,67,0,67
33,萧红故居,20220202,全国,全国,79,0,79
34,萧红故居,20220203,全国,全国,139,63,76
35,萧红故居,20220204,全国,全国,74,0,74
36,萧红故居,20220205,全国,全国,73,0,73
37,萧红故居,20220206,全国,全国,74,0,74
38,萧红故居,20220207,全国,全国,0,0,0
39,萧红故居,20220208,全国,全国,129,66,63
40,萧红故居,20220209,全国,全国,125,59,66
41,萧红故居,20220210,全国,全国,144,68,76
42,萧红故居,20220211,全国,全国,67,0,67
43,萧红故居,20220212,全国,全国,67,0,67
44,萧红故居,20220213,全国,全国,63,0,63
45,萧红故居,20220214,全国,全国,74,0,74
46,萧红故居,20220215,全国,全国,65,0,65
47,萧红故居,20220216,全国,全国,140,64,76
48,萧红故居,20220217,全国,全国,78,0,78
49,萧红故居,20220218,全国,全国,80,0,80
50,萧红故居,20220219,全国,全国,143,61,82
51,萧红故居,20220220,全国,全国,82,0,82
52,萧红故居,20220221,全国,全国,166,64,102
53,萧红故居,20220222,全国,全国,92,0,92
54,萧红故居,20220223,全国,全国,194,64,130
55,萧红故居,20220224,全国,全国,100,0,100
56,萧红故居,20220225,全国,全国,95,0,95
57,萧红故居,20220226,全国,全国,164,59,105
58,萧红故居,20220227,全国,全国,176,59,117
59,萧红故居,20220228,全国,全国,144,64,80
60,萧红故居,20220301,全国,全国,141,59,82
61,萧红故居,20220302,全国,全国,156,63,93
62,萧红故居,20220303,全国,全国,105,0,105
63,萧红故居,20220304,全国,全国,76,0,76
64,萧红故居,20220305,全国,全国,99,0,99
65,萧红故居,20220306,全国,全国,145,59,86
66,萧红故居,20220307,全国,全国,155,59,96
67,萧红故居,20220308,全国,全国,89,0,89
68,萧红故居,20220309,全国,全国,137,59,78
69,萧红故居,20220310,全国,全国,139,63,76
70,萧红故居,20220311,全国,全国,73,0,73
71,萧红故居,20220312,全国,全国,89,0,89
72,萧红故居,20220313,全国,全国,80,0,80
73,萧红故居,20220314,全国,全国,137,59,78
74,萧红故居,20220315,全国,全国,141,61,80
75,萧红故居,20220316,全国,全国,82,0,82
76,萧红故居,20220317,全国,全国,78,0,78
77,萧红故居,20220318,全国,全国,130,59,71
78,萧红故居,20220319,全国,全国,135,61,74
79,萧红故居,20220320,全国,全国,78,0,78
80,萧红故居,20220321,全国,全国,130,59,71
81,萧红故居,20220322,全国,全国,137,59,78
82,萧红故居,20220323,全国,全国,63,0,63
83,萧红故居,20220324,全国,全国,74,0,74
84,萧红故居,20220325,全国,全国,65,0,65
85,萧红故居,20220326,全国,全国,79,0,79
86,萧红故居,20220327,全国,全国,74,0,74
87,萧红故居,20220328,全国,全国,139,61,78
88,萧红故居,20220329,全国,全国,146,66,80
89,萧红故居,20220330,全国,全国,71,0,71
90,萧红故居,20220331,全国,全国,70,0,70
91,萧红故居,20220401,全国,全国,67,0,67
92,萧红故居,20220402,全国,全国,124,59,65
93,萧红故居,20220403,全国,全国,122,59,63
94,萧红故居,20220404,全国,全国,66,0,66
95,萧红故居,20220405,全国,全国,139,63,76
96,萧红故居,20220406,全国,全国,130,59,71
97,萧红故居,20220407,全国,全国,0,0,0
98,萧红故居,20220408,全国,全国,71,0,71
99,萧红故居,20220409,全国,全国,76,0,76
100,萧红故居,20220410,全国,全国,69,0,69
101,萧红故居,20220411,全国,全国,71,0,71
102,萧红故居,20220412,全国,全国,128,59,69
103,萧红故居,20220413,全国,全国,71,0,71
104,萧红故居,20220414,全国,全国,135,59,76
105,萧红故居,20220415,全国,全国,69,0,69
106,萧红故居,20220416,全国,全国,69,0,69
107,萧红故居,20220417,全国,全国,71,0,71
108,萧红故居,20220418,全国,全国,66,0,66
109,萧红故居,20220419,全国,全国,129,64,65
110,萧红故居,20220420,全国,全国,78,0,78
111,萧红故居,20220421,全国,全国,135,59,76
112,萧红故居,20220422,全国,全国,122,61,61
113,萧红故居,20220423,全国,全国,124,59,65
114,萧红故居,20220424,全国,全国,63,0,63
115,萧红故居,20220425,全国,全国,126,59,67
116,萧红故居,20220426,全国,全国,131,61,70
117,萧红故居,20220427,全国,全国,70,0,70
118,萧红故居,20220428,全国,全国,126,59,67
119,萧红故居,20220429,全国,全国,137,61,76
120,萧红故居,20220430,全国,全国,86,0,86
121,萧红故居,20220501,全国,全国,139,59,80
122,萧红故居,20220502,全国,全国,132,61,71
123,萧红故居,20220503,全国,全国,65,0,65
124,萧红故居,20220504,全国,全国,141,59,82
125,萧红故居,20220505,全国,全国,80,0,80
126,萧红故居,20220506,全国,全国,69,0,69
127,萧红故居,20220507,全国,全国,67,0,67
128,萧红故居,20220508,全国,全国,70,0,70
129,萧红故居,20220509,全国,全国,66,0,66
130,萧红故居,20220510,全国,全国,74,0,74
131,萧红故居,20220511,全国,全国,129,59,70
132,萧红故居,20220512,全国,全国,133,59,74
133,萧红故居,20220513,全国,全国,71,0,71
134,萧红故居,20220514,全国,全国,131,61,70
135,萧红故居,20220515,全国,全国,73,0,73
136,萧红故居,20220516,全国,全国,132,61,71
137,萧红故居,20220517,全国,全国,135,61,74
138,萧红故居,20220518,全国,全国,139,61,78
139,萧红故居,20220519,全国,全国,152,70,82
140,萧红故居,20220520,全国,全国,129,59,70
141,萧红故居,20220521,全国,全国,144,61,83
142,萧红故居,20220522,全国,全国,142,59,83
143,萧红故居,20220523,全国,全国,76,0,76
144,萧红故居,20220524,全国,全国,71,0,71
145,萧红故居,20220525,全国,全国,83,0,83
146,萧红故居,20220526,全国,全国,139,59,80
147,萧红故居,20220527,全国,全国,137,59,78
148,萧红故居,20220528,全国,全国,87,0,87
149,萧红故居,20220529,全国,全国,82,0,82
150,萧红故居,20220530,全国,全国,146,59,87
151,萧红故居,20220531,全国,全国,86,0,86
152,萧红故居,20220601,全国,全国,100,0,100
153,萧红故居,20220602,全国,全国,69,0,69
154,萧红故居,20220603,全国,全国,87,0,87
155,萧红故居,20220604,全国,全国,143,59,84
156,萧红故居,20220605,全国,全国,76,0,76
157,萧红故居,20220606,全国,全国,144,68,76
158,萧红故居,20220607,全国,全国,149,63,86
159,萧红故居,20220608,全国,全国,86,0,86
160,萧红故居,20220609,全国,全国,142,59,83
161,萧红故居,20220610,全国,全国,82,0,82
162,萧红故居,20220611,全国,全国,78,0,78
163,萧红故居,20220612,全国,全国,128,59,69
164,萧红故居,20220613,全国,全国,142,63,79
165,萧红故居,20220614,全国,全国,137,68,69
166,萧红故居,20220615,全国,全国,155,72,83
167,萧红故居,20220616,全国,全国,154,68,86
168,萧红故居,20220617,全国,全国,137,63,74
169,萧红故居,20220618,全国,全国,144,61,83
170,萧红故居,20220619,全国,全国,153,64,89
171,萧红故居,20220620,全国,全国,76,0,76
172,萧红故居,20220621,全国,全国,144,66,78
173,萧红故居,20220622,全国,全国,150,63,87
174,萧红故居,20220623,全国,全国,163,63,100
175,萧红故居,20220624,全国,全国,158,61,97
176,萧红故居,20220625,全国,全国,82,0,82
177,萧红故居,20220626,全国,全国,84,0,84
178,萧红故居,20220627,全国,全国,176,68,108
179,萧红故居,20220628,全国,全国,149,63,86
180,萧红故居,20220629,全国,全国,96,0,96
181,萧红故居,20220630,全国,全国,169,59,110
182,萧红故居,20220701,全国,全国,145,59,86
183,萧红故居,20220702,全国,全国,89,0,89
184,萧红故居,20220703,全国,全国,97,0,97
185,萧红故居,20220704,全国,全国,142,64,78
186,萧红故居,20220705,全国,全国,143,61,82
187,萧红故居,20220706,全国,全国,147,61,86
188,萧红故居,20220707,全国,全国,80,0,80
189,萧红故居,20220708,全国,全国,161,64,97
190,萧红故居,20220709,全国,全国,87,0,87
191,萧红故居,20220710,全国,全国,84,0,84
192,萧红故居,20220711,全国,全国,152,59,93
193,萧红故居,20220712,全国,全国,121,0,121
194,萧红故居,20220713,全国,全国,164,59,105
195,萧红故居,20220714,全国,全国,143,61,82
196,萧红故居,20220715,全国,全国,171,59,112
197,萧红故居,20220716,全国,全国,117,0,117
198,萧红故居,20220717,全国,全国,118,0,118
199,萧红故居,20220718,全国,全国,163,59,104
200,萧红故居,20220719,全国,全国,154,68,86
201,萧红故居,20220720,全国,全国,158,61,97
202,萧红故居,20220721,全国,全国,87,0,87
203,萧红故居,20220722,全国,全国,109,0,109
204,萧红故居,20220723,全国,全国,139,0,139
205,萧红故居,20220724,全国,全国,119,0,119
206,萧红故居,20220725,全国,全国,182,63,119
207,萧红故居,20220726,全国,全国,106,0,106
208,萧红故居,20220727,全国,全国,163,63,100
209,萧红故居,20220728,全国,全国,170,66,104
210,萧红故居,20220729,全国,全国,172,64,108
211,萧红故居,20220730,全国,全国,172,59,113
212,萧红故居,20220731,全国,全国,193,59,134
213,萧红故居,20220801,全国,全国,163,59,104
214,萧红故居,20220802,全国,全国,141,61,80
215,萧红故居,20220803,全国,全国,104,0,104
216,萧红故居,20220804,全国,全国,174,59,115
217,萧红故居,20220805,全国,全国,121,0,121
218,萧红故居,20220806,全国,全国,185,63,122
219,萧红故居,20220807,全国,全国,169,59,110
220,萧红故居,20220808,全国,全国,174,68,106
221,萧红故居,20220809,全国,全国,167,59,108
222,萧红故居,20220810,全国,全国,160,61,99
223,萧红故居,20220811,全国,全国,155,59,96
224,萧红故居,20220812,全国,全国,151,59,92
225,萧红故居,20220813,全国,全国,173,63,110
226,萧红故居,20220814,全国,全国,92,0,92
227,萧红故居,20220815,全国,全国,155,59,96
228,萧红故居,20220816,全国,全国,158,61,97
229,萧红故居,20220817,全国,全国,147,63,84
230,萧红故居,20220818,全国,全国,163,59,104
231,萧红故居,20220819,全国,全国,154,63,91
232,萧红故居,20220820,全国,全国,92,0,92
233,萧红故居,20220821,全国,全国,177,64,113
234,萧红故居,20220822,全国,全国,84,0,84
235,萧红故居,20220823,全国,全国,146,64,82
236,萧红故居,20220824,全国,全国,161,61,100
237,萧红故居,20220825,全国,全国,155,59,96
238,萧红故居,20220826,全国,全国,141,59,82
239,萧红故居,20220827,全国,全国,92,0,92
240,萧红故居,20220828,全国,全国,69,0,69
241,萧红故居,20220829,全国,全国,80,0,80
242,萧红故居,20220830,全国,全国,74,0,74
243,萧红故居,20220831,全国,全国,66,0,66
244,萧红故居,20220901,全国,全国,59,59,0
245,萧红故居,20220902,全国,全国,128,63,65
246,萧红故居,20220903,全国,全国,65,0,65
247,萧红故居,20220904,全国,全国,65,0,65
248,萧红故居,20220905,全国,全国,70,0,70
249,萧红故居,20220906,全国,全国,130,61,69
250,萧红故居,20220907,全国,全国,131,61,70
251,萧红故居,20220908,全国,全国,74,0,74
252,萧红故居,20220909,全国,全国,143,61,82
253,萧红故居,20220910,全国,全国,70,0,70
254,萧红故居,20220911,全国,全国,78,0,78
255,萧红故居,20220912,全国,全国,83,0,83
256,萧红故居,20220913,全国,全国,70,0,70
257,萧红故居,20220914,全国,全国,76,0,76
258,萧红故居,20220915,全国,全国,84,0,84
259,萧红故居,20220916,全国,全国,69,0,69
260,萧红故居,20220917,全国,全国,69,0,69
261,萧红故居,20220918,全国,全国,70,0,70
262,萧红故居,20220919,全国,全国,78,0,78
263,萧红故居,20220920,全国,全国,67,0,67
264,萧红故居,20220921,全国,全国,65,0,65
265,萧红故居,20220922,全国,全国,70,0,70
266,萧红故居,20220923,全国,全国,140,64,76
267,萧红故居,20220924,全国,全国,69,0,69
268,萧红故居,20220925,全国,全国,69,0,69
269,萧红故居,20220926,全国,全国,61,61,0
270,萧红故居,20220927,全国,全国,63,0,63
271,萧红故居,20220928,全国,全国,66,0,66
272,萧红故居,20220929,全国,全国,69,0,69
273,萧红故居,20220930,全国,全国,83,0,83
274,萧红故居,20221001,全国,全国,80,0,80
275,萧红故居,20221002,全国,全国,95,0,95
276,萧红故居,20221003,全国,全国,70,0,70
277,萧红故居,20221004,全国,全国,80,0,80
278,萧红故居,20221005,全国,全国,89,0,89
279,萧红故居,20221006,全国,全国,133,63,70
280,萧红故居,20221007,全国,全国,142,59,83
281,萧红故居,20221008,全国,全国,79,0,79
282,萧红故居,20221009,全国,全国,66,0,66
283,萧红故居,20221010,全国,全国,126,63,63
284,萧红故居,20221011,全国,全国,70,0,70
285,萧红故居,20221012,全国,全国,63,0,63
286,萧红故居,20221013,全国,全国,63,0,63
287,萧红故居,20221014,全国,全国,0,0,0
288,萧红故居,20221015,全国,全国,143,63,80
289,萧红故居,20221016,全国,全国,67,0,67
290,萧红故居,20221017,全国,全国,122,59,63
291,萧红故居,20221018,全国,全国,71,0,71
292,萧红故居,20221019,全国,全国,80,0,80
293,萧红故居,20221020,全国,全国,141,63,78
294,萧红故居,20221021,全国,全国,76,0,76
295,萧红故居,20221022,全国,全国,83,0,83
296,萧红故居,20221023,全国,全国,141,59,82
297,萧红故居,20221024,全国,全国,76,0,76
298,萧红故居,20221025,全国,全国,87,0,87
299,萧红故居,20221026,全国,全国,135,59,76
300,萧红故居,20221027,全国,全国,76,0,76
301,萧红故居,20221028,全国,全国,135,59,76
302,萧红故居,20221029,全国,全国,157,64,93
303,萧红故居,20221030,全国,全国,70,0,70
304,萧红故居,20221031,全国,全国,124,59,65
305,萧红故居,20221101,全国,全国,69,0,69
306,萧红故居,20221102,全国,全国,69,0,69
307,萧红故居,20221103,全国,全国,138,59,79
308,萧红故居,20221104,全国,全国,126,59,67
309,萧红故居,20221105,全国,全国,70,0,70
310,萧红故居,20221106,全国,全国,125,59,66
311,萧红故居,20221107,全国,全国,140,66,74
312,萧红故居,20221108,全国,全国,139,59,80
313,萧红故居,20221109,全国,全国,132,59,73
314,萧红故居,20221110,全国,全国,70,0,70
315,萧红故居,20221111,全国,全国,137,61,76
316,萧红故居,20221112,全国,全国,76,0,76
317,萧红故居,20221113,全国,全国,132,61,71
318,萧红故居,20221114,全国,全国,70,0,70
319,萧红故居,20221115,全国,全国,0,0,0
320,萧红故居,20221116,全国,全国,134,61,73
321,萧红故居,20221117,全国,全国,65,0,65
322,萧红故居,20221118,全国,全国,136,63,73
323,萧红故居,20221119,全国,全国,135,61,74
324,萧红故居,20221120,全国,全国,70,0,70
325,萧红故居,20221121,全国,全国,78,0,78
326,萧红故居,20221122,全国,全国,71,0,71
327,萧红故居,20221123,全国,全国,67,0,67
328,萧红故居,20221124,全国,全国,70,0,70
329,萧红故居,20221125,全国,全国,63,0,63
330,萧红故居,20221126,全国,全国,130,61,69
331,萧红故居,20221127,全国,全国,65,0,65
332,萧红故居,20221128,全国,全国,69,0,69
333,萧红故居,20221129,全国,全国,122,59,63
334,萧红故居,20221130,全国,全国,61,0,61
335,萧红故居,20221201,全国,全国,67,0,67
336,萧红故居,20221202,全国,全国,74,0,74
337,萧红故居,20221203,全国,全国,69,0,69
338,萧红故居,20221204,全国,全国,65,0,65
339,萧红故居,20221205,全国,全国,69,0,69
340,萧红故居,20221206,全国,全国,138,59,79
341,萧红故居,20221207,全国,全国,124,61,63
342,萧红故居,20221208,全国,全国,78,0,78
343,萧红故居,20221209,全国,全国,80,0,80
344,萧红故居,20221210,全国,全国,67,0,67
345,萧红故居,20221211,全国,全国,131,61,70
346,萧红故居,20221212,全国,全国,67,0,67
347,萧红故居,20221213,全国,全国,122,61,61
348,萧红故居,20221214,全国,全国,126,61,65
349,萧红故居,20221215,全国,全国,0,0,0
350,萧红故居,20221216,全国,全国,125,59,66
351,萧红故居,20221217,全国,全国,73,0,73
352,萧红故居,20221218,全国,全国,0,0,0
353,萧红故居,20221219,全国,全国,122,59,63
354,萧红故居,20221220,全国,全国,59,59,0
355,萧红故居,20221221,全国,全国,125,59,66
356,萧红故居,20221222,全国,全国,65,0,65
357,萧红故居,20221223,全国,全国,0,0,0
358,萧红故居,20221224,全国,全国,67,0,67
359,萧红故居,20221225,全国,全国,125,59,66
360,萧红故居,20221226,全国,全国,67,0,67
361,萧红故居,20221227,全国,全国,65,0,65
362,萧红故居,20221228,全国,全国,126,63,63
363,萧红故居,20221229,全国,全国,80,0,80
364,萧红故居,20221230,全国,全国,65,0,65
365,萧红故居,20221231,全国,全国,70,0,70
366,萧红故居,20230101,全国,全国,127,61,66
367,萧红故居,20230102,全国,全国,73,0,73
368,萧红故居,20230103,全国,全国,131,61,70
369,萧红故居,20230104,全国,全国,126,61,65
370,萧红故居,20230105,全国,全国,137,63,74
371,萧红故居,20230106,全国,全国,124,61,63
372,萧红故居,20230107,全国,全国,76,0,76
373,萧红故居,20230108,全国,全国,71,0,71
374,萧红故居,20230109,全国,全国,69,0,69
375,萧红故居,20230110,全国,全国,122,59,63
376,萧红故居,20230111,全国,全国,73,0,73
377,萧红故居,20230112,全国,全国,129,64,65
378,萧红故居,20230113,全国,全国,135,61,74
379,萧红故居,20230114,全国,全国,132,59,73
380,萧红故居,20230115,全国,全国,65,0,65
381,萧红故居,20230116,全国,全国,70,0,70
382,萧红故居,20230117,全国,全国,65,0,65
383,萧红故居,20230118,全国,全国,73,0,73
384,萧红故居,20230119,全国,全国,146,59,87
385,萧红故居,20230120,全国,全国,78,0,78
386,萧红故居,20230121,全国,全国,66,0,66
387,萧红故居,20230122,全国,全国,71,0,71
388,萧红故居,20230123,全国,全国,65,0,65
389,萧红故居,20230124,全国,全国,80,0,80
390,萧红故居,20230125,全国,全国,143,61,82
391,萧红故居,20230126,全国,全国,84,0,84
392,萧红故居,20230127,全国,全国,82,0,82
393,萧红故居,20230128,全国,全国,96,0,96
394,萧红故居,20230129,全国,全国,74,0,74
395,萧红故居,20230130,全国,全国,135,59,76
396,萧红故居,20230131,全国,全国,70,0,70
397,萧红故居,20230201,全国,全国,135,61,74
398,萧红故居,20230202,全国,全国,135,59,76
399,萧红故居,20230203,全国,全国,156,61,95
400,萧红故居,20230204,全国,全国,69,0,69
401,萧红故居,20230205,全国,全国,140,61,79
402,萧红故居,20230206,全国,全国,83,0,83
403,萧红故居,20230207,全国,全国,154,61,93
404,萧红故居,20230208,全国,全国,181,64,117
405,萧红故居,20230209,全国,全国,187,64,123
406,萧红故居,20230210,全国,全国,184,59,125
407,萧红故居,20230211,全国,全国,159,59,100
408,萧红故居,20230212,全国,全国,170,61,109
409,萧红故居,20230213,全国,全国,176,61,115
410,萧红故居,20230214,全国,全国,160,61,99
411,萧红故居,20230215,全国,全国,169,64,105
412,萧红故居,20230216,全国,全国,115,0,115
413,萧红故居,20230217,全国,全国,167,61,106
414,萧红故居,20230218,全国,全国,100,0,100
415,萧红故居,20230219,全国,全国,165,59,106
416,萧红故居,20230220,全国,全国,145,59,86
417,萧红故居,20230221,全国,全国,152,59,93
418,萧红故居,20230222,全国,全国,179,64,115
419,萧红故居,20230223,全国,全国,161,61,100
420,萧红故居,20230224,全国,全国,156,61,95
421,萧红故居,20230225,全国,全国,186,68,118
422,萧红故居,20230226,全国,全国,185,63,122
423,萧红故居,20230227,全国,全国,178,63,115
424,萧红故居,20230228,全国,全国,84,0,84
425,萧红故居,20230301,全国,全国,97,0,97
426,萧红故居,20230302,全国,全国,156,64,92
427,萧红故居,20230303,全国,全国,93,0,93
428,萧红故居,20230304,全国,全国,182,63,119
429,萧红故居,20230305,全国,全国,187,61,126
430,萧红故居,20230306,全国,全国,169,59,110
431,萧红故居,20230307,全国,全国,100,0,100
432,萧红故居,20230308,全国,全国,163,72,91
433,萧红故居,20230309,全国,全国,153,61,92
434,萧红故居,20230310,全国,全国,89,0,89
435,萧红故居,20230311,全国,全国,109,0,109
436,萧红故居,20230312,全国,全国,115,0,115
437,萧红故居,20230313,全国,全国,136,66,70
438,萧红故居,20230314,全国,全国,92,0,92
439,萧红故居,20230315,全国,全国,157,64,93
440,萧红故居,20230316,全国,全国,82,0,82
441,萧红故居,20230317,全国,全国,102,0,102
442,萧红故居,20230318,全国,全国,108,0,108
443,萧红故居,20230319,全国,全国,169,64,105
444,萧红故居,20230320,全国,全国,83,0,83
445,萧红故居,20230321,全国,全国,139,59,80
446,萧红故居,20230322,全国,全国,151,59,92
447,萧红故居,20230323,全国,全国,138,59,79
448,萧红故居,20230324,全国,全国,152,68,84
449,萧红故居,20230325,全国,全国,102,0,102
450,萧红故居,20230326,全国,全国,102,0,102
451,萧红故居,20230327,全国,全国,150,61,89
452,萧红故居,20230328,全国,全国,161,59,102
453,萧红故居,20230329,全国,全国,167,61,106
454,萧红故居,20230330,全国,全国,173,61,112
455,萧红故居,20230331,全国,全国,160,68,92
456,萧红故居,20230401,全国,全国,135,0,135
457,萧红故居,20230402,全国,全国,191,63,128
458,萧红故居,20230403,全国,全国,161,59,102
459,萧红故居,20230404,全国,全国,188,63,125
460,萧红故居,20230405,全国,全国,147,0,147
461,萧红故居,20230406,全国,全国,150,59,91
462,萧红故居,20230407,全国,全国,155,59,96
463,萧红故居,20230408,全国,全国,102,0,102
464,萧红故居,20230409,全国,全国,112,0,112
465,萧红故居,20230410,全国,全国,155,63,92
466,萧红故居,20230411,全国,全国,137,63,74
467,萧红故居,20230412,全国,全国,89,0,89
468,萧红故居,20230413,全国,全国,96,0,96
469,萧红故居,20230414,全国,全国,176,61,115
470,萧红故居,20230415,全国,全国,172,59,113
471,萧红故居,20230416,全国,全国,180,59,121
472,萧红故居,20230417,全国,全国,146,59,87
473,萧红故居,20230418,全国,全国,157,64,93
474,萧红故居,20230419,全国,全国,174,59,115
475,萧红故居,20230420,全国,全国,158,61,97
476,萧红故居,20230421,全国,全国,170,66,104
477,萧红故居,20230422,全国,全国,115,0,115
478,萧红故居,20230423,全国,全国,193,70,123
479,萧红故居,20230424,全国,全国,188,63,125
480,萧红故居,20230425,全国,全国,187,70,117
481,萧红故居,20230426,全国,全国,184,61,123
482,萧红故居,20230427,全国,全国,171,66,105
483,萧红故居,20230428,全国,全国,99,0,99
484,萧红故居,20230429,全国,全国,155,0,155
485,萧红故居,20230430,全国,全国,229,59,170
486,萧红故居,20230501,全国,全国,199,0,199
487,萧红故居,20230502,全国,全国,182,0,182
488,萧红故居,20230503,全国,全国,141,0,141
489,萧红故居,20230504,全国,全国,152,61,91
490,萧红故居,20230505,全国,全国,163,59,104
491,萧红故居,20230506,全国,全国,86,0,86
492,萧红故居,20230507,全国,全国,86,0,86
493,萧红故居,20230508,全国,全国,158,63,95
494,萧红故居,20230509,全国,全国,161,61,100
495,萧红故居,20230510,全国,全国,174,61,113
496,萧红故居,20230511,全国,全国,148,74,74
497,萧红故居,20230512,全国,全国,157,66,91
498,萧红故居,20230513,全国,全国,87,0,87
499,萧红故居,20230514,全国,全国,99,0,99
500,萧红故居,20230515,全国,全国,152,66,86
501,萧红故居,20230516,全国,全国,150,59,91
502,萧红故居,20230517,全国,全国,156,61,95
503,萧红故居,20230518,全国,全国,156,61,95
504,萧红故居,20230519,全国,全国,158,59,99
505,萧红故居,20230520,全国,全国,154,59,95
506,萧红故居,20230521,全国,全国,84,0,84
507,萧红故居,20230522,全国,全国,152,59,93
508,萧红故居,20230523,全国,全国,93,0,93
509,萧红故居,20230524,全国,全国,148,59,89
510,萧红故居,20230525,全国,全国,170,61,109
511,萧红故居,20230526,全国,全国,153,66,87
512,萧红故居,20230527,全国,全国,154,61,93
513,萧红故居,20230528,全国,全国,174,61,113
514,萧红故居,20230529,全国,全国,155,66,89
515,萧红故居,20230530,全国,全国,144,61,83
516,萧红故居,20230531,全国,全国,84,0,84
517,萧红故居,20230601,全国,全国,102,0,102
518,萧红故居,20230602,全国,全国,89,0,89
519,萧红故居,20230603,全国,全国,169,61,108
520,萧红故居,20230604,全国,全国,164,68,96
521,萧红故居,20230605,全国,全国,93,0,93
522,萧红故居,20230606,全国,全国,93,0,93
523,萧红故居,20230607,全国,全国,150,59,91
524,萧红故居,20230608,全国,全国,73,0,73
525,萧红故居,20230609,全国,全国,148,61,87
526,萧红故居,20230610,全国,全国,95,0,95
527,萧红故居,20230611,全国,全国,78,0,78
528,萧红故居,20230612,全国,全国,87,0,87
529,萧红故居,20230613,全国,全国,97,0,97
530,萧红故居,20230614,全国,全国,140,61,79
531,萧红故居,20230615,全国,全国,87,0,87
532,萧红故居,20230616,全国,全国,146,66,80
533,萧红故居,20230617,全国,全国,145,59,86
534,萧红故居,20230618,全国,全国,110,0,110
535,萧红故居,20230619,全国,全国,142,63,79
536,萧红故居,20230620,全国,全国,152,61,91
537,萧红故居,20230621,全国,全国,112,0,112
538,萧红故居,20230622,全国,全国,141,0,141
539,萧红故居,20230623,全国,全国,130,0,130
540,萧红故居,20230624,全国,全国,216,61,155
541,萧红故居,20230625,全国,全国,173,63,110
542,萧红故居,20230626,全国,全国,192,64,128
543,萧红故居,20230627,全国,全国,221,70,151
544,萧红故居,20230628,全国,全国,180,63,117
545,萧红故居,20230629,全国,全国,157,64,93
546,萧红故居,20230630,全国,全国,106,0,106
547,萧红故居,20230701,全国,全国,172,59,113
548,萧红故居,20230702,全国,全国,153,61,92
549,萧红故居,20230703,全国,全国,152,59,93
550,萧红故居,20230704,全国,全国,104,0,104
551,萧红故居,20230705,全国,全国,89,0,89
552,萧红故居,20230706,全国,全国,157,61,96
553,萧红故居,20230707,全国,全国,168,64,104
554,萧红故居,20230708,全国,全国,121,0,121
555,萧红故居,20230709,全国,全国,105,0,105
556,萧红故居,20230710,全国,全国,161,61,100
557,萧红故居,20230711,全国,全国,184,63,121
558,萧红故居,20230712,全国,全国,160,61,99
559,萧红故居,20230713,全国,全国,197,61,136
560,萧红故居,20230714,全国,全国,173,64,109
561,萧红故居,20230715,全国,全国,169,61,108
562,萧红故居,20230716,全国,全国,173,63,110
563,萧红故居,20230717,全国,全国,91,0,91
564,萧红故居,20230718,全国,全国,119,0,119
565,萧红故居,20230719,全国,全国,176,59,117
566,萧红故居,20230720,全国,全国,163,59,104
567,萧红故居,20230721,全国,全国,200,70,130
568,萧红故居,20230722,全国,全国,200,61,139
569,萧红故居,20230723,全国,全国,191,61,130
570,萧红故居,20230724,全国,全国,157,64,93
571,萧红故居,20230725,全国,全国,189,59,130
572,萧红故居,20230726,全国,全国,188,63,125
573,萧红故居,20230727,全国,全国,175,63,112
574,萧红故居,20230728,全国,全国,176,61,115
575,萧红故居,20230729,全国,全国,134,0,134
576,萧红故居,20230730,全国,全国,132,0,132
577,萧红故居,20230731,全国,全国,163,59,104
578,萧红故居,20230801,全国,全国,202,59,143
579,萧红故居,20230802,全国,全国,95,0,95
580,萧红故居,20230803,全国,全国,106,0,106
581,萧红故居,20230804,全国,全国,173,63,110
582,萧红故居,20230805,全国,全国,198,59,139
583,萧红故居,20230806,全国,全国,212,63,149
584,萧红故居,20230807,全国,全国,174,66,108
585,萧红故居,20230808,全国,全国,115,0,115
586,萧红故居,20230809,全国,全国,197,66,131
587,萧红故居,20230810,全国,全国,118,0,118
588,萧红故居,20230811,全国,全国,108,0,108
589,萧红故居,20230812,全国,全国,100,0,100
590,萧红故居,20230813,全国,全国,167,59,108
591,萧红故居,20230814,全国,全国,128,0,128
592,萧红故居,20230815,全国,全国,176,63,113
593,萧红故居,20230816,全国,全国,173,63,110
594,萧红故居,20230817,全国,全国,187,61,126
595,萧红故居,20230818,全国,全国,167,59,108
596,萧红故居,20230819,全国,全国,144,0,144
597,萧红故居,20230820,全国,全国,108,0,108
598,萧红故居,20230821,全国,全国,159,63,96
599,萧红故居,20230822,全国,全国,152,59,93
600,萧红故居,20230823,全国,全国,153,61,92
601,萧红故居,20230824,全国,全国,156,64,92
602,萧红故居,20230825,全国,全国,97,0,97
603,萧红故居,20230826,全国,全国,104,0,104
604,萧红故居,20230827,全国,全国,109,0,109
605,萧红故居,20230828,全国,全国,163,59,104
606,萧红故居,20230829,全国,全国,95,0,95
607,萧红故居,20230830,全国,全国,179,74,105
608,萧红故居,20230831,全国,全国,161,66,95
609,萧红故居,20230901,全国,全国,142,63,79
610,萧红故居,20230902,全国,全国,158,61,97
611,萧红故居,20230903,全国,全国,141,61,80
612,萧红故居,20230904,全国,全国,155,59,96
613,萧红故居,20230905,全国,全国,71,0,71
614,萧红故居,20230906,全国,全国,78,0,78
615,萧红故居,20230907,全国,全国,93,0,93
616,萧红故居,20230908,全国,全国,76,0,76
617,萧红故居,20230909,全国,全国,96,0,96
618,萧红故居,20230910,全国,全国,92,0,92
619,萧红故居,20230911,全国,全国,84,0,84
620,萧红故居,20230912,全国,全国,138,59,79
621,萧红故居,20230913,全国,全国,150,63,87
622,萧红故居,20230914,全国,全国,80,0,80
623,萧红故居,20230915,全国,全国,82,0,82
624,萧红故居,20230916,全国,全国,95,0,95
625,萧红故居,20230917,全国,全国,87,0,87
626,萧红故居,20230918,全国,全国,145,63,82
627,萧红故居,20230919,全国,全国,78,0,78
628,萧红故居,20230920,全国,全国,83,0,83
629,萧红故居,20230921,全国,全国,140,61,79
630,萧红故居,20230922,全国,全国,141,59,82
631,萧红故居,20230923,全国,全国,106,0,106
632,萧红故居,20230924,全国,全国,143,61,82
633,萧红故居,20230925,全国,全国,156,63,93
634,萧红故居,20230926,全国,全国,83,0,83
635,萧红故居,20230927,全国,全国,104,0,104
636,萧红故居,20230928,全国,全国,172,63,109
637,萧红故居,20230929,全国,全国,105,0,105
638,萧红故居,20230930,全国,全国,102,0,102
639,萧红故居,20231001,全国,全国,185,59,126
640,萧红故居,20231002,全国,全国,163,0,163
641,萧红故居,20231003,全国,全国,210,66,144
642,萧红故居,20231004,全国,全国,112,0,112
643,萧红故居,20231005,全国,全国,113,0,113
644,萧红故居,20231006,全国,全国,168,59,109
645,萧红故居,20231007,全国,全国,154,61,93
646,萧红故居,20231008,全国,全国,151,59,92
647,萧红故居,20231009,全国,全国,152,70,82
648,萧红故居,20231010,全国,全国,139,63,76
649,萧红故居,20231011,全国,全国,93,0,93
650,萧红故居,20231012,全国,全国,139,59,80
651,萧红故居,20231013,全国,全国,87,0,87
652,萧红故居,20231014,全国,全国,96,0,96
653,萧红故居,20231015,全国,全国,71,0,71
654,萧红故居,20231016,全国,全国,74,0,74
655,萧红故居,20231017,全国,全国,139,63,76
656,萧红故居,20231018,全国,全国,150,68,82
657,萧红故居,20231019,全国,全国,141,59,82
658,萧红故居,20231020,全国,全国,65,0,65
659,萧红故居,20231021,全国,全国,78,0,78
660,萧红故居,20231022,全国,全国,135,59,76
661,萧红故居,20231023,全国,全国,130,59,71
662,萧红故居,20231024,全国,全国,76,0,76
663,萧红故居,20231025,全国,全国,0,0,0
664,萧红故居,20231026,全国,全国,87,0,87
665,萧红故居,20231027,全国,全国,71,0,71
666,萧红故居,20231028,全国,全国,84,0,84
667,萧红故居,20231029,全国,全国,70,0,70
668,萧红故居,20231030,全国,全国,133,63,70
669,萧红故居,20231031,全国,全国,129,59,70
670,萧红故居,20231101,全国,全国,70,0,70
671,萧红故居,20231102,全国,全国,125,59,66
672,萧红故居,20231103,全国,全国,82,0,82
673,萧红故居,20231104,全国,全国,73,0,73
674,萧红故居,20231105,全国,全国,82,0,82
675,萧红故居,20231106,全国,全国,122,59,63
676,萧红故居,20231107,全国,全国,132,66,66
677,萧红故居,20231108,全国,全国,129,66,63
678,萧红故居,20231109,全国,全国,69,0,69
679,萧红故居,20231110,全国,全国,71,0,71
680,萧红故居,20231111,全国,全国,83,0,83
681,萧红故居,20231112,全国,全国,69,0,69
682,萧红故居,20231113,全国,全国,131,61,70
683,萧红故居,20231114,全国,全国,150,61,89
684,萧红故居,20231115,全国,全国,130,61,69
685,萧红故居,20231116,全国,全国,66,0,66
686,萧红故居,20231117,全国,全国,133,59,74
687,萧红故居,20231118,全国,全国,73,0,73
688,萧红故居,20231119,全国,全国,139,59,80
689,萧红故居,20231120,全国,全国,146,59,87
690,萧红故居,20231121,全国,全国,150,59,91
691,萧红故居,20231122,全国,全国,76,0,76
692,萧红故居,20231123,全国,全国,76,0,76
693,萧红故居,20231124,全国,全国,76,0,76
694,萧红故居,20231125,全国,全国,74,0,74
695,萧红故居,20231126,全国,全国,128,59,69
696,萧红故居,20231127,全国,全国,128,61,67
697,萧红故居,20231128,全国,全国,126,61,65
698,萧红故居,20231129,全国,全国,128,61,67
699,萧红故居,20231130,全国,全国,70,0,70
700,萧红故居,20231201,全国,全国,132,63,69
701,萧红故居,20231202,全国,全国,73,0,73
702,萧红故居,20231203,全国,全国,86,0,86
703,萧红故居,20231204,全国,全国,135,61,74
704,萧红故居,20231205,全国,全国,78,0,78
705,萧红故居,20231206,全国,全国,74,0,74
706,萧红故居,20231207,全国,全国,69,0,69
707,萧红故居,20231208,全国,全国,137,59,78
708,萧红故居,20231209,全国,全国,66,0,66
709,萧红故居,20231210,全国,全国,80,0,80
710,萧红故居,20231211,全国,全国,61,0,61
711,萧红故居,20231212,全国,全国,138,59,79
712,萧红故居,20231213,全国,全国,73,0,73
713,萧红故居,20231214,全国,全国,132,61,71
714,萧红故居,20231215,全国,全国,70,0,70
715,萧红故居,20231216,全国,全国,79,0,79
716,萧红故居,20231217,全国,全国,138,64,74
717,萧红故居,20231218,全国,全国,149,63,86
718,萧红故居,20231219,全国,全国,122,59,63
719,萧红故居,20231220,全国,全国,76,0,76
720,萧红故居,20231221,全国,全国,128,59,69
721,萧红故居,20231222,全国,全国,73,0,73
722,萧红故居,20231223,全国,全国,78,0,78
723,萧红故居,20231224,全国,全国,134,63,71
724,萧红故居,20231225,全国,全国,65,0,65
725,萧红故居,20231226,全国,全国,67,0,67
726,萧红故居,20231227,全国,全国,145,59,86
727,萧红故居,20231228,全国,全国,84,0,84
728,萧红故居,20231229,全国,全国,80,0,80
729,萧红故居,20231230,全国,全国,100,0,100
730,萧红故居,20231231,全国,全国,78,0,78
731,萧红故居,20240101,全国,全国,74,0,74
732,萧红故居,20240102,全国,全国,69,0,69
733,萧红故居,20240103,全国,全国,70,0,70
734,萧红故居,20240104,全国,全国,148,61,87
735,萧红故居,20240105,全国,全国,150,64,86
736,萧红故居,20240106,全国,全国,146,59,87
737,萧红故居,20240107,全国,全国,80,0,80
738,萧红故居,20240108,全国,全国,153,61,92
739,萧红故居,20240109,全国,全国,86,0,86
740,萧红故居,20240110,全国,全国,143,61,82
741,萧红故居,20240111,全国,全国,80,0,80
742,萧红故居,20240112,全国,全国,143,61,82
743,萧红故居,20240113,全国,全国,73,0,73
744,萧红故居,20240114,全国,全国,91,0,91
745,萧红故居,20240115,全国,全国,91,0,91
746,萧红故居,20240116,全国,全国,89,0,89
747,萧红故居,20240117,全国,全国,150,63,87
748,萧红故居,20240118,全国,全国,144,61,83
749,萧红故居,20240119,全国,全国,74,0,74
750,萧红故居,20240120,全国,全国,143,59,84
751,萧红故居,20240121,全国,全国,104,0,104
752,萧红故居,20240122,全国,全国,160,64,96
753,萧红故居,20240123,全国,全国,153,66,87
754,萧红故居,20240124,全国,全国,141,59,82
755,萧红故居,20240125,全国,全国,145,59,86
756,萧红故居,20240126,全国,全国,95,0,95
757,萧红故居,20240127,全国,全国,105,0,105
758,萧红故居,20240128,全国,全国,92,0,92
759,萧红故居,20240129,全国,全国,141,63,78
760,萧红故居,20240130,全国,全国,92,0,92
761,萧红故居,20240131,全国,全国,92,0,92
762,萧红故居,20240201,全国,全国,138,59,79
763,萧红故居,20240202,全国,全国,80,0,80
764,萧红故居,20240203,全国,全国,130,61,69
765,萧红故居,20240204,全国,全国,142,59,83
766,萧红故居,20240205,全国,全国,78,0,78
767,萧红故居,20240206,全国,全国,141,59,82
768,萧红故居,20240207,全国,全国,141,59,82
769,萧红故居,20240208,全国,全国,130,59,71
770,萧红故居,20240209,全国,全国,78,0,78
771,萧红故居,20240210,全国,全国,66,0,66
772,萧红故居,20240211,全国,全国,89,0,89
773,萧红故居,20240212,全国,全国,93,0,93
774,萧红故居,20240213,全国,全国,104,0,104
775,萧红故居,20240214,全国,全国,112,0,112
776,萧红故居,20240215,全国,全国,168,59,109
777,萧红故居,20240216,全国,全国,93,0,93
778,萧红故居,20240217,全国,全国,91,0,91
779,萧红故居,20240218,全国,全国,87,0,87
780,萧红故居,20240219,全国,全国,78,0,78
781,萧红故居,20240220,全国,全国,83,0,83
782,萧红故居,20240221,全国,全国,169,63,106
783,萧红故居,20240222,全国,全国,167,61,106
784,萧红故居,20240223,全国,全国,157,66,91
785,萧红故居,20240224,全国,全国,145,59,86
786,萧红故居,20240225,全国,全国,161,61,100
787,萧红故居,20240226,全国,全国,172,59,113
788,萧红故居,20240227,全国,全国,196,68,128
789,萧红故居,20240228,全国,全国,246,72,174
790,萧红故居,20240229,全国,全国,257,70,187
791,萧红故居,20240301,全国,全国,183,64,119
792,萧红故居,20240302,全国,全国,108,0,108
793,萧红故居,20240303,全国,全国,170,61,109
794,萧红故居,20240304,全国,全国,164,68,96
795,萧红故居,20240305,全国,全国,93,0,93
796,萧红故居,20240306,全国,全国,160,68,92
797,萧红故居,20240307,全国,全国,137,61,76
798,萧红故居,20240308,全国,全国,83,0,83
799,萧红故居,20240309,全国,全国,96,0,96
800,萧红故居,20240310,全国,全国,163,59,104
801,萧红故居,20240311,全国,全国,141,59,82
802,萧红故居,20240312,全国,全国,86,0,86
803,萧红故居,20240313,全国,全国,133,59,74
804,萧红故居,20240314,全国,全国,151,59,92
805,萧红故居,20240315,全国,全国,73,0,73
806,萧红故居,20240316,全国,全国,82,0,82
807,萧红故居,20240317,全国,全国,110,0,110
808,萧红故居,20240318,全国,全国,89,0,89
809,萧红故居,20240319,全国,全国,87,0,87
810,萧红故居,20240320,全国,全国,139,61,78
811,萧红故居,20240321,全国,全国,132,59,73
812,萧红故居,20240322,全国,全国,141,61,80
813,萧红故居,20240323,全国,全国,78,0,78
814,萧红故居,20240324,全国,全国,162,63,99
815,萧红故居,20240325,全国,全国,142,59,83
816,萧红故居,20240326,全国,全国,80,0,80
817,萧红故居,20240327,全国,全国,152,59,93
818,萧红故居,20240328,全国,全国,133,63,70
819,萧红故居,20240329,全国,全国,141,63,78
820,萧红故居,20240330,全国,全国,83,0,83
821,萧红故居,20240331,全国,全国,99,0,99
822,萧红故居,20240401,全国,全国,138,64,74
823,萧红故居,20240402,全国,全国,153,64,89
824,萧红故居,20240403,全国,全国,110,0,110
825,萧红故居,20240404,全国,全国,220,63,157
826,萧红故居,20240405,全国,全国,151,0,151
827,萧红故居,20240406,全国,全国,152,59,93
828,萧红故居,20240407,全国,全国,78,0,78
829,萧红故居,20240408,全国,全国,150,61,89
830,萧红故居,20240409,全国,全国,129,59,70
831,萧红故居,20240410,全国,全国,83,0,83
832,萧红故居,20240411,全国,全国,132,61,71
833,萧红故居,20240412,全国,全国,151,59,92
834,萧红故居,20240413,全国,全国,167,59,108
835,萧红故居,20240414,全国,全国,143,61,82
836,萧红故居,20240415,全国,全国,146,63,83
837,萧红故居,20240416,全国,全国,144,61,83
838,萧红故居,20240417,全国,全国,145,61,84
839,萧红故居,20240418,全国,全国,152,61,91
840,萧红故居,20240419,全国,全国,156,57,99
841,萧红故居,20240420,全国,全国,156,61,95
842,萧红故居,20240421,全国,全国,162,63,99
843,萧红故居,20240422,全国,全国,136,63,73
844,萧红故居,20240423,全国,全国,86,0,86
845,萧红故居,20240424,全国,全国,150,57,93
846,萧红故居,20240425,全国,全国,152,61,91
847,萧红故居,20240426,全国,全国,154,59,95
848,萧红故居,20240427,全国,全国,154,57,97
849,萧红故居,20240428,全国,全国,159,66,93
850,萧红故居,20240429,全国,全国,155,64,91
851,萧红故居,20240430,全国,全国,161,66,95
1,沙糖桔,20220101,全国,全国,0,0,0
2,沙糖桔,20220102,全国,全国,0,0,0
3,沙糖桔,20220103,全国,全国,0,0,0
4,沙糖桔,20220104,全国,全国,0,0,0
5,沙糖桔,20220105,全国,全国,0,0,0
6,沙糖桔,20220106,全国,全国,0,0,0
7,沙糖桔,20220107,全国,全国,0,0,0
8,沙糖桔,20220108,全国,全国,0,0,0
9,沙糖桔,20220109,全国,全国,0,0,0
10,沙糖桔,20220110,全国,全国,0,0,0
11,沙糖桔,20220111,全国,全国,0,0,0
12,沙糖桔,20220112,全国,全国,0,0,0
13,沙糖桔,20220113,全国,全国,0,0,0
14,沙糖桔,20220114,全国,全国,0,0,0
15,沙糖桔,20220115,全国,全国,0,0,0
16,沙糖桔,20220116,全国,全国,0,0,0
17,沙糖桔,20220117,全国,全国,0,0,0
18,沙糖桔,20220118,全国,全国,0,0,0
19,沙糖桔,20220119,全国,全国,0,0,0
20,沙糖桔,20220120,全国,全国,0,0,0
21,沙糖桔,20220121,全国,全国,0,0,0
22,沙糖桔,20220122,全国,全国,0,0,0
23,沙糖桔,20220123,全国,全国,0,0,0
24,沙糖桔,20220124,全国,全国,0,0,0
25,沙糖桔,20220125,全国,全国,0,0,0
26,沙糖桔,20220126,全国,全国,0,0,0
27,沙糖桔,20220127,全国,全国,0,0,0
28,沙糖桔,20220128,全国,全国,0,0,0
29,沙糖桔,20220129,全国,全国,0,0,0
30,沙糖桔,20220130,全国,全国,0,0,0
31,沙糖桔,20220131,全国,全国,0,0,0
32,沙糖桔,20220201,全国,全国,0,0,0
33,沙糖桔,20220202,全国,全国,0,0,0
34,沙糖桔,20220203,全国,全国,0,0,0
35,沙糖桔,20220204,全国,全国,0,0,0
36,沙糖桔,20220205,全国,全国,0,0,0
37,沙糖桔,20220206,全国,全国,0,0,0
38,沙糖桔,20220207,全国,全国,0,0,0
39,沙糖桔,20220208,全国,全国,0,0,0
40,沙糖桔,20220209,全国,全国,0,0,0
41,沙糖桔,20220210,全国,全国,0,0,0
42,沙糖桔,20220211,全国,全国,0,0,0
43,沙糖桔,20220212,全国,全国,0,0,0
44,沙糖桔,20220213,全国,全国,0,0,0
45,沙糖桔,20220214,全国,全国,0,0,0
46,沙糖桔,20220215,全国,全国,0,0,0
47,沙糖桔,20220216,全国,全国,0,0,0
48,沙糖桔,20220217,全国,全国,0,0,0
49,沙糖桔,20220218,全国,全国,0,0,0
50,沙糖桔,20220219,全国,全国,0,0,0
51,沙糖桔,20220220,全国,全国,0,0,0
52,沙糖桔,20220221,全国,全国,0,0,0
53,沙糖桔,20220222,全国,全国,0,0,0
54,沙糖桔,20220223,全国,全国,0,0,0
55,沙糖桔,20220224,全国,全国,0,0,0
56,沙糖桔,20220225,全国,全国,0,0,0
57,沙糖桔,20220226,全国,全国,0,0,0
58,沙糖桔,20220227,全国,全国,0,0,0
59,沙糖桔,20220228,全国,全国,0,0,0
60,沙糖桔,20220301,全国,全国,0,0,0
61,沙糖桔,20220302,全国,全国,0,0,0
62,沙糖桔,20220303,全国,全国,0,0,0
63,沙糖桔,20220304,全国,全国,0,0,0
64,沙糖桔,20220305,全国,全国,0,0,0
65,沙糖桔,20220306,全国,全国,0,0,0
66,沙糖桔,20220307,全国,全国,0,0,0
67,沙糖桔,20220308,全国,全国,0,0,0
68,沙糖桔,20220309,全国,全国,0,0,0
69,沙糖桔,20220310,全国,全国,0,0,0
70,沙糖桔,20220311,全国,全国,0,0,0
71,沙糖桔,20220312,全国,全国,0,0,0
72,沙糖桔,20220313,全国,全国,0,0,0
73,沙糖桔,20220314,全国,全国,0,0,0
74,沙糖桔,20220315,全国,全国,0,0,0
75,沙糖桔,20220316,全国,全国,0,0,0
76,沙糖桔,20220317,全国,全国,0,0,0
77,沙糖桔,20220318,全国,全国,0,0,0
78,沙糖桔,20220319,全国,全国,0,0,0
79,沙糖桔,20220320,全国,全国,0,0,0
80,沙糖桔,20220321,全国,全国,0,0,0
81,沙糖桔,20220322,全国,全国,0,0,0
82,沙糖桔,20220323,全国,全国,0,0,0
83,沙糖桔,20220324,全国,全国,0,0,0
84,沙糖桔,20220325,全国,全国,0,0,0
85,沙糖桔,20220326,全国,全国,0,0,0
86,沙糖桔,20220327,全国,全国,0,0,0
87,沙糖桔,20220328,全国,全国,0,0,0
88,沙糖桔,20220329,全国,全国,0,0,0
89,沙糖桔,20220330,全国,全国,0,0,0
90,沙糖桔,20220331,全国,全国,0,0,0
91,沙糖桔,20220401,全国,全国,0,0,0
92,沙糖桔,20220402,全国,全国,0,0,0
93,沙糖桔,20220403,全国,全国,0,0,0
94,沙糖桔,20220404,全国,全国,0,0,0
95,沙糖桔,20220405,全国,全国,0,0,0
96,沙糖桔,20220406,全国,全国,0,0,0
97,沙糖桔,20220407,全国,全国,0,0,0
98,沙糖桔,20220408,全国,全国,0,0,0
99,沙糖桔,20220409,全国,全国,0,0,0
100,沙糖桔,20220410,全国,全国,0,0,0
101,沙糖桔,20220411,全国,全国,0,0,0
102,沙糖桔,20220412,全国,全国,0,0,0
103,沙糖桔,20220413,全国,全国,0,0,0
104,沙糖桔,20220414,全国,全国,0,0,0
105,沙糖桔,20220415,全国,全国,0,0,0
106,沙糖桔,20220416,全国,全国,0,0,0
107,沙糖桔,20220417,全国,全国,0,0,0
108,沙糖桔,20220418,全国,全国,0,0,0
109,沙糖桔,20220419,全国,全国,0,0,0
110,沙糖桔,20220420,全国,全国,0,0,0
111,沙糖桔,20220421,全国,全国,0,0,0
112,沙糖桔,20220422,全国,全国,0,0,0
113,沙糖桔,20220423,全国,全国,0,0,0
114,沙糖桔,20220424,全国,全国,0,0,0
115,沙糖桔,20220425,全国,全国,0,0,0
116,沙糖桔,20220426,全国,全国,0,0,0
117,沙糖桔,20220427,全国,全国,0,0,0
118,沙糖桔,20220428,全国,全国,0,0,0
119,沙糖桔,20220429,全国,全国,0,0,0
120,沙糖桔,20220430,全国,全国,0,0,0
121,沙糖桔,20220501,全国,全国,0,0,0
122,沙糖桔,20220502,全国,全国,0,0,0
123,沙糖桔,20220503,全国,全国,0,0,0
124,沙糖桔,20220504,全国,全国,0,0,0
125,沙糖桔,20220505,全国,全国,0,0,0
126,沙糖桔,20220506,全国,全国,0,0,0
127,沙糖桔,20220507,全国,全国,0,0,0
128,沙糖桔,20220508,全国,全国,0,0,0
129,沙糖桔,20220509,全国,全国,0,0,0
130,沙糖桔,20220510,全国,全国,0,0,0
131,沙糖桔,20220511,全国,全国,0,0,0
132,沙糖桔,20220512,全国,全国,0,0,0
133,沙糖桔,20220513,全国,全国,0,0,0
134,沙糖桔,20220514,全国,全国,0,0,0
135,沙糖桔,20220515,全国,全国,0,0,0
136,沙糖桔,20220516,全国,全国,0,0,0
137,沙糖桔,20220517,全国,全国,0,0,0
138,沙糖桔,20220518,全国,全国,0,0,0
139,沙糖桔,20220519,全国,全国,0,0,0
140,沙糖桔,20220520,全国,全国,0,0,0
141,沙糖桔,20220521,全国,全国,0,0,0
142,沙糖桔,20220522,全国,全国,0,0,0
143,沙糖桔,20220523,全国,全国,0,0,0
144,沙糖桔,20220524,全国,全国,0,0,0
145,沙糖桔,20220525,全国,全国,0,0,0
146,沙糖桔,20220526,全国,全国,0,0,0
147,沙糖桔,20220527,全国,全国,0,0,0
148,沙糖桔,20220528,全国,全国,0,0,0
149,沙糖桔,20220529,全国,全国,0,0,0
150,沙糖桔,20220530,全国,全国,0,0,0
151,沙糖桔,20220531,全国,全国,0,0,0
152,沙糖桔,20220601,全国,全国,0,0,0
153,沙糖桔,20220602,全国,全国,0,0,0
154,沙糖桔,20220603,全国,全国,0,0,0
155,沙糖桔,20220604,全国,全国,0,0,0
156,沙糖桔,20220605,全国,全国,0,0,0
157,沙糖桔,20220606,全国,全国,0,0,0
158,沙糖桔,20220607,全国,全国,0,0,0
159,沙糖桔,20220608,全国,全国,0,0,0
160,沙糖桔,20220609,全国,全国,0,0,0
161,沙糖桔,20220610,全国,全国,0,0,0
162,沙糖桔,20220611,全国,全国,0,0,0
163,沙糖桔,20220612,全国,全国,0,0,0
164,沙糖桔,20220613,全国,全国,0,0,0
165,沙糖桔,20220614,全国,全国,0,0,0
166,沙糖桔,20220615,全国,全国,0,0,0
167,沙糖桔,20220616,全国,全国,0,0,0
168,沙糖桔,20220617,全国,全国,0,0,0
169,沙糖桔,20220618,全国,全国,0,0,0
170,沙糖桔,20220619,全国,全国,0,0,0
171,沙糖桔,20220620,全国,全国,0,0,0
172,沙糖桔,20220621,全国,全国,0,0,0
173,沙糖桔,20220622,全国,全国,0,0,0
174,沙糖桔,20220623,全国,全国,0,0,0
175,沙糖桔,20220624,全国,全国,0,0,0
176,沙糖桔,20220625,全国,全国,0,0,0
177,沙糖桔,20220626,全国,全国,0,0,0
178,沙糖桔,20220627,全国,全国,0,0,0
179,沙糖桔,20220628,全国,全国,0,0,0
180,沙糖桔,20220629,全国,全国,0,0,0
181,沙糖桔,20220630,全国,全国,0,0,0
182,沙糖桔,20220701,全国,全国,0,0,0
183,沙糖桔,20220702,全国,全国,0,0,0
184,沙糖桔,20220703,全国,全国,0,0,0
185,沙糖桔,20220704,全国,全国,0,0,0
186,沙糖桔,20220705,全国,全国,0,0,0
187,沙糖桔,20220706,全国,全国,0,0,0
188,沙糖桔,20220707,全国,全国,0,0,0
189,沙糖桔,20220708,全国,全国,0,0,0
190,沙糖桔,20220709,全国,全国,0,0,0
191,沙糖桔,20220710,全国,全国,0,0,0
192,沙糖桔,20220711,全国,全国,0,0,0
193,沙糖桔,20220712,全国,全国,0,0,0
194,沙糖桔,20220713,全国,全国,0,0,0
195,沙糖桔,20220714,全国,全国,0,0,0
196,沙糖桔,20220715,全国,全国,0,0,0
197,沙糖桔,20220716,全国,全国,0,0,0
198,沙糖桔,20220717,全国,全国,0,0,0
199,沙糖桔,20220718,全国,全国,0,0,0
200,沙糖桔,20220719,全国,全国,0,0,0
201,沙糖桔,20220720,全国,全国,0,0,0
202,沙糖桔,20220721,全国,全国,0,0,0
203,沙糖桔,20220722,全国,全国,0,0,0
204,沙糖桔,20220723,全国,全国,0,0,0
205,沙糖桔,20220724,全国,全国,0,0,0
206,沙糖桔,20220725,全国,全国,0,0,0
207,沙糖桔,20220726,全国,全国,0,0,0
208,沙糖桔,20220727,全国,全国,0,0,0
209,沙糖桔,20220728,全国,全国,0,0,0
210,沙糖桔,20220729,全国,全国,0,0,0
211,沙糖桔,20220730,全国,全国,0,0,0
212,沙糖桔,20220731,全国,全国,0,0,0
213,沙糖桔,20220801,全国,全国,0,0,0
214,沙糖桔,20220802,全国,全国,0,0,0
215,沙糖桔,20220803,全国,全国,0,0,0
216,沙糖桔,20220804,全国,全国,0,0,0
217,沙糖桔,20220805,全国,全国,0,0,0
218,沙糖桔,20220806,全国,全国,0,0,0
219,沙糖桔,20220807,全国,全国,0,0,0
220,沙糖桔,20220808,全国,全国,0,0,0
221,沙糖桔,20220809,全国,全国,0,0,0
222,沙糖桔,20220810,全国,全国,0,0,0
223,沙糖桔,20220811,全国,全国,0,0,0
224,沙糖桔,20220812,全国,全国,0,0,0
225,沙糖桔,20220813,全国,全国,0,0,0
226,沙糖桔,20220814,全国,全国,0,0,0
227,沙糖桔,20220815,全国,全国,0,0,0
228,沙糖桔,20220816,全国,全国,0,0,0
229,沙糖桔,20220817,全国,全国,0,0,0
230,沙糖桔,20220818,全国,全国,0,0,0
231,沙糖桔,20220819,全国,全国,0,0,0
232,沙糖桔,20220820,全国,全国,0,0,0
233,沙糖桔,20220821,全国,全国,0,0,0
234,沙糖桔,20220822,全国,全国,0,0,0
235,沙糖桔,20220823,全国,全国,0,0,0
236,沙糖桔,20220824,全国,全国,0,0,0
237,沙糖桔,20220825,全国,全国,0,0,0
238,沙糖桔,20220826,全国,全国,0,0,0
239,沙糖桔,20220827,全国,全国,0,0,0
240,沙糖桔,20220828,全国,全国,0,0,0
241,沙糖桔,20220829,全国,全国,0,0,0
242,沙糖桔,20220830,全国,全国,0,0,0
243,沙糖桔,20220831,全国,全国,0,0,0
244,沙糖桔,20220901,全国,全国,0,0,0
245,沙糖桔,20220902,全国,全国,0,0,0
246,沙糖桔,20220903,全国,全国,0,0,0
247,沙糖桔,20220904,全国,全国,0,0,0
248,沙糖桔,20220905,全国,全国,0,0,0
249,沙糖桔,20220906,全国,全国,0,0,0
250,沙糖桔,20220907,全国,全国,0,0,0
251,沙糖桔,20220908,全国,全国,0,0,0
252,沙糖桔,20220909,全国,全国,0,0,0
253,沙糖桔,20220910,全国,全国,0,0,0
254,沙糖桔,20220911,全国,全国,0,0,0
255,沙糖桔,20220912,全国,全国,0,0,0
256,沙糖桔,20220913,全国,全国,0,0,0
257,沙糖桔,20220914,全国,全国,0,0,0
258,沙糖桔,20220915,全国,全国,0,0,0
259,沙糖桔,20220916,全国,全国,0,0,0
260,沙糖桔,20220917,全国,全国,0,0,0
261,沙糖桔,20220918,全国,全国,0,0,0
262,沙糖桔,20220919,全国,全国,0,0,0
263,沙糖桔,20220920,全国,全国,0,0,0
264,沙糖桔,20220921,全国,全国,0,0,0
265,沙糖桔,20220922,全国,全国,0,0,0
266,沙糖桔,20220923,全国,全国,0,0,0
267,沙糖桔,20220924,全国,全国,0,0,0
268,沙糖桔,20220925,全国,全国,0,0,0
269,沙糖桔,20220926,全国,全国,0,0,0
270,沙糖桔,20220927,全国,全国,0,0,0
271,沙糖桔,20220928,全国,全国,0,0,0
272,沙糖桔,20220929,全国,全国,0,0,0
273,沙糖桔,20220930,全国,全国,0,0,0
274,沙糖桔,20221001,全国,全国,0,0,0
275,沙糖桔,20221002,全国,全国,0,0,0
276,沙糖桔,20221003,全国,全国,0,0,0
277,沙糖桔,20221004,全国,全国,0,0,0
278,沙糖桔,20221005,全国,全国,0,0,0
279,沙糖桔,20221006,全国,全国,0,0,0
280,沙糖桔,20221007,全国,全国,0,0,0
281,沙糖桔,20221008,全国,全国,0,0,0
282,沙糖桔,20221009,全国,全国,0,0,0
283,沙糖桔,20221010,全国,全国,0,0,0
284,沙糖桔,20221011,全国,全国,0,0,0
285,沙糖桔,20221012,全国,全国,0,0,0
286,沙糖桔,20221013,全国,全国,0,0,0
287,沙糖桔,20221014,全国,全国,0,0,0
288,沙糖桔,20221015,全国,全国,0,0,0
289,沙糖桔,20221016,全国,全国,0,0,0
290,沙糖桔,20221017,全国,全国,0,0,0
291,沙糖桔,20221018,全国,全国,0,0,0
292,沙糖桔,20221019,全国,全国,0,0,0
293,沙糖桔,20221020,全国,全国,0,0,0
294,沙糖桔,20221021,全国,全国,0,0,0
295,沙糖桔,20221022,全国,全国,0,0,0
296,沙糖桔,20221023,全国,全国,0,0,0
297,沙糖桔,20221024,全国,全国,0,0,0
298,沙糖桔,20221025,全国,全国,0,0,0
299,沙糖桔,20221026,全国,全国,0,0,0
300,沙糖桔,20221027,全国,全国,0,0,0
301,沙糖桔,20221028,全国,全国,0,0,0
302,沙糖桔,20221029,全国,全国,0,0,0
303,沙糖桔,20221030,全国,全国,0,0,0
304,沙糖桔,20221031,全国,全国,0,0,0
305,沙糖桔,20221101,全国,全国,0,0,0
306,沙糖桔,20221102,全国,全国,0,0,0
307,沙糖桔,20221103,全国,全国,0,0,0
308,沙糖桔,20221104,全国,全国,0,0,0
309,沙糖桔,20221105,全国,全国,0,0,0
310,沙糖桔,20221106,全国,全国,0,0,0
311,沙糖桔,20221107,全国,全国,0,0,0
312,沙糖桔,20221108,全国,全国,0,0,0
313,沙糖桔,20221109,全国,全国,0,0,0
314,沙糖桔,20221110,全国,全国,0,0,0
315,沙糖桔,20221111,全国,全国,0,0,0
316,沙糖桔,20221112,全国,全国,0,0,0
317,沙糖桔,20221113,全国,全国,0,0,0
318,沙糖桔,20221114,全国,全国,0,0,0
319,沙糖桔,20221115,全国,全国,0,0,0
320,沙糖桔,20221116,全国,全国,0,0,0
321,沙糖桔,20221117,全国,全国,0,0,0
322,沙糖桔,20221118,全国,全国,0,0,0
323,沙糖桔,20221119,全国,全国,0,0,0
324,沙糖桔,20221120,全国,全国,0,0,0
325,沙糖桔,20221121,全国,全国,0,0,0
326,沙糖桔,20221122,全国,全国,0,0,0
327,沙糖桔,20221123,全国,全国,0,0,0
328,沙糖桔,20221124,全国,全国,0,0,0
329,沙糖桔,20221125,全国,全国,0,0,0
330,沙糖桔,20221126,全国,全国,0,0,0
331,沙糖桔,20221127,全国,全国,0,0,0
332,沙糖桔,20221128,全国,全国,0,0,0
333,沙糖桔,20221129,全国,全国,0,0,0
334,沙糖桔,20221130,全国,全国,0,0,0
335,沙糖桔,20221201,全国,全国,0,0,0
336,沙糖桔,20221202,全国,全国,0,0,0
337,沙糖桔,20221203,全国,全国,0,0,0
338,沙糖桔,20221204,全国,全国,0,0,0
339,沙糖桔,20221205,全国,全国,0,0,0
340,沙糖桔,20221206,全国,全国,0,0,0
341,沙糖桔,20221207,全国,全国,0,0,0
342,沙糖桔,20221208,全国,全国,0,0,0
343,沙糖桔,20221209,全国,全国,0,0,0
344,沙糖桔,20221210,全国,全国,0,0,0
345,沙糖桔,20221211,全国,全国,0,0,0
346,沙糖桔,20221212,全国,全国,0,0,0
347,沙糖桔,20221213,全国,全国,0,0,0
348,沙糖桔,20221214,全国,全国,0,0,0
349,沙糖桔,20221215,全国,全国,0,0,0
350,沙糖桔,20221216,全国,全国,0,0,0
351,沙糖桔,20221217,全国,全国,0,0,0
352,沙糖桔,20221218,全国,全国,0,0,0
353,沙糖桔,20221219,全国,全国,0,0,0
354,沙糖桔,20221220,全国,全国,0,0,0
355,沙糖桔,20221221,全国,全国,0,0,0
356,沙糖桔,20221222,全国,全国,0,0,0
357,沙糖桔,20221223,全国,全国,0,0,0
358,沙糖桔,20221224,全国,全国,0,0,0
359,沙糖桔,20221225,全国,全国,0,0,0
360,沙糖桔,20221226,全国,全国,0,0,0
361,沙糖桔,20221227,全国,全国,0,0,0
362,沙糖桔,20221228,全国,全国,0,0,0
363,沙糖桔,20221229,全国,全国,0,0,0
364,沙糖桔,20221230,全国,全国,0,0,0
365,沙糖桔,20221231,全国,全国,0,0,0
366,沙糖桔,20230101,全国,全国,0,0,0
367,沙糖桔,20230102,全国,全国,0,0,0
368,沙糖桔,20230103,全国,全国,0,0,0
369,沙糖桔,20230104,全国,全国,0,0,0
370,沙糖桔,20230105,全国,全国,0,0,0
371,沙糖桔,20230106,全国,全国,0,0,0
372,沙糖桔,20230107,全国,全国,0,0,0
373,沙糖桔,20230108,全国,全国,0,0,0
374,沙糖桔,20230109,全国,全国,0,0,0
375,沙糖桔,20230110,全国,全国,0,0,0
376,沙糖桔,20230111,全国,全国,0,0,0
377,沙糖桔,20230112,全国,全国,0,0,0
378,沙糖桔,20230113,全国,全国,0,0,0
379,沙糖桔,20230114,全国,全国,0,0,0
380,沙糖桔,20230115,全国,全国,0,0,0
381,沙糖桔,20230116,全国,全国,0,0,0
382,沙糖桔,20230117,全国,全国,0,0,0
383,沙糖桔,20230118,全国,全国,0,0,0
384,沙糖桔,20230119,全国,全国,0,0,0
385,沙糖桔,20230120,全国,全国,0,0,0
386,沙糖桔,20230121,全国,全国,0,0,0
387,沙糖桔,20230122,全国,全国,0,0,0
388,沙糖桔,20230123,全国,全国,0,0,0
389,沙糖桔,20230124,全国,全国,0,0,0
390,沙糖桔,20230125,全国,全国,0,0,0
391,沙糖桔,20230126,全国,全国,0,0,0
392,沙糖桔,20230127,全国,全国,0,0,0
393,沙糖桔,20230128,全国,全国,0,0,0
394,沙糖桔,20230129,全国,全国,0,0,0
395,沙糖桔,20230130,全国,全国,0,0,0
396,沙糖桔,20230131,全国,全国,0,0,0
397,沙糖桔,20230201,全国,全国,0,0,0
398,沙糖桔,20230202,全国,全国,0,0,0
399,沙糖桔,20230203,全国,全国,0,0,0
400,沙糖桔,20230204,全国,全国,0,0,0
401,沙糖桔,20230205,全国,全国,0,0,0
402,沙糖桔,20230206,全国,全国,0,0,0
403,沙糖桔,20230207,全国,全国,0,0,0
404,沙糖桔,20230208,全国,全国,0,0,0
405,沙糖桔,20230209,全国,全国,0,0,0
406,沙糖桔,20230210,全国,全国,0,0,0
407,沙糖桔,20230211,全国,全国,0,0,0
408,沙糖桔,20230212,全国,全国,0,0,0
409,沙糖桔,20230213,全国,全国,0,0,0
410,沙糖桔,20230214,全国,全国,0,0,0
411,沙糖桔,20230215,全国,全国,0,0,0
412,沙糖桔,20230216,全国,全国,0,0,0
413,沙糖桔,20230217,全国,全国,0,0,0
414,沙糖桔,20230218,全国,全国,0,0,0
415,沙糖桔,20230219,全国,全国,0,0,0
416,沙糖桔,20230220,全国,全国,0,0,0
417,沙糖桔,20230221,全国,全国,0,0,0
418,沙糖桔,20230222,全国,全国,0,0,0
419,沙糖桔,20230223,全国,全国,0,0,0
420,沙糖桔,20230224,全国,全国,0,0,0
421,沙糖桔,20230225,全国,全国,0,0,0
422,沙糖桔,20230226,全国,全国,0,0,0
423,沙糖桔,20230227,全国,全国,0,0,0
424,沙糖桔,20230228,全国,全国,0,0,0
425,沙糖桔,20230301,全国,全国,0,0,0
426,沙糖桔,20230302,全国,全国,0,0,0
427,沙糖桔,20230303,全国,全国,0,0,0
428,沙糖桔,20230304,全国,全国,0,0,0
429,沙糖桔,20230305,全国,全国,0,0,0
430,沙糖桔,20230306,全国,全国,0,0,0
431,沙糖桔,20230307,全国,全国,0,0,0
432,沙糖桔,20230308,全国,全国,0,0,0
433,沙糖桔,20230309,全国,全国,0,0,0
434,沙糖桔,20230310,全国,全国,0,0,0
435,沙糖桔,20230311,全国,全国,0,0,0
436,沙糖桔,20230312,全国,全国,0,0,0
437,沙糖桔,20230313,全国,全国,0,0,0
438,沙糖桔,20230314,全国,全国,0,0,0
439,沙糖桔,20230315,全国,全国,0,0,0
440,沙糖桔,20230316,全国,全国,0,0,0
441,沙糖桔,20230317,全国,全国,0,0,0
442,沙糖桔,20230318,全国,全国,0,0,0
443,沙糖桔,20230319,全国,全国,0,0,0
444,沙糖桔,20230320,全国,全国,0,0,0
445,沙糖桔,20230321,全国,全国,0,0,0
446,沙糖桔,20230322,全国,全国,0,0,0
447,沙糖桔,20230323,全国,全国,0,0,0
448,沙糖桔,20230324,全国,全国,0,0,0
449,沙糖桔,20230325,全国,全国,0,0,0
450,沙糖桔,20230326,全国,全国,0,0,0
451,沙糖桔,20230327,全国,全国,0,0,0
452,沙糖桔,20230328,全国,全国,0,0,0
453,沙糖桔,20230329,全国,全国,0,0,0
454,沙糖桔,20230330,全国,全国,0,0,0
455,沙糖桔,20230331,全国,全国,0,0,0
456,沙糖桔,20230401,全国,全国,0,0,0
457,沙糖桔,20230402,全国,全国,0,0,0
458,沙糖桔,20230403,全国,全国,0,0,0
459,沙糖桔,20230404,全国,全国,0,0,0
460,沙糖桔,20230405,全国,全国,0,0,0
461,沙糖桔,20230406,全国,全国,0,0,0
462,沙糖桔,20230407,全国,全国,0,0,0
463,沙糖桔,20230408,全国,全国,0,0,0
464,沙糖桔,20230409,全国,全国,0,0,0
465,沙糖桔,20230410,全国,全国,0,0,0
466,沙糖桔,20230411,全国,全国,0,0,0
467,沙糖桔,20230412,全国,全国,0,0,0
468,沙糖桔,20230413,全国,全国,0,0,0
469,沙糖桔,20230414,全国,全国,0,0,0
470,沙糖桔,20230415,全国,全国,0,0,0
471,沙糖桔,20230416,全国,全国,0,0,0
472,沙糖桔,20230417,全国,全国,0,0,0
473,沙糖桔,20230418,全国,全国,0,0,0
474,沙糖桔,20230419,全国,全国,0,0,0
475,沙糖桔,20230420,全国,全国,0,0,0
476,沙糖桔,20230421,全国,全国,0,0,0
477,沙糖桔,20230422,全国,全国,0,0,0
478,沙糖桔,20230423,全国,全国,0,0,0
479,沙糖桔,20230424,全国,全国,0,0,0
480,沙糖桔,20230425,全国,全国,0,0,0
481,沙糖桔,20230426,全国,全国,0,0,0
482,沙糖桔,20230427,全国,全国,0,0,0
483,沙糖桔,20230428,全国,全国,0,0,0
484,沙糖桔,20230429,全国,全国,0,0,0
485,沙糖桔,20230430,全国,全国,0,0,0
486,沙糖桔,20230501,全国,全国,0,0,0
487,沙糖桔,20230502,全国,全国,0,0,0
488,沙糖桔,20230503,全国,全国,0,0,0
489,沙糖桔,20230504,全国,全国,0,0,0
490,沙糖桔,20230505,全国,全国,0,0,0
491,沙糖桔,20230506,全国,全国,0,0,0
492,沙糖桔,20230507,全国,全国,0,0,0
493,沙糖桔,20230508,全国,全国,0,0,0
494,沙糖桔,20230509,全国,全国,0,0,0
495,沙糖桔,20230510,全国,全国,0,0,0
496,沙糖桔,20230511,全国,全国,0,0,0
497,沙糖桔,20230512,全国,全国,0,0,0
498,沙糖桔,20230513,全国,全国,0,0,0
499,沙糖桔,20230514,全国,全国,0,0,0
500,沙糖桔,20230515,全国,全国,0,0,0
501,沙糖桔,20230516,全国,全国,0,0,0
502,沙糖桔,20230517,全国,全国,0,0,0
503,沙糖桔,20230518,全国,全国,0,0,0
504,沙糖桔,20230519,全国,全国,0,0,0
505,沙糖桔,20230520,全国,全国,0,0,0
506,沙糖桔,20230521,全国,全国,0,0,0
507,沙糖桔,20230522,全国,全国,0,0,0
508,沙糖桔,20230523,全国,全国,0,0,0
509,沙糖桔,20230524,全国,全国,0,0,0
510,沙糖桔,20230525,全国,全国,0,0,0
511,沙糖桔,20230526,全国,全国,0,0,0
512,沙糖桔,20230527,全国,全国,0,0,0
513,沙糖桔,20230528,全国,全国,0,0,0
514,沙糖桔,20230529,全国,全国,0,0,0
515,沙糖桔,20230530,全国,全国,0,0,0
516,沙糖桔,20230531,全国,全国,0,0,0
517,沙糖桔,20230601,全国,全国,0,0,0
518,沙糖桔,20230602,全国,全国,0,0,0
519,沙糖桔,20230603,全国,全国,0,0,0
520,沙糖桔,20230604,全国,全国,0,0,0
521,沙糖桔,20230605,全国,全国,0,0,0
522,沙糖桔,20230606,全国,全国,0,0,0
523,沙糖桔,20230607,全国,全国,0,0,0
524,沙糖桔,20230608,全国,全国,0,0,0
525,沙糖桔,20230609,全国,全国,0,0,0
526,沙糖桔,20230610,全国,全国,0,0,0
527,沙糖桔,20230611,全国,全国,0,0,0
528,沙糖桔,20230612,全国,全国,0,0,0
529,沙糖桔,20230613,全国,全国,0,0,0
530,沙糖桔,20230614,全国,全国,0,0,0
531,沙糖桔,20230615,全国,全国,0,0,0
532,沙糖桔,20230616,全国,全国,0,0,0
533,沙糖桔,20230617,全国,全国,0,0,0
534,沙糖桔,20230618,全国,全国,0,0,0
535,沙糖桔,20230619,全国,全国,0,0,0
536,沙糖桔,20230620,全国,全国,0,0,0
537,沙糖桔,20230621,全国,全国,0,0,0
538,沙糖桔,20230622,全国,全国,0,0,0
539,沙糖桔,20230623,全国,全国,0,0,0
540,沙糖桔,20230624,全国,全国,0,0,0
541,沙糖桔,20230625,全国,全国,0,0,0
542,沙糖桔,20230626,全国,全国,0,0,0
543,沙糖桔,20230627,全国,全国,0,0,0
544,沙糖桔,20230628,全国,全国,0,0,0
545,沙糖桔,20230629,全国,全国,0,0,0
546,沙糖桔,20230630,全国,全国,0,0,0
547,沙糖桔,20230701,全国,全国,0,0,0
548,沙糖桔,20230702,全国,全国,0,0,0
549,沙糖桔,20230703,全国,全国,0,0,0
550,沙糖桔,20230704,全国,全国,0,0,0
551,沙糖桔,20230705,全国,全国,0,0,0
552,沙糖桔,20230706,全国,全国,0,0,0
553,沙糖桔,20230707,全国,全国,0,0,0
554,沙糖桔,20230708,全国,全国,0,0,0
555,沙糖桔,20230709,全国,全国,0,0,0
556,沙糖桔,20230710,全国,全国,0,0,0
557,沙糖桔,20230711,全国,全国,0,0,0
558,沙糖桔,20230712,全国,全国,0,0,0
559,沙糖桔,20230713,全国,全国,0,0,0
560,沙糖桔,20230714,全国,全国,0,0,0
561,沙糖桔,20230715,全国,全国,0,0,0
562,沙糖桔,20230716,全国,全国,0,0,0
563,沙糖桔,20230717,全国,全国,0,0,0
564,沙糖桔,20230718,全国,全国,0,0,0
565,沙糖桔,20230719,全国,全国,0,0,0
566,沙糖桔,20230720,全国,全国,0,0,0
567,沙糖桔,20230721,全国,全国,0,0,0
568,沙糖桔,20230722,全国,全国,0,0,0
569,沙糖桔,20230723,全国,全国,0,0,0
570,沙糖桔,20230724,全国,全国,0,0,0
571,沙糖桔,20230725,全国,全国,0,0,0
572,沙糖桔,20230726,全国,全国,0,0,0
573,沙糖桔,20230727,全国,全国,0,0,0
574,沙糖桔,20230728,全国,全国,0,0,0
575,沙糖桔,20230729,全国,全国,0,0,0
576,沙糖桔,20230730,全国,全国,0,0,0
577,沙糖桔,20230731,全国,全国,0,0,0
578,沙糖桔,20230801,全国,全国,0,0,0
579,沙糖桔,20230802,全国,全国,0,0,0
580,沙糖桔,20230803,全国,全国,0,0,0
581,沙糖桔,20230804,全国,全国,0,0,0
582,沙糖桔,20230805,全国,全国,0,0,0
583,沙糖桔,20230806,全国,全国,0,0,0
584,沙糖桔,20230807,全国,全国,0,0,0
585,沙糖桔,20230808,全国,全国,0,0,0
586,沙糖桔,20230809,全国,全国,0,0,0
587,沙糖桔,20230810,全国,全国,0,0,0
588,沙糖桔,20230811,全国,全国,0,0,0
589,沙糖桔,20230812,全国,全国,0,0,0
590,沙糖桔,20230813,全国,全国,0,0,0
591,沙糖桔,20230814,全国,全国,0,0,0
592,沙糖桔,20230815,全国,全国,0,0,0
593,沙糖桔,20230816,全国,全国,0,0,0
594,沙糖桔,20230817,全国,全国,0,0,0
595,沙糖桔,20230818,全国,全国,0,0,0
596,沙糖桔,20230819,全国,全国,0,0,0
597,沙糖桔,20230820,全国,全国,0,0,0
598,沙糖桔,20230821,全国,全国,0,0,0
599,沙糖桔,20230822,全国,全国,0,0,0
600,沙糖桔,20230823,全国,全国,0,0,0
601,沙糖桔,20230824,全国,全国,0,0,0
602,沙糖桔,20230825,全国,全国,0,0,0
603,沙糖桔,20230826,全国,全国,0,0,0
604,沙糖桔,20230827,全国,全国,0,0,0
605,沙糖桔,20230828,全国,全国,0,0,0
606,沙糖桔,20230829,全国,全国,0,0,0
607,沙糖桔,20230830,全国,全国,0,0,0
608,沙糖桔,20230831,全国,全国,0,0,0
609,沙糖桔,20230901,全国,全国,0,0,0
610,沙糖桔,20230902,全国,全国,0,0,0
611,沙糖桔,20230903,全国,全国,0,0,0
612,沙糖桔,20230904,全国,全国,0,0,0
613,沙糖桔,20230905,全国,全国,0,0,0
614,沙糖桔,20230906,全国,全国,0,0,0
615,沙糖桔,20230907,全国,全国,0,0,0
616,沙糖桔,20230908,全国,全国,0,0,0
617,沙糖桔,20230909,全国,全国,0,0,0
618,沙糖桔,20230910,全国,全国,0,0,0
619,沙糖桔,20230911,全国,全国,0,0,0
620,沙糖桔,20230912,全国,全国,0,0,0
621,沙糖桔,20230913,全国,全国,0,0,0
622,沙糖桔,20230914,全国,全国,0,0,0
623,沙糖桔,20230915,全国,全国,0,0,0
624,沙糖桔,20230916,全国,全国,0,0,0
625,沙糖桔,20230917,全国,全国,0,0,0
626,沙糖桔,20230918,全国,全国,0,0,0
627,沙糖桔,20230919,全国,全国,0,0,0
628,沙糖桔,20230920,全国,全国,0,0,0
629,沙糖桔,20230921,全国,全国,0,0,0
630,沙糖桔,20230922,全国,全国,0,0,0
631,沙糖桔,20230923,全国,全国,0,0,0
632,沙糖桔,20230924,全国,全国,0,0,0
633,沙糖桔,20230925,全国,全国,0,0,0
634,沙糖桔,20230926,全国,全国,0,0,0
635,沙糖桔,20230927,全国,全国,0,0,0
636,沙糖桔,20230928,全国,全国,0,0,0
637,沙糖桔,20230929,全国,全国,0,0,0
638,沙糖桔,20230930,全国,全国,0,0,0
639,沙糖桔,20231001,全国,全国,269,61,208
640,沙糖桔,20231002,全国,全国,275,63,212
641,沙糖桔,20231003,全国,全国,256,61,195
642,沙糖桔,20231004,全国,全国,281,66,215
643,沙糖桔,20231005,全国,全国,280,68,212
644,沙糖桔,20231006,全国,全国,314,66,248
645,沙糖桔,20231007,全国,全国,287,78,209
646,沙糖桔,20231008,全国,全国,316,89,227
647,沙糖桔,20231009,全国,全国,308,70,238
648,沙糖桔,20231010,全国,全国,325,70,255
649,沙糖桔,20231011,全国,全国,344,80,264
650,沙糖桔,20231012,全国,全国,335,87,248
651,沙糖桔,20231013,全国,全国,316,82,234
652,沙糖桔,20231014,全国,全国,336,63,273
653,沙糖桔,20231015,全国,全国,383,76,307
654,沙糖桔,20231016,全国,全国,388,85,303
655,沙糖桔,20231017,全国,全国,372,87,285
656,沙糖桔,20231018,全国,全国,378,91,287
657,沙糖桔,20231019,全国,全国,355,93,262
658,沙糖桔,20231020,全国,全国,331,93,238
659,沙糖桔,20231021,全国,全国,427,83,344
660,沙糖桔,20231022,全国,全国,407,74,333
661,沙糖桔,20231023,全国,全国,402,87,315
662,沙糖桔,20231024,全国,全国,370,76,294
663,沙糖桔,20231025,全国,全国,387,102,285
664,沙糖桔,20231026,全国,全国,353,87,266
665,沙糖桔,20231027,全国,全国,402,89,313
666,沙糖桔,20231028,全国,全国,449,82,367
667,沙糖桔,20231029,全国,全国,443,74,369
668,沙糖桔,20231030,全国,全国,404,95,309
669,沙糖桔,20231031,全国,全国,447,95,352
670,沙糖桔,20231101,全国,全国,519,114,405
671,沙糖桔,20231102,全国,全国,448,106,342
672,沙糖桔,20231103,全国,全国,498,97,401
673,沙糖桔,20231104,全国,全国,498,82,416
674,沙糖桔,20231105,全国,全国,468,95,373
675,沙糖桔,20231106,全国,全国,548,108,440
676,沙糖桔,20231107,全国,全国,513,97,416
677,沙糖桔,20231108,全国,全国,591,99,492
678,沙糖桔,20231109,全国,全国,584,116,468
679,沙糖桔,20231110,全国,全国,509,116,393
680,沙糖桔,20231111,全国,全国,523,87,436
681,沙糖桔,20231112,全国,全国,649,78,571
682,沙糖桔,20231113,全国,全国,549,112,437
683,沙糖桔,20231114,全国,全国,657,85,572
684,沙糖桔,20231115,全国,全国,652,133,519
685,沙糖桔,20231116,全国,全国,638,121,517
686,沙糖桔,20231117,全国,全国,735,104,631
687,沙糖桔,20231118,全国,全国,745,114,631
688,沙糖桔,20231119,全国,全国,882,82,800
689,沙糖桔,20231120,全国,全国,943,140,803
690,沙糖桔,20231121,全国,全国,822,116,706
691,沙糖桔,20231122,全国,全国,823,120,703
692,沙糖桔,20231123,全国,全国,783,116,667
693,沙糖桔,20231124,全国,全国,797,133,664
694,沙糖桔,20231125,全国,全国,878,89,789
695,沙糖桔,20231126,全国,全国,996,139,857
696,沙糖桔,20231127,全国,全国,920,140,780
697,沙糖桔,20231128,全国,全国,819,162,657
698,沙糖桔,20231129,全国,全国,912,139,773
699,沙糖桔,20231130,全国,全国,840,137,703
700,沙糖桔,20231201,全国,全国,845,148,697
701,沙糖桔,20231202,全国,全国,837,110,727
702,沙糖桔,20231203,全国,全国,935,102,833
703,沙糖桔,20231204,全国,全国,834,144,690
704,沙糖桔,20231205,全国,全国,806,118,688
705,沙糖桔,20231206,全国,全国,912,157,755
706,沙糖桔,20231207,全国,全国,796,140,656
707,沙糖桔,20231208,全国,全国,774,137,637
708,沙糖桔,20231209,全国,全国,815,116,699
709,沙糖桔,20231210,全国,全国,944,102,842
710,沙糖桔,20231211,全国,全国,619,162,457
711,沙糖桔,20231212,全国,全国,524,148,376
712,沙糖桔,20231213,全国,全国,698,142,556
713,沙糖桔,20231214,全国,全国,738,146,592
714,沙糖桔,20231215,全国,全国,720,146,574
715,沙糖桔,20231216,全国,全国,636,93,543
716,沙糖桔,20231217,全国,全国,686,97,589
717,沙糖桔,20231218,全国,全国,734,148,586
718,沙糖桔,20231219,全国,全国,722,159,563
719,沙糖桔,20231220,全国,全国,754,168,586
720,沙糖桔,20231221,全国,全国,750,151,599
721,沙糖桔,20231222,全国,全国,669,116,553
722,沙糖桔,20231223,全国,全国,661,116,545
723,沙糖桔,20231224,全国,全国,790,116,674
724,沙糖桔,20231225,全国,全国,795,137,658
725,沙糖桔,20231226,全国,全国,798,139,659
726,沙糖桔,20231227,全国,全国,850,165,685
727,沙糖桔,20231228,全国,全国,891,125,766
728,沙糖桔,20231229,全国,全国,840,135,705
729,沙糖桔,20231230,全国,全国,821,91,730
730,沙糖桔,20231231,全国,全国,788,83,705
731,沙糖桔,20240101,全国,全国,873,91,782
732,沙糖桔,20240102,全国,全国,841,168,673
733,沙糖桔,20240103,全国,全国,1310,372,938
734,沙糖桔,20240104,全国,全国,1701,461,1240
735,沙糖桔,20240105,全国,全国,2136,512,1624
736,沙糖桔,20240106,全国,全国,2077,264,1813
737,沙糖桔,20240107,全国,全国,1978,211,1767
738,沙糖桔,20240108,全国,全国,1706,330,1376
739,沙糖桔,20240109,全国,全国,1242,279,963
740,沙糖桔,20240110,全国,全国,1190,239,951
741,沙糖桔,20240111,全国,全国,1111,204,907
742,沙糖桔,20240112,全国,全国,1137,205,932
743,沙糖桔,20240113,全国,全国,1082,144,938
744,沙糖桔,20240114,全国,全国,1033,139,894
745,沙糖桔,20240115,全国,全国,1040,176,864
746,沙糖桔,20240116,全国,全国,1039,209,830
747,沙糖桔,20240117,全国,全国,1028,165,863
748,沙糖桔,20240118,全国,全国,1003,162,841
749,沙糖桔,20240119,全国,全国,983,142,841
750,沙糖桔,20240120,全国,全国,952,104,848
751,沙糖桔,20240121,全国,全国,953,110,843
752,沙糖桔,20240122,全国,全国,835,157,678
753,沙糖桔,20240123,全国,全国,888,144,744
754,沙糖桔,20240124,全国,全国,909,125,784
755,沙糖桔,20240125,全国,全国,937,150,787
756,沙糖桔,20240126,全国,全国,946,139,807
757,沙糖桔,20240127,全国,全国,914,93,821
758,沙糖桔,20240128,全国,全国,967,112,855
759,沙糖桔,20240129,全国,全国,1010,163,847
760,沙糖桔,20240130,全国,全国,982,137,845
761,沙糖桔,20240131,全国,全国,944,150,794
762,沙糖桔,20240201,全国,全国,1047,207,840
763,沙糖桔,20240202,全国,全国,996,148,848
764,沙糖桔,20240203,全国,全国,964,108,856
765,沙糖桔,20240204,全国,全国,1009,152,857
766,沙糖桔,20240205,全国,全国,977,108,869
767,沙糖桔,20240206,全国,全国,984,104,880
768,沙糖桔,20240207,全国,全国,1010,118,892
769,沙糖桔,20240208,全国,全国,1032,101,931
770,沙糖桔,20240209,全国,全国,951,66,885
771,沙糖桔,20240210,全国,全国,926,72,854
772,沙糖桔,20240211,全国,全国,930,78,852
773,沙糖桔,20240212,全国,全国,909,64,845
774,沙糖桔,20240213,全国,全国,881,66,815
775,沙糖桔,20240214,全国,全国,869,83,786
776,沙糖桔,20240215,全国,全国,797,78,719
777,沙糖桔,20240216,全国,全国,816,93,723
778,沙糖桔,20240217,全国,全国,804,87,717
779,沙糖桔,20240218,全国,全国,828,125,703
780,沙糖桔,20240219,全国,全国,747,120,627
781,沙糖桔,20240220,全国,全国,650,99,551
782,沙糖桔,20240221,全国,全国,655,123,532
783,沙糖桔,20240222,全国,全国,658,104,554
784,沙糖桔,20240223,全国,全国,627,95,532
785,沙糖桔,20240224,全国,全国,629,80,549
786,沙糖桔,20240225,全国,全国,623,85,538
787,沙糖桔,20240226,全国,全国,547,102,445
788,沙糖桔,20240227,全国,全国,497,97,400
789,沙糖桔,20240228,全国,全国,492,106,386
790,沙糖桔,20240229,全国,全国,441,101,340
791,沙糖桔,20240301,全国,全国,401,87,314
792,沙糖桔,20240302,全国,全国,461,87,374
793,沙糖桔,20240303,全国,全国,432,70,362
794,沙糖桔,20240304,全国,全国,384,85,299
795,沙糖桔,20240305,全国,全国,408,101,307
796,沙糖桔,20240306,全国,全国,367,97,270
797,沙糖桔,20240307,全国,全国,351,74,277
798,沙糖桔,20240308,全国,全国,321,89,232
799,沙糖桔,20240309,全国,全国,305,66,239
800,沙糖桔,20240310,全国,全国,373,78,295
801,沙糖桔,20240311,全国,全国,323,78,245
802,沙糖桔,20240312,全国,全国,340,85,255
803,沙糖桔,20240313,全国,全国,317,83,234
804,沙糖桔,20240314,全国,全国,332,93,239
805,沙糖桔,20240315,全国,全国,303,72,231
806,沙糖桔,20240316,全国,全国,309,68,241
807,沙糖桔,20240317,全国,全国,288,61,227
808,沙糖桔,20240318,全国,全国,259,70,189
809,沙糖桔,20240319,全国,全国,311,93,218
810,沙糖桔,20240320,全国,全国,276,78,198
811,沙糖桔,20240321,全国,全国,287,76,211
812,沙糖桔,20240322,全国,全国,246,72,174
813,沙糖桔,20240323,全国,全国,263,63,200
814,沙糖桔,20240324,全国,全国,279,68,211
815,沙糖桔,20240325,全国,全国,253,76,177
816,沙糖桔,20240326,全国,全国,255,76,179
817,沙糖桔,20240327,全国,全国,248,80,168
818,沙糖桔,20240328,全国,全国,251,70,181
819,沙糖桔,20240329,全国,全国,259,80,179
820,沙糖桔,20240330,全国,全国,233,63,170
821,沙糖桔,20240331,全国,全国,182,0,182
822,沙糖桔,20240401,全国,全国,244,83,161
823,沙糖桔,20240402,全国,全国,248,72,176
824,沙糖桔,20240403,全国,全国,242,74,168
825,沙糖桔,20240404,全国,全国,219,64,155
826,沙糖桔,20240405,全国,全国,231,63,168
827,沙糖桔,20240406,全国,全国,254,70,184
828,沙糖桔,20240407,全国,全国,228,64,164
829,沙糖桔,20240408,全国,全国,225,64,161
830,沙糖桔,20240409,全国,全国,221,64,157
831,沙糖桔,20240410,全国,全国,236,70,166
832,沙糖桔,20240411,全国,全国,191,66,125
833,沙糖桔,20240412,全国,全国,259,70,189
834,沙糖桔,20240413,全国,全国,255,66,189
835,沙糖桔,20240414,全国,全国,230,70,160
836,沙糖桔,20240415,全国,全国,247,64,183
837,沙糖桔,20240416,全国,全国,231,63,168
838,沙糖桔,20240417,全国,全国,227,72,155
839,沙糖桔,20240418,全国,全国,248,85,163
840,沙糖桔,20240419,全国,全国,216,61,155
841,沙糖桔,20240420,全国,全国,224,57,167
842,沙糖桔,20240421,全国,全国,216,61,155
843,沙糖桔,20240422,全国,全国,227,64,163
844,沙糖桔,20240423,全国,全国,195,64,131
845,沙糖桔,20240424,全国,全国,213,66,147
846,沙糖桔,20240425,全国,全国,211,64,147
847,沙糖桔,20240426,全国,全国,207,68,139
848,沙糖桔,20240427,全国,全国,226,61,165
849,沙糖桔,20240428,全国,全国,197,74,123
850,沙糖桔,20240429,全国,全国,184,63,121
851,沙糖桔,20240430,全国,全国,208,57,151
639,沙糖桔,20231001,全国,全国,269,61,208
640,沙糖桔,20231002,全国,全国,275,63,212
641,沙糖桔,20231003,全国,全国,256,61,195
642,沙糖桔,20231004,全国,全国,281,66,215
643,沙糖桔,20231005,全国,全国,280,68,212
644,沙糖桔,20231006,全国,全国,314,66,248
645,沙糖桔,20231007,全国,全国,287,78,209
646,沙糖桔,20231008,全国,全国,316,89,227
647,沙糖桔,20231009,全国,全国,308,70,238
648,沙糖桔,20231010,全国,全国,325,70,255
649,沙糖桔,20231011,全国,全国,344,80,264
650,沙糖桔,20231012,全国,全国,335,87,248
651,沙糖桔,20231013,全国,全国,316,82,234
652,沙糖桔,20231014,全国,全国,336,63,273
653,沙糖桔,20231015,全国,全国,383,76,307
654,沙糖桔,20231016,全国,全国,388,85,303
655,沙糖桔,20231017,全国,全国,372,87,285
656,沙糖桔,20231018,全国,全国,378,91,287
657,沙糖桔,20231019,全国,全国,355,93,262
658,沙糖桔,20231020,全国,全国,331,93,238
659,沙糖桔,20231021,全国,全国,427,83,344
660,沙糖桔,20231022,全国,全国,407,74,333
661,沙糖桔,20231023,全国,全国,402,87,315
662,沙糖桔,20231024,全国,全国,370,76,294
663,沙糖桔,20231025,全国,全国,387,102,285
664,沙糖桔,20231026,全国,全国,353,87,266
665,沙糖桔,20231027,全国,全国,402,89,313
666,沙糖桔,20231028,全国,全国,449,82,367
667,沙糖桔,20231029,全国,全国,443,74,369
668,沙糖桔,20231030,全国,全国,404,95,309
669,沙糖桔,20231031,全国,全国,447,95,352
670,沙糖桔,20231101,全国,全国,519,114,405
671,沙糖桔,20231102,全国,全国,448,106,342
672,沙糖桔,20231103,全国,全国,498,97,401
673,沙糖桔,20231104,全国,全国,498,82,416
674,沙糖桔,20231105,全国,全国,468,95,373
675,沙糖桔,20231106,全国,全国,548,108,440
676,沙糖桔,20231107,全国,全国,513,97,416
677,沙糖桔,20231108,全国,全国,591,99,492
678,沙糖桔,20231109,全国,全国,584,116,468
679,沙糖桔,20231110,全国,全国,509,116,393
680,沙糖桔,20231111,全国,全国,523,87,436
681,沙糖桔,20231112,全国,全国,649,78,571
682,沙糖桔,20231113,全国,全国,549,112,437
683,沙糖桔,20231114,全国,全国,657,85,572
684,沙糖桔,20231115,全国,全国,652,133,519
685,沙糖桔,20231116,全国,全国,638,121,517
686,沙糖桔,20231117,全国,全国,735,104,631
687,沙糖桔,20231118,全国,全国,745,114,631
688,沙糖桔,20231119,全国,全国,882,82,800
689,沙糖桔,20231120,全国,全国,943,140,803
690,沙糖桔,20231121,全国,全国,822,116,706
691,沙糖桔,20231122,全国,全国,823,120,703
692,沙糖桔,20231123,全国,全国,783,116,667
693,沙糖桔,20231124,全国,全国,797,133,664
694,沙糖桔,20231125,全国,全国,878,89,789
695,沙糖桔,20231126,全国,全国,996,139,857
696,沙糖桔,20231127,全国,全国,920,140,780
697,沙糖桔,20231128,全国,全国,819,162,657
698,沙糖桔,20231129,全国,全国,912,139,773
699,沙糖桔,20231130,全国,全国,840,137,703
700,沙糖桔,20231201,全国,全国,845,148,697
701,沙糖桔,20231202,全国,全国,837,110,727
702,沙糖桔,20231203,全国,全国,935,102,833
703,沙糖桔,20231204,全国,全国,834,144,690
704,沙糖桔,20231205,全国,全国,806,118,688
705,沙糖桔,20231206,全国,全国,912,157,755
706,沙糖桔,20231207,全国,全国,796,140,656
707,沙糖桔,20231208,全国,全国,774,137,637
708,沙糖桔,20231209,全国,全国,815,116,699
709,沙糖桔,20231210,全国,全国,944,102,842
710,沙糖桔,20231211,全国,全国,619,162,457
711,沙糖桔,20231212,全国,全国,524,148,376
712,沙糖桔,20231213,全国,全国,698,142,556
713,沙糖桔,20231214,全国,全国,738,146,592
714,沙糖桔,20231215,全国,全国,720,146,574
715,沙糖桔,20231216,全国,全国,636,93,543
716,沙糖桔,20231217,全国,全国,686,97,589
717,沙糖桔,20231218,全国,全国,734,148,586
718,沙糖桔,20231219,全国,全国,722,159,563
719,沙糖桔,20231220,全国,全国,754,168,586
720,沙糖桔,20231221,全国,全国,750,151,599
721,沙糖桔,20231222,全国,全国,669,116,553
722,沙糖桔,20231223,全国,全国,661,116,545
723,沙糖桔,20231224,全国,全国,790,116,674
724,沙糖桔,20231225,全国,全国,795,137,658
725,沙糖桔,20231226,全国,全国,798,139,659
726,沙糖桔,20231227,全国,全国,850,165,685
727,沙糖桔,20231228,全国,全国,891,125,766
728,沙糖桔,20231229,全国,全国,840,135,705
729,沙糖桔,20231230,全国,全国,821,91,730
730,沙糖桔,20231231,全国,全国,788,83,705
731,沙糖桔,20240101,全国,全国,873,91,782
732,沙糖桔,20240102,全国,全国,841,168,673
733,沙糖桔,20240103,全国,全国,1310,372,938
734,沙糖桔,20240104,全国,全国,1701,461,1240
735,沙糖桔,20240105,全国,全国,2136,512,1624
736,沙糖桔,20240106,全国,全国,2077,264,1813
737,沙糖桔,20240107,全国,全国,1978,211,1767
738,沙糖桔,20240108,全国,全国,1706,330,1376
739,沙糖桔,20240109,全国,全国,1242,279,963
740,沙糖桔,20240110,全国,全国,1190,239,951
741,沙糖桔,20240111,全国,全国,1111,204,907
742,沙糖桔,20240112,全国,全国,1137,205,932
743,沙糖桔,20240113,全国,全国,1082,144,938
744,沙糖桔,20240114,全国,全国,1033,139,894
745,沙糖桔,20240115,全国,全国,1040,176,864
746,沙糖桔,20240116,全国,全国,1039,209,830
747,沙糖桔,20240117,全国,全国,1028,165,863
748,沙糖桔,20240118,全国,全国,1003,162,841
749,沙糖桔,20240119,全国,全国,983,142,841
750,沙糖桔,20240120,全国,全国,952,104,848
751,沙糖桔,20240121,全国,全国,953,110,843
752,沙糖桔,20240122,全国,全国,835,157,678
753,沙糖桔,20240123,全国,全国,888,144,744
754,沙糖桔,20240124,全国,全国,909,125,784
755,沙糖桔,20240125,全国,全国,937,150,787
756,沙糖桔,20240126,全国,全国,946,139,807
757,沙糖桔,20240127,全国,全国,914,93,821
758,沙糖桔,20240128,全国,全国,967,112,855
759,沙糖桔,20240129,全国,全国,1010,163,847
760,沙糖桔,20240130,全国,全国,982,137,845
761,沙糖桔,20240131,全国,全国,944,150,794
762,沙糖桔,20240201,全国,全国,1047,207,840
763,沙糖桔,20240202,全国,全国,996,148,848
764,沙糖桔,20240203,全国,全国,964,108,856
765,沙糖桔,20240204,全国,全国,1009,152,857
766,沙糖桔,20240205,全国,全国,977,108,869
767,沙糖桔,20240206,全国,全国,984,104,880
768,沙糖桔,20240207,全国,全国,1010,118,892
769,沙糖桔,20240208,全国,全国,1032,101,931
770,沙糖桔,20240209,全国,全国,951,66,885
771,沙糖桔,20240210,全国,全国,926,72,854
772,沙糖桔,20240211,全国,全国,930,78,852
773,沙糖桔,20240212,全国,全国,909,64,845
774,沙糖桔,20240213,全国,全国,881,66,815
775,沙糖桔,20240214,全国,全国,869,83,786
776,沙糖桔,20240215,全国,全国,797,78,719
777,沙糖桔,20240216,全国,全国,816,93,723
778,沙糖桔,20240217,全国,全国,804,87,717
779,沙糖桔,20240218,全国,全国,828,125,703
780,沙糖桔,20240219,全国,全国,747,120,627
781,沙糖桔,20240220,全国,全国,650,99,551
782,沙糖桔,20240221,全国,全国,655,123,532
783,沙糖桔,20240222,全国,全国,658,104,554
784,沙糖桔,20240223,全国,全国,627,95,532
785,沙糖桔,20240224,全国,全国,629,80,549
786,沙糖桔,20240225,全国,全国,623,85,538
787,沙糖桔,20240226,全国,全国,547,102,445
788,沙糖桔,20240227,全国,全国,497,97,400
789,沙糖桔,20240228,全国,全国,492,106,386
790,沙糖桔,20240229,全国,全国,441,101,340
791,沙糖桔,20240301,全国,全国,401,87,314
792,沙糖桔,20240302,全国,全国,461,87,374
793,沙糖桔,20240303,全国,全国,432,70,362
794,沙糖桔,20240304,全国,全国,384,85,299
795,沙糖桔,20240305,全国,全国,408,101,307
796,沙糖桔,20240306,全国,全国,367,97,270
797,沙糖桔,20240307,全国,全国,351,74,277
798,沙糖桔,20240308,全国,全国,321,89,232
799,沙糖桔,20240309,全国,全国,305,66,239
800,沙糖桔,20240310,全国,全国,373,78,295
801,沙糖桔,20240311,全国,全国,323,78,245
802,沙糖桔,20240312,全国,全国,340,85,255
803,沙糖桔,20240313,全国,全国,317,83,234
804,沙糖桔,20240314,全国,全国,332,93,239
805,沙糖桔,20240315,全国,全国,303,72,231
806,沙糖桔,20240316,全国,全国,309,68,241
807,沙糖桔,20240317,全国,全国,288,61,227
808,沙糖桔,20240318,全国,全国,259,70,189
809,沙糖桔,20240319,全国,全国,311,93,218
810,沙糖桔,20240320,全国,全国,276,78,198
811,沙糖桔,20240321,全国,全国,287,76,211
812,沙糖桔,20240322,全国,全国,246,72,174
813,沙糖桔,20240323,全国,全国,263,63,200
814,沙糖桔,20240324,全国,全国,279,68,211
815,沙糖桔,20240325,全国,全国,253,76,177
816,沙糖桔,20240326,全国,全国,255,76,179
817,沙糖桔,20240327,全国,全国,248,80,168
818,沙糖桔,20240328,全国,全国,251,70,181
819,沙糖桔,20240329,全国,全国,259,80,179
820,沙糖桔,20240330,全国,全国,233,63,170
821,沙糖桔,20240331,全国,全国,182,0,182
822,沙糖桔,20240401,全国,全国,244,83,161
823,沙糖桔,20240402,全国,全国,248,72,176
824,沙糖桔,20240403,全国,全国,242,74,168
825,沙糖桔,20240404,全国,全国,219,64,155
826,沙糖桔,20240405,全国,全国,231,63,168
827,沙糖桔,20240406,全国,全国,254,70,184
828,沙糖桔,20240407,全国,全国,228,64,164
829,沙糖桔,20240408,全国,全国,225,64,161
830,沙糖桔,20240409,全国,全国,221,64,157
831,沙糖桔,20240410,全国,全国,236,70,166
832,沙糖桔,20240411,全国,全国,191,66,125
833,沙糖桔,20240412,全国,全国,259,70,189
834,沙糖桔,20240413,全国,全国,255,66,189
835,沙糖桔,20240414,全国,全国,230,70,160
836,沙糖桔,20240415,全国,全国,247,64,183
837,沙糖桔,20240416,全国,全国,231,63,168
838,沙糖桔,20240417,全国,全国,227,72,155
839,沙糖桔,20240418,全国,全国,248,85,163
840,沙糖桔,20240419,全国,全国,216,61,155
841,沙糖桔,20240420,全国,全国,224,57,167
842,沙糖桔,20240421,全国,全国,216,61,155
843,沙糖桔,20240422,全国,全国,227,64,163
844,沙糖桔,20240423,全国,全国,195,64,131
845,沙糖桔,20240424,全国,全国,213,66,147
846,沙糖桔,20240425,全国,全国,211,64,147
847,沙糖桔,20240426,全国,全国,207,68,139
848,沙糖桔,20240427,全国,全国,226,61,165
849,沙糖桔,20240428,全国,全国,197,74,123
850,沙糖桔,20240429,全国,全国,184,63,121
851,沙糖桔,20240430,全国,全国,208,57,151
1,小土豆,20220101,全国,全国,0,0,0
2,小土豆,20220102,全国,全国,0,0,0
3,小土豆,20220103,全国,全国,0,0,0
4,小土豆,20220104,全国,全国,0,0,0
5,小土豆,20220105,全国,全国,0,0,0
6,小土豆,20220106,全国,全国,0,0,0
7,小土豆,20220107,全国,全国,0,0,0
8,小土豆,20220108,全国,全国,0,0,0
9,小土豆,20220109,全国,全国,0,0,0
10,小土豆,20220110,全国,全国,0,0,0
11,小土豆,20220111,全国,全国,0,0,0
12,小土豆,20220112,全国,全国,0,0,0
13,小土豆,20220113,全国,全国,0,0,0
14,小土豆,20220114,全国,全国,0,0,0
15,小土豆,20220115,全国,全国,0,0,0
16,小土豆,20220116,全国,全国,0,0,0
17,小土豆,20220117,全国,全国,0,0,0
18,小土豆,20220118,全国,全国,0,0,0
19,小土豆,20220119,全国,全国,0,0,0
20,小土豆,20220120,全国,全国,0,0,0
21,小土豆,20220121,全国,全国,0,0,0
22,小土豆,20220122,全国,全国,0,0,0
23,小土豆,20220123,全国,全国,0,0,0
24,小土豆,20220124,全国,全国,0,0,0
25,小土豆,20220125,全国,全国,0,0,0
26,小土豆,20220126,全国,全国,0,0,0
27,小土豆,20220127,全国,全国,0,0,0
28,小土豆,20220128,全国,全国,0,0,0
29,小土豆,20220129,全国,全国,0,0,0
30,小土豆,20220130,全国,全国,0,0,0
31,小土豆,20220131,全国,全国,0,0,0
32,小土豆,20220201,全国,全国,0,0,0
33,小土豆,20220202,全国,全国,0,0,0
34,小土豆,20220203,全国,全国,0,0,0
35,小土豆,20220204,全国,全国,0,0,0
36,小土豆,20220205,全国,全国,0,0,0
37,小土豆,20220206,全国,全国,0,0,0
38,小土豆,20220207,全国,全国,0,0,0
39,小土豆,20220208,全国,全国,0,0,0
40,小土豆,20220209,全国,全国,0,0,0
41,小土豆,20220210,全国,全国,0,0,0
42,小土豆,20220211,全国,全国,0,0,0
43,小土豆,20220212,全国,全国,0,0,0
44,小土豆,20220213,全国,全国,0,0,0
45,小土豆,20220214,全国,全国,0,0,0
46,小土豆,20220215,全国,全国,0,0,0
47,小土豆,20220216,全国,全国,0,0,0
48,小土豆,20220217,全国,全国,0,0,0
49,小土豆,20220218,全国,全国,0,0,0
50,小土豆,20220219,全国,全国,0,0,0
51,小土豆,20220220,全国,全国,0,0,0
52,小土豆,20220221,全国,全国,0,0,0
53,小土豆,20220222,全国,全国,0,0,0
54,小土豆,20220223,全国,全国,0,0,0
55,小土豆,20220224,全国,全国,0,0,0
56,小土豆,20220225,全国,全国,0,0,0
57,小土豆,20220226,全国,全国,0,0,0
58,小土豆,20220227,全国,全国,0,0,0
59,小土豆,20220228,全国,全国,0,0,0
60,小土豆,20220301,全国,全国,0,0,0
61,小土豆,20220302,全国,全国,0,0,0
62,小土豆,20220303,全国,全国,0,0,0
63,小土豆,20220304,全国,全国,0,0,0
64,小土豆,20220305,全国,全国,0,0,0
65,小土豆,20220306,全国,全国,0,0,0
66,小土豆,20220307,全国,全国,0,0,0
67,小土豆,20220308,全国,全国,0,0,0
68,小土豆,20220309,全国,全国,0,0,0
69,小土豆,20220310,全国,全国,0,0,0
70,小土豆,20220311,全国,全国,0,0,0
71,小土豆,20220312,全国,全国,0,0,0
72,小土豆,20220313,全国,全国,0,0,0
73,小土豆,20220314,全国,全国,0,0,0
74,小土豆,20220315,全国,全国,0,0,0
75,小土豆,20220316,全国,全国,0,0,0
76,小土豆,20220317,全国,全国,0,0,0
77,小土豆,20220318,全国,全国,0,0,0
78,小土豆,20220319,全国,全国,0,0,0
79,小土豆,20220320,全国,全国,0,0,0
80,小土豆,20220321,全国,全国,0,0,0
81,小土豆,20220322,全国,全国,0,0,0
82,小土豆,20220323,全国,全国,0,0,0
83,小土豆,20220324,全国,全国,0,0,0
84,小土豆,20220325,全国,全国,0,0,0
85,小土豆,20220326,全国,全国,0,0,0
86,小土豆,20220327,全国,全国,0,0,0
87,小土豆,20220328,全国,全国,0,0,0
88,小土豆,20220329,全国,全国,0,0,0
89,小土豆,20220330,全国,全国,0,0,0
90,小土豆,20220331,全国,全国,0,0,0
91,小土豆,20220401,全国,全国,0,0,0
92,小土豆,20220402,全国,全国,0,0,0
93,小土豆,20220403,全国,全国,0,0,0
94,小土豆,20220404,全国,全国,0,0,0
95,小土豆,20220405,全国,全国,0,0,0
96,小土豆,20220406,全国,全国,0,0,0
97,小土豆,20220407,全国,全国,0,0,0
98,小土豆,20220408,全国,全国,0,0,0
99,小土豆,20220409,全国,全国,0,0,0
100,小土豆,20220410,全国,全国,0,0,0
101,小土豆,20220411,全国,全国,0,0,0
102,小土豆,20220412,全国,全国,0,0,0
103,小土豆,20220413,全国,全国,0,0,0
104,小土豆,20220414,全国,全国,0,0,0
105,小土豆,20220415,全国,全国,0,0,0
106,小土豆,20220416,全国,全国,0,0,0
107,小土豆,20220417,全国,全国,0,0,0
108,小土豆,20220418,全国,全国,0,0,0
109,小土豆,20220419,全国,全国,0,0,0
110,小土豆,20220420,全国,全国,0,0,0
111,小土豆,20220421,全国,全国,0,0,0
112,小土豆,20220422,全国,全国,0,0,0
113,小土豆,20220423,全国,全国,0,0,0
114,小土豆,20220424,全国,全国,0,0,0
115,小土豆,20220425,全国,全国,0,0,0
116,小土豆,20220426,全国,全国,0,0,0
117,小土豆,20220427,全国,全国,0,0,0
118,小土豆,20220428,全国,全国,0,0,0
119,小土豆,20220429,全国,全国,0,0,0
120,小土豆,20220430,全国,全国,0,0,0
121,小土豆,20220501,全国,全国,0,0,0
122,小土豆,20220502,全国,全国,0,0,0
123,小土豆,20220503,全国,全国,0,0,0
124,小土豆,20220504,全国,全国,0,0,0
125,小土豆,20220505,全国,全国,0,0,0
126,小土豆,20220506,全国,全国,0,0,0
127,小土豆,20220507,全国,全国,0,0,0
128,小土豆,20220508,全国,全国,0,0,0
129,小土豆,20220509,全国,全国,0,0,0
130,小土豆,20220510,全国,全国,0,0,0
131,小土豆,20220511,全国,全国,0,0,0
132,小土豆,20220512,全国,全国,0,0,0
133,小土豆,20220513,全国,全国,0,0,0
134,小土豆,20220514,全国,全国,0,0,0
135,小土豆,20220515,全国,全国,0,0,0
136,小土豆,20220516,全国,全国,0,0,0
137,小土豆,20220517,全国,全国,0,0,0
138,小土豆,20220518,全国,全国,0,0,0
139,小土豆,20220519,全国,全国,0,0,0
140,小土豆,20220520,全国,全国,0,0,0
141,小土豆,20220521,全国,全国,0,0,0
142,小土豆,20220522,全国,全国,0,0,0
143,小土豆,20220523,全国,全国,0,0,0
144,小土豆,20220524,全国,全国,0,0,0
145,小土豆,20220525,全国,全国,0,0,0
146,小土豆,20220526,全国,全国,0,0,0
147,小土豆,20220527,全国,全国,0,0,0
148,小土豆,20220528,全国,全国,0,0,0
149,小土豆,20220529,全国,全国,0,0,0
150,小土豆,20220530,全国,全国,0,0,0
151,小土豆,20220531,全国,全国,0,0,0
152,小土豆,20220601,全国,全国,0,0,0
153,小土豆,20220602,全国,全国,0,0,0
154,小土豆,20220603,全国,全国,0,0,0
155,小土豆,20220604,全国,全国,0,0,0
156,小土豆,20220605,全国,全国,0,0,0
157,小土豆,20220606,全国,全国,0,0,0
158,小土豆,20220607,全国,全国,0,0,0
159,小土豆,20220608,全国,全国,0,0,0
160,小土豆,20220609,全国,全国,0,0,0
161,小土豆,20220610,全国,全国,0,0,0
162,小土豆,20220611,全国,全国,0,0,0
163,小土豆,20220612,全国,全国,0,0,0
164,小土豆,20220613,全国,全国,0,0,0
165,小土豆,20220614,全国,全国,0,0,0
166,小土豆,20220615,全国,全国,0,0,0
167,小土豆,20220616,全国,全国,0,0,0
168,小土豆,20220617,全国,全国,0,0,0
169,小土豆,20220618,全国,全国,0,0,0
170,小土豆,20220619,全国,全国,0,0,0
171,小土豆,20220620,全国,全国,0,0,0
172,小土豆,20220621,全国,全国,0,0,0
173,小土豆,20220622,全国,全国,0,0,0
174,小土豆,20220623,全国,全国,0,0,0
175,小土豆,20220624,全国,全国,0,0,0
176,小土豆,20220625,全国,全国,0,0,0
177,小土豆,20220626,全国,全国,0,0,0
178,小土豆,20220627,全国,全国,0,0,0
179,小土豆,20220628,全国,全国,0,0,0
180,小土豆,20220629,全国,全国,0,0,0
181,小土豆,20220630,全国,全国,0,0,0
182,小土豆,20220701,全国,全国,0,0,0
183,小土豆,20220702,全国,全国,0,0,0
184,小土豆,20220703,全国,全国,0,0,0
185,小土豆,20220704,全国,全国,0,0,0
186,小土豆,20220705,全国,全国,0,0,0
187,小土豆,20220706,全国,全国,0,0,0
188,小土豆,20220707,全国,全国,0,0,0
189,小土豆,20220708,全国,全国,0,0,0
190,小土豆,20220709,全国,全国,0,0,0
191,小土豆,20220710,全国,全国,0,0,0
192,小土豆,20220711,全国,全国,0,0,0
193,小土豆,20220712,全国,全国,0,0,0
194,小土豆,20220713,全国,全国,0,0,0
195,小土豆,20220714,全国,全国,0,0,0
196,小土豆,20220715,全国,全国,0,0,0
197,小土豆,20220716,全国,全国,0,0,0
198,小土豆,20220717,全国,全国,0,0,0
199,小土豆,20220718,全国,全国,0,0,0
200,小土豆,20220719,全国,全国,0,0,0
201,小土豆,20220720,全国,全国,0,0,0
202,小土豆,20220721,全国,全国,0,0,0
203,小土豆,20220722,全国,全国,0,0,0
204,小土豆,20220723,全国,全国,0,0,0
205,小土豆,20220724,全国,全国,0,0,0
206,小土豆,20220725,全国,全国,0,0,0
207,小土豆,20220726,全国,全国,0,0,0
208,小土豆,20220727,全国,全国,0,0,0
209,小土豆,20220728,全国,全国,0,0,0
210,小土豆,20220729,全国,全国,0,0,0
211,小土豆,20220730,全国,全国,0,0,0
212,小土豆,20220731,全国,全国,0,0,0
213,小土豆,20220801,全国,全国,0,0,0
214,小土豆,20220802,全国,全国,0,0,0
215,小土豆,20220803,全国,全国,0,0,0
216,小土豆,20220804,全国,全国,0,0,0
217,小土豆,20220805,全国,全国,0,0,0
218,小土豆,20220806,全国,全国,0,0,0
219,小土豆,20220807,全国,全国,0,0,0
220,小土豆,20220808,全国,全国,0,0,0
221,小土豆,20220809,全国,全国,0,0,0
222,小土豆,20220810,全国,全国,0,0,0
223,小土豆,20220811,全国,全国,0,0,0
224,小土豆,20220812,全国,全国,0,0,0
225,小土豆,20220813,全国,全国,0,0,0
226,小土豆,20220814,全国,全国,0,0,0
227,小土豆,20220815,全国,全国,0,0,0
228,小土豆,20220816,全国,全国,0,0,0
229,小土豆,20220817,全国,全国,0,0,0
230,小土豆,20220818,全国,全国,0,0,0
231,小土豆,20220819,全国,全国,0,0,0
232,小土豆,20220820,全国,全国,0,0,0
233,小土豆,20220821,全国,全国,0,0,0
234,小土豆,20220822,全国,全国,0,0,0
235,小土豆,20220823,全国,全国,0,0,0
236,小土豆,20220824,全国,全国,0,0,0
237,小土豆,20220825,全国,全国,0,0,0
238,小土豆,20220826,全国,全国,0,0,0
239,小土豆,20220827,全国,全国,0,0,0
240,小土豆,20220828,全国,全国,0,0,0
241,小土豆,20220829,全国,全国,0,0,0
242,小土豆,20220830,全国,全国,0,0,0
243,小土豆,20220831,全国,全国,0,0,0
244,小土豆,20220901,全国,全国,0,0,0
245,小土豆,20220902,全国,全国,0,0,0
246,小土豆,20220903,全国,全国,0,0,0
247,小土豆,20220904,全国,全国,0,0,0
248,小土豆,20220905,全国,全国,0,0,0
249,小土豆,20220906,全国,全国,0,0,0
250,小土豆,20220907,全国,全国,0,0,0
251,小土豆,20220908,全国,全国,0,0,0
252,小土豆,20220909,全国,全国,0,0,0
253,小土豆,20220910,全国,全国,0,0,0
254,小土豆,20220911,全国,全国,0,0,0
255,小土豆,20220912,全国,全国,0,0,0
256,小土豆,20220913,全国,全国,0,0,0
257,小土豆,20220914,全国,全国,0,0,0
258,小土豆,20220915,全国,全国,0,0,0
259,小土豆,20220916,全国,全国,0,0,0
260,小土豆,20220917,全国,全国,0,0,0
261,小土豆,20220918,全国,全国,0,0,0
262,小土豆,20220919,全国,全国,0,0,0
263,小土豆,20220920,全国,全国,0,0,0
264,小土豆,20220921,全国,全国,0,0,0
265,小土豆,20220922,全国,全国,0,0,0
266,小土豆,20220923,全国,全国,0,0,0
267,小土豆,20220924,全国,全国,0,0,0
268,小土豆,20220925,全国,全国,0,0,0
269,小土豆,20220926,全国,全国,0,0,0
270,小土豆,20220927,全国,全国,0,0,0
271,小土豆,20220928,全国,全国,0,0,0
272,小土豆,20220929,全国,全国,0,0,0
273,小土豆,20220930,全国,全国,0,0,0
274,小土豆,20221001,全国,全国,0,0,0
275,小土豆,20221002,全国,全国,0,0,0
276,小土豆,20221003,全国,全国,0,0,0
277,小土豆,20221004,全国,全国,0,0,0
278,小土豆,20221005,全国,全国,0,0,0
279,小土豆,20221006,全国,全国,0,0,0
280,小土豆,20221007,全国,全国,0,0,0
281,小土豆,20221008,全国,全国,0,0,0
282,小土豆,20221009,全国,全国,0,0,0
283,小土豆,20221010,全国,全国,0,0,0
284,小土豆,20221011,全国,全国,0,0,0
285,小土豆,20221012,全国,全国,0,0,0
286,小土豆,20221013,全国,全国,0,0,0
287,小土豆,20221014,全国,全国,0,0,0
288,小土豆,20221015,全国,全国,0,0,0
289,小土豆,20221016,全国,全国,0,0,0
290,小土豆,20221017,全国,全国,0,0,0
291,小土豆,20221018,全国,全国,0,0,0
292,小土豆,20221019,全国,全国,0,0,0
293,小土豆,20221020,全国,全国,0,0,0
294,小土豆,20221021,全国,全国,0,0,0
295,小土豆,20221022,全国,全国,0,0,0
296,小土豆,20221023,全国,全国,0,0,0
297,小土豆,20221024,全国,全国,0,0,0
298,小土豆,20221025,全国,全国,0,0,0
299,小土豆,20221026,全国,全国,0,0,0
300,小土豆,20221027,全国,全国,0,0,0
301,小土豆,20221028,全国,全国,0,0,0
302,小土豆,20221029,全国,全国,0,0,0
303,小土豆,20221030,全国,全国,0,0,0
304,小土豆,20221031,全国,全国,0,0,0
305,小土豆,20221101,全国,全国,0,0,0
306,小土豆,20221102,全国,全国,0,0,0
307,小土豆,20221103,全国,全国,0,0,0
308,小土豆,20221104,全国,全国,0,0,0
309,小土豆,20221105,全国,全国,0,0,0
310,小土豆,20221106,全国,全国,0,0,0
311,小土豆,20221107,全国,全国,0,0,0
312,小土豆,20221108,全国,全国,0,0,0
313,小土豆,20221109,全国,全国,0,0,0
314,小土豆,20221110,全国,全国,0,0,0
315,小土豆,20221111,全国,全国,0,0,0
316,小土豆,20221112,全国,全国,0,0,0
317,小土豆,20221113,全国,全国,0,0,0
318,小土豆,20221114,全国,全国,0,0,0
319,小土豆,20221115,全国,全国,0,0,0
320,小土豆,20221116,全国,全国,0,0,0
321,小土豆,20221117,全国,全国,0,0,0
322,小土豆,20221118,全国,全国,0,0,0
323,小土豆,20221119,全国,全国,0,0,0
324,小土豆,20221120,全国,全国,0,0,0
325,小土豆,20221121,全国,全国,0,0,0
326,小土豆,20221122,全国,全国,0,0,0
327,小土豆,20221123,全国,全国,0,0,0
328,小土豆,20221124,全国,全国,0,0,0
329,小土豆,20221125,全国,全国,0,0,0
330,小土豆,20221126,全国,全国,0,0,0
331,小土豆,20221127,全国,全国,0,0,0
332,小土豆,20221128,全国,全国,0,0,0
333,小土豆,20221129,全国,全国,0,0,0
334,小土豆,20221130,全国,全国,0,0,0
335,小土豆,20221201,全国,全国,0,0,0
336,小土豆,20221202,全国,全国,0,0,0
337,小土豆,20221203,全国,全国,0,0,0
338,小土豆,20221204,全国,全国,0,0,0
339,小土豆,20221205,全国,全国,0,0,0
340,小土豆,20221206,全国,全国,0,0,0
341,小土豆,20221207,全国,全国,0,0,0
342,小土豆,20221208,全国,全国,0,0,0
343,小土豆,20221209,全国,全国,0,0,0
344,小土豆,20221210,全国,全国,0,0,0
345,小土豆,20221211,全国,全国,0,0,0
346,小土豆,20221212,全国,全国,0,0,0
347,小土豆,20221213,全国,全国,0,0,0
348,小土豆,20221214,全国,全国,0,0,0
349,小土豆,20221215,全国,全国,0,0,0
350,小土豆,20221216,全国,全国,0,0,0
351,小土豆,20221217,全国,全国,0,0,0
352,小土豆,20221218,全国,全国,0,0,0
353,小土豆,20221219,全国,全国,0,0,0
354,小土豆,20221220,全国,全国,0,0,0
355,小土豆,20221221,全国,全国,0,0,0
356,小土豆,20221222,全国,全国,0,0,0
357,小土豆,20221223,全国,全国,0,0,0
358,小土豆,20221224,全国,全国,0,0,0
359,小土豆,20221225,全国,全国,0,0,0
360,小土豆,20221226,全国,全国,0,0,0
361,小土豆,20221227,全国,全国,0,0,0
362,小土豆,20221228,全国,全国,0,0,0
363,小土豆,20221229,全国,全国,0,0,0
364,小土豆,20221230,全国,全国,0,0,0
365,小土豆,20221231,全国,全国,0,0,0
366,小土豆,20230101,全国,全国,0,0,0
367,小土豆,20230102,全国,全国,0,0,0
368,小土豆,20230103,全国,全国,0,0,0
369,小土豆,20230104,全国,全国,0,0,0
370,小土豆,20230105,全国,全国,0,0,0
371,小土豆,20230106,全国,全国,0,0,0
372,小土豆,20230107,全国,全国,0,0,0
373,小土豆,20230108,全国,全国,0,0,0
374,小土豆,20230109,全国,全国,0,0,0
375,小土豆,20230110,全国,全国,0,0,0
376,小土豆,20230111,全国,全国,0,0,0
377,小土豆,20230112,全国,全国,0,0,0
378,小土豆,20230113,全国,全国,0,0,0
379,小土豆,20230114,全国,全国,0,0,0
380,小土豆,20230115,全国,全国,0,0,0
381,小土豆,20230116,全国,全国,0,0,0
382,小土豆,20230117,全国,全国,0,0,0
383,小土豆,20230118,全国,全国,0,0,0
384,小土豆,20230119,全国,全国,0,0,0
385,小土豆,20230120,全国,全国,0,0,0
386,小土豆,20230121,全国,全国,0,0,0
387,小土豆,20230122,全国,全国,0,0,0
388,小土豆,20230123,全国,全国,0,0,0
389,小土豆,20230124,全国,全国,0,0,0
390,小土豆,20230125,全国,全国,0,0,0
391,小土豆,20230126,全国,全国,0,0,0
392,小土豆,20230127,全国,全国,0,0,0
393,小土豆,20230128,全国,全国,0,0,0
394,小土豆,20230129,全国,全国,0,0,0
395,小土豆,20230130,全国,全国,0,0,0
396,小土豆,20230131,全国,全国,0,0,0
397,小土豆,20230201,全国,全国,0,0,0
398,小土豆,20230202,全国,全国,0,0,0
399,小土豆,20230203,全国,全国,0,0,0
400,小土豆,20230204,全国,全国,0,0,0
401,小土豆,20230205,全国,全国,0,0,0
402,小土豆,20230206,全国,全国,0,0,0
403,小土豆,20230207,全国,全国,0,0,0
404,小土豆,20230208,全国,全国,0,0,0
405,小土豆,20230209,全国,全国,0,0,0
406,小土豆,20230210,全国,全国,0,0,0
407,小土豆,20230211,全国,全国,0,0,0
408,小土豆,20230212,全国,全国,0,0,0
409,小土豆,20230213,全国,全国,0,0,0
410,小土豆,20230214,全国,全国,0,0,0
411,小土豆,20230215,全国,全国,0,0,0
412,小土豆,20230216,全国,全国,0,0,0
413,小土豆,20230217,全国,全国,0,0,0
414,小土豆,20230218,全国,全国,0,0,0
415,小土豆,20230219,全国,全国,0,0,0
416,小土豆,20230220,全国,全国,0,0,0
417,小土豆,20230221,全国,全国,0,0,0
418,小土豆,20230222,全国,全国,0,0,0
419,小土豆,20230223,全国,全国,0,0,0
420,小土豆,20230224,全国,全国,0,0,0
421,小土豆,20230225,全国,全国,0,0,0
422,小土豆,20230226,全国,全国,0,0,0
423,小土豆,20230227,全国,全国,0,0,0
424,小土豆,20230228,全国,全国,0,0,0
425,小土豆,20230301,全国,全国,0,0,0
426,小土豆,20230302,全国,全国,0,0,0
427,小土豆,20230303,全国,全国,0,0,0
428,小土豆,20230304,全国,全国,0,0,0
429,小土豆,20230305,全国,全国,0,0,0
430,小土豆,20230306,全国,全国,0,0,0
431,小土豆,20230307,全国,全国,0,0,0
432,小土豆,20230308,全国,全国,0,0,0
433,小土豆,20230309,全国,全国,0,0,0
434,小土豆,20230310,全国,全国,0,0,0
435,小土豆,20230311,全国,全国,0,0,0
436,小土豆,20230312,全国,全国,0,0,0
437,小土豆,20230313,全国,全国,0,0,0
438,小土豆,20230314,全国,全国,0,0,0
439,小土豆,20230315,全国,全国,0,0,0
440,小土豆,20230316,全国,全国,0,0,0
441,小土豆,20230317,全国,全国,0,0,0
442,小土豆,20230318,全国,全国,0,0,0
443,小土豆,20230319,全国,全国,0,0,0
444,小土豆,20230320,全国,全国,0,0,0
445,小土豆,20230321,全国,全国,0,0,0
446,小土豆,20230322,全国,全国,0,0,0
447,小土豆,20230323,全国,全国,0,0,0
448,小土豆,20230324,全国,全国,0,0,0
449,小土豆,20230325,全国,全国,0,0,0
450,小土豆,20230326,全国,全国,0,0,0
451,小土豆,20230327,全国,全国,0,0,0
452,小土豆,20230328,全国,全国,0,0,0
453,小土豆,20230329,全国,全国,0,0,0
454,小土豆,20230330,全国,全国,0,0,0
455,小土豆,20230331,全国,全国,0,0,0
456,小土豆,20230401,全国,全国,0,0,0
457,小土豆,20230402,全国,全国,0,0,0
458,小土豆,20230403,全国,全国,0,0,0
459,小土豆,20230404,全国,全国,0,0,0
460,小土豆,20230405,全国,全国,0,0,0
461,小土豆,20230406,全国,全国,0,0,0
462,小土豆,20230407,全国,全国,0,0,0
463,小土豆,20230408,全国,全国,0,0,0
464,小土豆,20230409,全国,全国,0,0,0
465,小土豆,20230410,全国,全国,0,0,0
466,小土豆,20230411,全国,全国,0,0,0
467,小土豆,20230412,全国,全国,0,0,0
468,小土豆,20230413,全国,全国,0,0,0
469,小土豆,20230414,全国,全国,0,0,0
470,小土豆,20230415,全国,全国,0,0,0
471,小土豆,20230416,全国,全国,0,0,0
472,小土豆,20230417,全国,全国,0,0,0
473,小土豆,20230418,全国,全国,0,0,0
474,小土豆,20230419,全国,全国,0,0,0
475,小土豆,20230420,全国,全国,0,0,0
476,小土豆,20230421,全国,全国,0,0,0
477,小土豆,20230422,全国,全国,0,0,0
478,小土豆,20230423,全国,全国,0,0,0
479,小土豆,20230424,全国,全国,0,0,0
480,小土豆,20230425,全国,全国,0,0,0
481,小土豆,20230426,全国,全国,0,0,0
482,小土豆,20230427,全国,全国,0,0,0
483,小土豆,20230428,全国,全国,0,0,0
484,小土豆,20230429,全国,全国,0,0,0
485,小土豆,20230430,全国,全国,0,0,0
486,小土豆,20230501,全国,全国,0,0,0
487,小土豆,20230502,全国,全国,0,0,0
488,小土豆,20230503,全国,全国,0,0,0
489,小土豆,20230504,全国,全国,0,0,0
490,小土豆,20230505,全国,全国,0,0,0
491,小土豆,20230506,全国,全国,0,0,0
492,小土豆,20230507,全国,全国,0,0,0
493,小土豆,20230508,全国,全国,0,0,0
494,小土豆,20230509,全国,全国,0,0,0
495,小土豆,20230510,全国,全国,0,0,0
496,小土豆,20230511,全国,全国,0,0,0
497,小土豆,20230512,全国,全国,0,0,0
498,小土豆,20230513,全国,全国,0,0,0
499,小土豆,20230514,全国,全国,0,0,0
500,小土豆,20230515,全国,全国,0,0,0
501,小土豆,20230516,全国,全国,0,0,0
502,小土豆,20230517,全国,全国,0,0,0
503,小土豆,20230518,全国,全国,0,0,0
504,小土豆,20230519,全国,全国,0,0,0
505,小土豆,20230520,全国,全国,0,0,0
506,小土豆,20230521,全国,全国,0,0,0
507,小土豆,20230522,全国,全国,0,0,0
508,小土豆,20230523,全国,全国,0,0,0
509,小土豆,20230524,全国,全国,0,0,0
510,小土豆,20230525,全国,全国,0,0,0
511,小土豆,20230526,全国,全国,0,0,0
512,小土豆,20230527,全国,全国,0,0,0
513,小土豆,20230528,全国,全国,0,0,0
514,小土豆,20230529,全国,全国,0,0,0
515,小土豆,20230530,全国,全国,0,0,0
516,小土豆,20230531,全国,全国,0,0,0
517,小土豆,20230601,全国,全国,0,0,0
518,小土豆,20230602,全国,全国,0,0,0
519,小土豆,20230603,全国,全国,0,0,0
520,小土豆,20230604,全国,全国,0,0,0
521,小土豆,20230605,全国,全国,0,0,0
522,小土豆,20230606,全国,全国,0,0,0
523,小土豆,20230607,全国,全国,0,0,0
524,小土豆,20230608,全国,全国,0,0,0
525,小土豆,20230609,全国,全国,0,0,0
526,小土豆,20230610,全国,全国,0,0,0
527,小土豆,20230611,全国,全国,0,0,0
528,小土豆,20230612,全国,全国,0,0,0
529,小土豆,20230613,全国,全国,0,0,0
530,小土豆,20230614,全国,全国,0,0,0
531,小土豆,20230615,全国,全国,0,0,0
532,小土豆,20230616,全国,全国,0,0,0
533,小土豆,20230617,全国,全国,0,0,0
534,小土豆,20230618,全国,全国,0,0,0
535,小土豆,20230619,全国,全国,0,0,0
536,小土豆,20230620,全国,全国,0,0,0
537,小土豆,20230621,全国,全国,0,0,0
538,小土豆,20230622,全国,全国,0,0,0
539,小土豆,20230623,全国,全国,0,0,0
540,小土豆,20230624,全国,全国,0,0,0
541,小土豆,20230625,全国,全国,0,0,0
542,小土豆,20230626,全国,全国,0,0,0
543,小土豆,20230627,全国,全国,0,0,0
544,小土豆,20230628,全国,全国,0,0,0
545,小土豆,20230629,全国,全国,0,0,0
546,小土豆,20230630,全国,全国,0,0,0
547,小土豆,20230701,全国,全国,0,0,0
548,小土豆,20230702,全国,全国,0,0,0
549,小土豆,20230703,全国,全国,0,0,0
550,小土豆,20230704,全国,全国,0,0,0
551,小土豆,20230705,全国,全国,0,0,0
552,小土豆,20230706,全国,全国,0,0,0
553,小土豆,20230707,全国,全国,0,0,0
554,小土豆,20230708,全国,全国,0,0,0
555,小土豆,20230709,全国,全国,0,0,0
556,小土豆,20230710,全国,全国,0,0,0
557,小土豆,20230711,全国,全国,0,0,0
558,小土豆,20230712,全国,全国,0,0,0
559,小土豆,20230713,全国,全国,0,0,0
560,小土豆,20230714,全国,全国,0,0,0
561,小土豆,20230715,全国,全国,0,0,0
562,小土豆,20230716,全国,全国,0,0,0
563,小土豆,20230717,全国,全国,0,0,0
564,小土豆,20230718,全国,全国,0,0,0
565,小土豆,20230719,全国,全国,0,0,0
566,小土豆,20230720,全国,全国,0,0,0
567,小土豆,20230721,全国,全国,0,0,0
568,小土豆,20230722,全国,全国,0,0,0
569,小土豆,20230723,全国,全国,0,0,0
570,小土豆,20230724,全国,全国,0,0,0
571,小土豆,20230725,全国,全国,0,0,0
572,小土豆,20230726,全国,全国,0,0,0
573,小土豆,20230727,全国,全国,0,0,0
574,小土豆,20230728,全国,全国,0,0,0
575,小土豆,20230729,全国,全国,0,0,0
576,小土豆,20230730,全国,全国,0,0,0
577,小土豆,20230731,全国,全国,0,0,0
578,小土豆,20230801,全国,全国,0,0,0
579,小土豆,20230802,全国,全国,0,0,0
580,小土豆,20230803,全国,全国,0,0,0
581,小土豆,20230804,全国,全国,0,0,0
582,小土豆,20230805,全国,全国,0,0,0
583,小土豆,20230806,全国,全国,0,0,0
584,小土豆,20230807,全国,全国,0,0,0
585,小土豆,20230808,全国,全国,0,0,0
586,小土豆,20230809,全国,全国,0,0,0
587,小土豆,20230810,全国,全国,0,0,0
588,小土豆,20230811,全国,全国,0,0,0
589,小土豆,20230812,全国,全国,0,0,0
590,小土豆,20230813,全国,全国,0,0,0
591,小土豆,20230814,全国,全国,0,0,0
592,小土豆,20230815,全国,全国,0,0,0
593,小土豆,20230816,全国,全国,0,0,0
594,小土豆,20230817,全国,全国,0,0,0
595,小土豆,20230818,全国,全国,0,0,0
596,小土豆,20230819,全国,全国,0,0,0
597,小土豆,20230820,全国,全国,0,0,0
598,小土豆,20230821,全国,全国,0,0,0
599,小土豆,20230822,全国,全国,0,0,0
600,小土豆,20230823,全国,全国,0,0,0
601,小土豆,20230824,全国,全国,0,0,0
602,小土豆,20230825,全国,全国,0,0,0
603,小土豆,20230826,全国,全国,0,0,0
604,小土豆,20230827,全国,全国,0,0,0
605,小土豆,20230828,全国,全国,0,0,0
606,小土豆,20230829,全国,全国,0,0,0
607,小土豆,20230830,全国,全国,0,0,0
608,小土豆,20230831,全国,全国,0,0,0
609,小土豆,20230901,全国,全国,0,0,0
610,小土豆,20230902,全国,全国,0,0,0
611,小土豆,20230903,全国,全国,0,0,0
612,小土豆,20230904,全国,全国,0,0,0
613,小土豆,20230905,全国,全国,0,0,0
614,小土豆,20230906,全国,全国,0,0,0
615,小土豆,20230907,全国,全国,0,0,0
616,小土豆,20230908,全国,全国,0,0,0
617,小土豆,20230909,全国,全国,0,0,0
618,小土豆,20230910,全国,全国,0,0,0
619,小土豆,20230911,全国,全国,0,0,0
620,小土豆,20230912,全国,全国,0,0,0
621,小土豆,20230913,全国,全国,0,0,0
622,小土豆,20230914,全国,全国,0,0,0
623,小土豆,20230915,全国,全国,0,0,0
624,小土豆,20230916,全国,全国,0,0,0
625,小土豆,20230917,全国,全国,0,0,0
626,小土豆,20230918,全国,全国,0,0,0
627,小土豆,20230919,全国,全国,0,0,0
628,小土豆,20230920,全国,全国,0,0,0
629,小土豆,20230921,全国,全国,0,0,0
630,小土豆,20230922,全国,全国,0,0,0
631,小土豆,20230923,全国,全国,0,0,0
632,小土豆,20230924,全国,全国,0,0,0
633,小土豆,20230925,全国,全国,0,0,0
634,小土豆,20230926,全国,全国,0,0,0
635,小土豆,20230927,全国,全国,0,0,0
636,小土豆,20230928,全国,全国,0,0,0
637,小土豆,20230929,全国,全国,0,0,0
638,小土豆,20230930,全国,全国,0,0,0
639,小土豆,20231001,全国,全国,353,66,287
640,小土豆,20231002,全国,全国,331,72,259
641,小土豆,20231003,全国,全国,356,68,288
642,小土豆,20231004,全国,全国,369,66,303
643,小土豆,20231005,全国,全国,366,74,292
644,小土豆,20231006,全国,全国,375,66,309
645,小土豆,20231007,全国,全国,412,85,327
646,小土豆,20231008,全国,全国,371,82,289
647,小土豆,20231009,全国,全国,355,108,247
648,小土豆,20231010,全国,全国,368,80,288
649,小土豆,20231011,全国,全国,362,82,280
650,小土豆,20231012,全国,全国,349,78,271
651,小土豆,20231013,全国,全国,369,87,282
652,小土豆,20231014,全国,全国,351,70,281
653,小土豆,20231015,全国,全国,410,68,342
654,小土豆,20231016,全国,全国,382,72,310
655,小土豆,20231017,全国,全国,361,99,262
656,小土豆,20231018,全国,全国,346,85,261
657,小土豆,20231019,全国,全国,364,82,282
658,小土豆,20231020,全国,全国,347,74,273
659,小土豆,20231021,全国,全国,392,85,307
660,小土豆,20231022,全国,全国,366,68,298
661,小土豆,20231023,全国,全国,348,82,266
662,小土豆,20231024,全国,全国,303,74,229
663,小土豆,20231025,全国,全国,272,74,198
664,小土豆,20231026,全国,全国,297,72,225
665,小土豆,20231027,全国,全国,327,68,259
666,小土豆,20231028,全国,全国,363,68,295
667,小土豆,20231029,全国,全国,327,66,261
668,小土豆,20231030,全国,全国,304,83,221
669,小土豆,20231031,全国,全国,318,91,227
670,小土豆,20231101,全国,全国,375,83,292
671,小土豆,20231102,全国,全国,325,101,224
672,小土豆,20231103,全国,全国,369,89,280
673,小土豆,20231104,全国,全国,375,63,312
674,小土豆,20231105,全国,全国,416,76,340
675,小土豆,20231106,全国,全国,358,83,275
676,小土豆,20231107,全国,全国,368,91,277
677,小土豆,20231108,全国,全国,349,87,262
678,小土豆,20231109,全国,全国,377,89,288
679,小土豆,20231110,全国,全国,410,93,317
680,小土豆,20231111,全国,全国,408,70,338
681,小土豆,20231112,全国,全国,490,82,408
682,小土豆,20231113,全国,全国,376,89,287
683,小土豆,20231114,全国,全国,408,74,334
684,小土豆,20231115,全国,全国,361,101,260
685,小土豆,20231116,全国,全国,396,114,282
686,小土豆,20231117,全国,全国,478,101,377
687,小土豆,20231118,全国,全国,418,80,338
688,小土豆,20231119,全国,全国,411,70,341
689,小土豆,20231120,全国,全国,368,91,277
690,小土豆,20231121,全国,全国,428,91,337
691,小土豆,20231122,全国,全国,422,101,321
692,小土豆,20231123,全国,全国,368,108,260
693,小土豆,20231124,全国,全国,432,85,347
694,小土豆,20231125,全国,全国,514,82,432
695,小土豆,20231126,全国,全国,475,68,407
696,小土豆,20231127,全国,全国,448,102,346
697,小土豆,20231128,全国,全国,410,104,306
698,小土豆,20231129,全国,全国,454,110,344
699,小土豆,20231130,全国,全国,472,120,352
700,小土豆,20231201,全国,全国,548,114,434
701,小土豆,20231202,全国,全国,561,83,478
702,小土豆,20231203,全国,全国,555,72,483
703,小土豆,20231204,全国,全国,529,116,413
704,小土豆,20231205,全国,全国,520,106,414
705,小土豆,20231206,全国,全国,579,131,448
706,小土豆,20231207,全国,全国,517,118,399
707,小土豆,20231208,全国,全国,603,135,468
708,小土豆,20231209,全国,全国,566,83,483
709,小土豆,20231210,全国,全国,676,97,579
710,小土豆,20231211,全国,全国,514,152,362
711,小土豆,20231212,全国,全国,435,144,291
712,小土豆,20231213,全国,全国,554,135,419
713,小土豆,20231214,全国,全国,613,127,486
714,小土豆,20231215,全国,全国,674,146,528
715,小土豆,20231216,全国,全国,644,83,561
716,小土豆,20231217,全国,全国,669,101,568
717,小土豆,20231218,全国,全国,766,159,607
718,小土豆,20231219,全国,全国,704,168,536
719,小土豆,20231220,全国,全国,794,173,621
720,小土豆,20231221,全国,全国,956,204,752
721,小土豆,20231222,全国,全国,893,166,727
722,小土豆,20231223,全国,全国,923,112,811
723,小土豆,20231224,全国,全国,978,112,866
724,小土豆,20231225,全国,全国,1265,360,905
725,小土豆,20231226,全国,全国,1313,350,963
726,小土豆,20231227,全国,全国,1447,447,1000
727,小土豆,20231228,全国,全国,1768,628,1140
728,小土豆,20231229,全国,全国,1921,647,1274
729,小土豆,20231230,全国,全国,1943,369,1574
730,小土豆,20231231,全国,全国,2151,459,1692
731,小土豆,20240101,全国,全国,2738,720,2018
732,小土豆,20240102,全国,全国,2840,1064,1776
733,小土豆,20240103,全国,全国,6936,3755,3181
734,小土豆,20240104,全国,全国,6526,2537,3989
735,小土豆,20240105,全国,全国,5834,1908,3926
736,小土豆,20240106,全国,全国,4459,1053,3406
737,小土豆,20240107,全国,全国,3747,685,3062
738,小土豆,20240108,全国,全国,3460,943,2517
739,小土豆,20240109,全国,全国,2572,852,1720
740,小土豆,20240110,全国,全国,2446,842,1604
741,小土豆,20240111,全国,全国,2083,704,1379
742,小土豆,20240112,全国,全国,2423,670,1753
743,小土豆,20240113,全国,全国,2275,375,1900
744,小土豆,20240114,全国,全国,1954,326,1628
745,小土豆,20240115,全国,全国,2020,510,1510
746,小土豆,20240116,全国,全国,2193,603,1590
747,小土豆,20240117,全国,全国,2346,465,1881
748,小土豆,20240118,全国,全国,2207,388,1819
749,小土豆,20240119,全国,全国,2604,374,2230
750,小土豆,20240120,全国,全国,2712,274,2438
751,小土豆,20240121,全国,全国,3252,295,2957
752,小土豆,20240122,全国,全国,3570,555,3015
753,小土豆,20240123,全国,全国,3687,453,3234
754,小土豆,20240124,全国,全国,3808,412,3396
755,小土豆,20240125,全国,全国,3795,344,3451
756,小土豆,20240126,全国,全国,3783,323,3460
757,小土豆,20240127,全国,全国,4492,595,3897
758,小土豆,20240128,全国,全国,5216,552,4664
759,小土豆,20240129,全国,全国,3982,416,3566
760,小土豆,20240130,全国,全国,3900,313,3587
761,小土豆,20240131,全国,全国,4194,310,3884
762,小土豆,20240201,全国,全国,3921,326,3595
763,小土豆,20240202,全国,全国,4585,270,4315
764,小土豆,20240203,全国,全国,4569,307,4262
765,小土豆,20240204,全国,全国,4089,307,3782
766,小土豆,20240205,全国,全国,4235,245,3990
767,小土豆,20240206,全国,全国,4001,256,3745
768,小土豆,20240207,全国,全国,3893,207,3686
769,小土豆,20240208,全国,全国,4082,161,3921
770,小土豆,20240209,全国,全国,4391,144,4247
771,小土豆,20240210,全国,全国,4484,161,4323
772,小土豆,20240211,全国,全国,4561,170,4391
773,小土豆,20240212,全国,全国,3911,140,3771
774,小土豆,20240213,全国,全国,4031,133,3898
775,小土豆,20240214,全国,全国,3696,161,3535
776,小土豆,20240215,全国,全国,3442,144,3298
777,小土豆,20240216,全国,全国,3449,148,3301
778,小土豆,20240217,全国,全国,3130,152,2978
779,小土豆,20240218,全国,全国,3036,236,2800
780,小土豆,20240219,全国,全国,2777,225,2552
781,小土豆,20240220,全国,全国,3038,200,2838
782,小土豆,20240221,全国,全国,2954,226,2728
783,小土豆,20240222,全国,全国,3152,226,2926
784,小土豆,20240223,全国,全国,2587,190,2397
785,小土豆,20240224,全国,全国,3209,168,3041
786,小土豆,20240225,全国,全国,2458,158,2300
787,小土豆,20240226,全国,全国,2613,251,2362
788,小土豆,20240227,全国,全国,2075,225,1850
789,小土豆,20240228,全国,全国,2035,200,1835
790,小土豆,20240229,全国,全国,1896,231,1665
791,小土豆,20240301,全国,全国,1941,195,1746
792,小土豆,20240302,全国,全国,2358,157,2201
793,小土豆,20240303,全国,全国,2165,146,2019
794,小土豆,20240304,全国,全国,1680,190,1490
795,小土豆,20240305,全国,全国,1773,205,1568
796,小土豆,20240306,全国,全国,1529,162,1367
797,小土豆,20240307,全国,全国,1704,190,1514
798,小土豆,20240308,全国,全国,1716,157,1559
799,小土豆,20240309,全国,全国,1891,150,1741
800,小土豆,20240310,全国,全国,1959,137,1822
801,小土豆,20240311,全国,全国,1403,179,1224
802,小土豆,20240312,全国,全国,1458,207,1251
803,小土豆,20240313,全国,全国,1280,173,1107
804,小土豆,20240314,全国,全国,1341,162,1179
805,小土豆,20240315,全国,全国,1498,152,1346
806,小土豆,20240316,全国,全国,1826,140,1686
807,小土豆,20240317,全国,全国,1734,137,1597
808,小土豆,20240318,全国,全国,1248,142,1106
809,小土豆,20240319,全国,全国,1279,139,1140
810,小土豆,20240320,全国,全国,1184,146,1038
811,小土豆,20240321,全国,全国,1335,137,1198
812,小土豆,20240322,全国,全国,1199,146,1053
813,小土豆,20240323,全国,全国,1591,110,1481
814,小土豆,20240324,全国,全国,1658,144,1514
815,小土豆,20240325,全国,全国,1148,157,991
816,小土豆,20240326,全国,全国,1148,148,1000
817,小土豆,20240327,全国,全国,1217,163,1054
818,小土豆,20240328,全国,全国,1130,139,991
819,小土豆,20240329,全国,全国,1111,121,990
820,小土豆,20240330,全国,全国,1424,114,1310
821,小土豆,20240331,全国,全国,1401,112,1289
822,小土豆,20240401,全国,全国,1130,131,999
823,小土豆,20240402,全国,全国,1071,125,946
824,小土豆,20240403,全国,全国,1175,146,1029
825,小土豆,20240404,全国,全国,1556,106,1450
826,小土豆,20240405,全国,全国,1551,95,1456
827,小土豆,20240406,全国,全国,1386,127,1259
828,小土豆,20240407,全国,全国,1078,106,972
829,小土豆,20240408,全国,全国,1088,135,953
830,小土豆,20240409,全国,全国,1101,137,964
831,小土豆,20240410,全国,全国,1112,139,973
832,小土豆,20240411,全国,全国,1051,157,894
833,小土豆,20240412,全国,全国,1134,144,990
834,小土豆,20240413,全国,全国,1352,118,1234
835,小土豆,20240414,全国,全国,1301,133,1168
836,小土豆,20240415,全国,全国,1025,108,917
837,小土豆,20240416,全国,全国,1050,125,925
838,小土豆,20240417,全国,全国,1032,125,907
839,小土豆,20240418,全国,全国,1060,123,937
840,小土豆,20240419,全国,全国,1112,129,983
841,小土豆,20240420,全国,全国,1093,99,994
842,小土豆,20240421,全国,全国,1126,114,1012
843,小土豆,20240422,全国,全国,1020,114,906
844,小土豆,20240423,全国,全国,1060,150,910
845,小土豆,20240424,全国,全国,1009,106,903
846,小土豆,20240425,全国,全国,1061,135,926
847,小土豆,20240426,全国,全国,1052,129,923
848,小土豆,20240427,全国,全国,1211,131,1080
849,小土豆,20240428,全国,全国,1111,166,945
850,小土豆,20240429,全国,全国,984,131,853
851,小土豆,20240430,全国,全国,1082,129,953
1,尔滨,20220101,全国,全国,0,0,0
2,尔滨,20220102,全国,全国,0,0,0
3,尔滨,20220103,全国,全国,0,0,0
4,尔滨,20220104,全国,全国,0,0,0
5,尔滨,20220105,全国,全国,0,0,0
6,尔滨,20220106,全国,全国,0,0,0
7,尔滨,20220107,全国,全国,0,0,0
8,尔滨,20220108,全国,全国,0,0,0
9,尔滨,20220109,全国,全国,0,0,0
10,尔滨,20220110,全国,全国,0,0,0
11,尔滨,20220111,全国,全国,0,0,0
12,尔滨,20220112,全国,全国,0,0,0
13,尔滨,20220113,全国,全国,0,0,0
14,尔滨,20220114,全国,全国,0,0,0
15,尔滨,20220115,全国,全国,0,0,0
16,尔滨,20220116,全国,全国,0,0,0
17,尔滨,20220117,全国,全国,0,0,0
18,尔滨,20220118,全国,全国,0,0,0
19,尔滨,20220119,全国,全国,0,0,0
20,尔滨,20220120,全国,全国,0,0,0
21,尔滨,20220121,全国,全国,0,0,0
22,尔滨,20220122,全国,全国,0,0,0
23,尔滨,20220123,全国,全国,0,0,0
24,尔滨,20220124,全国,全国,0,0,0
25,尔滨,20220125,全国,全国,0,0,0
26,尔滨,20220126,全国,全国,0,0,0
27,尔滨,20220127,全国,全国,0,0,0
28,尔滨,20220128,全国,全国,0,0,0
29,尔滨,20220129,全国,全国,0,0,0
30,尔滨,20220130,全国,全国,0,0,0
31,尔滨,20220131,全国,全国,0,0,0
32,尔滨,20220201,全国,全国,0,0,0
33,尔滨,20220202,全国,全国,0,0,0
34,尔滨,20220203,全国,全国,0,0,0
35,尔滨,20220204,全国,全国,0,0,0
36,尔滨,20220205,全国,全国,0,0,0
37,尔滨,20220206,全国,全国,0,0,0
38,尔滨,20220207,全国,全国,0,0,0
39,尔滨,20220208,全国,全国,0,0,0
40,尔滨,20220209,全国,全国,0,0,0
41,尔滨,20220210,全国,全国,0,0,0
42,尔滨,20220211,全国,全国,0,0,0
43,尔滨,20220212,全国,全国,0,0,0
44,尔滨,20220213,全国,全国,0,0,0
45,尔滨,20220214,全国,全国,0,0,0
46,尔滨,20220215,全国,全国,0,0,0
47,尔滨,20220216,全国,全国,0,0,0
48,尔滨,20220217,全国,全国,0,0,0
49,尔滨,20220218,全国,全国,0,0,0
50,尔滨,20220219,全国,全国,0,0,0
51,尔滨,20220220,全国,全国,0,0,0
52,尔滨,20220221,全国,全国,0,0,0
53,尔滨,20220222,全国,全国,0,0,0
54,尔滨,20220223,全国,全国,0,0,0
55,尔滨,20220224,全国,全国,0,0,0
56,尔滨,20220225,全国,全国,0,0,0
57,尔滨,20220226,全国,全国,0,0,0
58,尔滨,20220227,全国,全国,0,0,0
59,尔滨,20220228,全国,全国,0,0,0
60,尔滨,20220301,全国,全国,0,0,0
61,尔滨,20220302,全国,全国,0,0,0
62,尔滨,20220303,全国,全国,0,0,0
63,尔滨,20220304,全国,全国,0,0,0
64,尔滨,20220305,全国,全国,0,0,0
65,尔滨,20220306,全国,全国,0,0,0
66,尔滨,20220307,全国,全国,0,0,0
67,尔滨,20220308,全国,全国,0,0,0
68,尔滨,20220309,全国,全国,0,0,0
69,尔滨,20220310,全国,全国,0,0,0
70,尔滨,20220311,全国,全国,0,0,0
71,尔滨,20220312,全国,全国,0,0,0
72,尔滨,20220313,全国,全国,0,0,0
73,尔滨,20220314,全国,全国,0,0,0
74,尔滨,20220315,全国,全国,0,0,0
75,尔滨,20220316,全国,全国,0,0,0
76,尔滨,20220317,全国,全国,0,0,0
77,尔滨,20220318,全国,全国,0,0,0
78,尔滨,20220319,全国,全国,0,0,0
79,尔滨,20220320,全国,全国,0,0,0
80,尔滨,20220321,全国,全国,0,0,0
81,尔滨,20220322,全国,全国,0,0,0
82,尔滨,20220323,全国,全国,0,0,0
83,尔滨,20220324,全国,全国,0,0,0
84,尔滨,20220325,全国,全国,0,0,0
85,尔滨,20220326,全国,全国,0,0,0
86,尔滨,20220327,全国,全国,0,0,0
87,尔滨,20220328,全国,全国,0,0,0
88,尔滨,20220329,全国,全国,0,0,0
89,尔滨,20220330,全国,全国,0,0,0
90,尔滨,20220331,全国,全国,0,0,0
91,尔滨,20220401,全国,全国,0,0,0
92,尔滨,20220402,全国,全国,0,0,0
93,尔滨,20220403,全国,全国,0,0,0
94,尔滨,20220404,全国,全国,0,0,0
95,尔滨,20220405,全国,全国,0,0,0
96,尔滨,20220406,全国,全国,0,0,0
97,尔滨,20220407,全国,全国,0,0,0
98,尔滨,20220408,全国,全国,0,0,0
99,尔滨,20220409,全国,全国,0,0,0
100,尔滨,20220410,全国,全国,0,0,0
101,尔滨,20220411,全国,全国,0,0,0
102,尔滨,20220412,全国,全国,0,0,0
103,尔滨,20220413,全国,全国,0,0,0
104,尔滨,20220414,全国,全国,0,0,0
105,尔滨,20220415,全国,全国,0,0,0
106,尔滨,20220416,全国,全国,0,0,0
107,尔滨,20220417,全国,全国,0,0,0
108,尔滨,20220418,全国,全国,0,0,0
109,尔滨,20220419,全国,全国,0,0,0
110,尔滨,20220420,全国,全国,0,0,0
111,尔滨,20220421,全国,全国,0,0,0
112,尔滨,20220422,全国,全国,0,0,0
113,尔滨,20220423,全国,全国,0,0,0
114,尔滨,20220424,全国,全国,0,0,0
115,尔滨,20220425,全国,全国,0,0,0
116,尔滨,20220426,全国,全国,0,0,0
117,尔滨,20220427,全国,全国,0,0,0
118,尔滨,20220428,全国,全国,0,0,0
119,尔滨,20220429,全国,全国,0,0,0
120,尔滨,20220430,全国,全国,0,0,0
121,尔滨,20220501,全国,全国,0,0,0
122,尔滨,20220502,全国,全国,0,0,0
123,尔滨,20220503,全国,全国,0,0,0
124,尔滨,20220504,全国,全国,0,0,0
125,尔滨,20220505,全国,全国,0,0,0
126,尔滨,20220506,全国,全国,0,0,0
127,尔滨,20220507,全国,全国,0,0,0
128,尔滨,20220508,全国,全国,0,0,0
129,尔滨,20220509,全国,全国,0,0,0
130,尔滨,20220510,全国,全国,0,0,0
131,尔滨,20220511,全国,全国,0,0,0
132,尔滨,20220512,全国,全国,0,0,0
133,尔滨,20220513,全国,全国,0,0,0
134,尔滨,20220514,全国,全国,0,0,0
135,尔滨,20220515,全国,全国,0,0,0
136,尔滨,20220516,全国,全国,0,0,0
137,尔滨,20220517,全国,全国,0,0,0
138,尔滨,20220518,全国,全国,0,0,0
139,尔滨,20220519,全国,全国,0,0,0
140,尔滨,20220520,全国,全国,0,0,0
141,尔滨,20220521,全国,全国,0,0,0
142,尔滨,20220522,全国,全国,0,0,0
143,尔滨,20220523,全国,全国,0,0,0
144,尔滨,20220524,全国,全国,0,0,0
145,尔滨,20220525,全国,全国,0,0,0
146,尔滨,20220526,全国,全国,0,0,0
147,尔滨,20220527,全国,全国,0,0,0
148,尔滨,20220528,全国,全国,0,0,0
149,尔滨,20220529,全国,全国,0,0,0
150,尔滨,20220530,全国,全国,0,0,0
151,尔滨,20220531,全国,全国,0,0,0
152,尔滨,20220601,全国,全国,0,0,0
153,尔滨,20220602,全国,全国,0,0,0
154,尔滨,20220603,全国,全国,0,0,0
155,尔滨,20220604,全国,全国,0,0,0
156,尔滨,20220605,全国,全国,0,0,0
157,尔滨,20220606,全国,全国,0,0,0
158,尔滨,20220607,全国,全国,0,0,0
159,尔滨,20220608,全国,全国,0,0,0
160,尔滨,20220609,全国,全国,0,0,0
161,尔滨,20220610,全国,全国,0,0,0
162,尔滨,20220611,全国,全国,0,0,0
163,尔滨,20220612,全国,全国,0,0,0
164,尔滨,20220613,全国,全国,0,0,0
165,尔滨,20220614,全国,全国,0,0,0
166,尔滨,20220615,全国,全国,0,0,0
167,尔滨,20220616,全国,全国,0,0,0
168,尔滨,20220617,全国,全国,0,0,0
169,尔滨,20220618,全国,全国,0,0,0
170,尔滨,20220619,全国,全国,0,0,0
171,尔滨,20220620,全国,全国,0,0,0
172,尔滨,20220621,全国,全国,0,0,0
173,尔滨,20220622,全国,全国,0,0,0
174,尔滨,20220623,全国,全国,0,0,0
175,尔滨,20220624,全国,全国,0,0,0
176,尔滨,20220625,全国,全国,0,0,0
177,尔滨,20220626,全国,全国,0,0,0
178,尔滨,20220627,全国,全国,0,0,0
179,尔滨,20220628,全国,全国,0,0,0
180,尔滨,20220629,全国,全国,0,0,0
181,尔滨,20220630,全国,全国,0,0,0
182,尔滨,20220701,全国,全国,0,0,0
183,尔滨,20220702,全国,全国,0,0,0
184,尔滨,20220703,全国,全国,0,0,0
185,尔滨,20220704,全国,全国,0,0,0
186,尔滨,20220705,全国,全国,0,0,0
187,尔滨,20220706,全国,全国,0,0,0
188,尔滨,20220707,全国,全国,0,0,0
189,尔滨,20220708,全国,全国,0,0,0
190,尔滨,20220709,全国,全国,0,0,0
191,尔滨,20220710,全国,全国,0,0,0
192,尔滨,20220711,全国,全国,0,0,0
193,尔滨,20220712,全国,全国,0,0,0
194,尔滨,20220713,全国,全国,0,0,0
195,尔滨,20220714,全国,全国,0,0,0
196,尔滨,20220715,全国,全国,0,0,0
197,尔滨,20220716,全国,全国,0,0,0
198,尔滨,20220717,全国,全国,0,0,0
199,尔滨,20220718,全国,全国,0,0,0
200,尔滨,20220719,全国,全国,0,0,0
201,尔滨,20220720,全国,全国,0,0,0
202,尔滨,20220721,全国,全国,0,0,0
203,尔滨,20220722,全国,全国,0,0,0
204,尔滨,20220723,全国,全国,0,0,0
205,尔滨,20220724,全国,全国,0,0,0
206,尔滨,20220725,全国,全国,0,0,0
207,尔滨,20220726,全国,全国,0,0,0
208,尔滨,20220727,全国,全国,0,0,0
209,尔滨,20220728,全国,全国,0,0,0
210,尔滨,20220729,全国,全国,0,0,0
211,尔滨,20220730,全国,全国,0,0,0
212,尔滨,20220731,全国,全国,0,0,0
213,尔滨,20220801,全国,全国,0,0,0
214,尔滨,20220802,全国,全国,0,0,0
215,尔滨,20220803,全国,全国,0,0,0
216,尔滨,20220804,全国,全国,0,0,0
217,尔滨,20220805,全国,全国,0,0,0
218,尔滨,20220806,全国,全国,0,0,0
219,尔滨,20220807,全国,全国,0,0,0
220,尔滨,20220808,全国,全国,0,0,0
221,尔滨,20220809,全国,全国,0,0,0
222,尔滨,20220810,全国,全国,0,0,0
223,尔滨,20220811,全国,全国,0,0,0
224,尔滨,20220812,全国,全国,0,0,0
225,尔滨,20220813,全国,全国,0,0,0
226,尔滨,20220814,全国,全国,0,0,0
227,尔滨,20220815,全国,全国,0,0,0
228,尔滨,20220816,全国,全国,0,0,0
229,尔滨,20220817,全国,全国,0,0,0
230,尔滨,20220818,全国,全国,0,0,0
231,尔滨,20220819,全国,全国,0,0,0
232,尔滨,20220820,全国,全国,0,0,0
233,尔滨,20220821,全国,全国,0,0,0
234,尔滨,20220822,全国,全国,0,0,0
235,尔滨,20220823,全国,全国,0,0,0
236,尔滨,20220824,全国,全国,0,0,0
237,尔滨,20220825,全国,全国,0,0,0
238,尔滨,20220826,全国,全国,0,0,0
239,尔滨,20220827,全国,全国,0,0,0
240,尔滨,20220828,全国,全国,0,0,0
241,尔滨,20220829,全国,全国,0,0,0
242,尔滨,20220830,全国,全国,0,0,0
243,尔滨,20220831,全国,全国,0,0,0
244,尔滨,20220901,全国,全国,0,0,0
245,尔滨,20220902,全国,全国,0,0,0
246,尔滨,20220903,全国,全国,0,0,0
247,尔滨,20220904,全国,全国,0,0,0
248,尔滨,20220905,全国,全国,0,0,0
249,尔滨,20220906,全国,全国,0,0,0
250,尔滨,20220907,全国,全国,0,0,0
251,尔滨,20220908,全国,全国,0,0,0
252,尔滨,20220909,全国,全国,0,0,0
253,尔滨,20220910,全国,全国,0,0,0
254,尔滨,20220911,全国,全国,0,0,0
255,尔滨,20220912,全国,全国,0,0,0
256,尔滨,20220913,全国,全国,0,0,0
257,尔滨,20220914,全国,全国,0,0,0
258,尔滨,20220915,全国,全国,0,0,0
259,尔滨,20220916,全国,全国,0,0,0
260,尔滨,20220917,全国,全国,0,0,0
261,尔滨,20220918,全国,全国,0,0,0
262,尔滨,20220919,全国,全国,0,0,0
263,尔滨,20220920,全国,全国,0,0,0
264,尔滨,20220921,全国,全国,0,0,0
265,尔滨,20220922,全国,全国,0,0,0
266,尔滨,20220923,全国,全国,0,0,0
267,尔滨,20220924,全国,全国,0,0,0
268,尔滨,20220925,全国,全国,0,0,0
269,尔滨,20220926,全国,全国,0,0,0
270,尔滨,20220927,全国,全国,0,0,0
271,尔滨,20220928,全国,全国,0,0,0
272,尔滨,20220929,全国,全国,0,0,0
273,尔滨,20220930,全国,全国,0,0,0
274,尔滨,20221001,全国,全国,0,0,0
275,尔滨,20221002,全国,全国,0,0,0
276,尔滨,20221003,全国,全国,0,0,0
277,尔滨,20221004,全国,全国,0,0,0
278,尔滨,20221005,全国,全国,0,0,0
279,尔滨,20221006,全国,全国,0,0,0
280,尔滨,20221007,全国,全国,0,0,0
281,尔滨,20221008,全国,全国,0,0,0
282,尔滨,20221009,全国,全国,0,0,0
283,尔滨,20221010,全国,全国,0,0,0
284,尔滨,20221011,全国,全国,0,0,0
285,尔滨,20221012,全国,全国,0,0,0
286,尔滨,20221013,全国,全国,0,0,0
287,尔滨,20221014,全国,全国,0,0,0
288,尔滨,20221015,全国,全国,0,0,0
289,尔滨,20221016,全国,全国,0,0,0
290,尔滨,20221017,全国,全国,0,0,0
291,尔滨,20221018,全国,全国,0,0,0
292,尔滨,20221019,全国,全国,0,0,0
293,尔滨,20221020,全国,全国,0,0,0
294,尔滨,20221021,全国,全国,0,0,0
295,尔滨,20221022,全国,全国,0,0,0
296,尔滨,20221023,全国,全国,0,0,0
297,尔滨,20221024,全国,全国,0,0,0
298,尔滨,20221025,全国,全国,0,0,0
299,尔滨,20221026,全国,全国,0,0,0
300,尔滨,20221027,全国,全国,0,0,0
301,尔滨,20221028,全国,全国,0,0,0
302,尔滨,20221029,全国,全国,0,0,0
303,尔滨,20221030,全国,全国,0,0,0
304,尔滨,20221031,全国,全国,0,0,0
305,尔滨,20221101,全国,全国,0,0,0
306,尔滨,20221102,全国,全国,0,0,0
307,尔滨,20221103,全国,全国,0,0,0
308,尔滨,20221104,全国,全国,0,0,0
309,尔滨,20221105,全国,全国,0,0,0
310,尔滨,20221106,全国,全国,0,0,0
311,尔滨,20221107,全国,全国,0,0,0
312,尔滨,20221108,全国,全国,0,0,0
313,尔滨,20221109,全国,全国,0,0,0
314,尔滨,20221110,全国,全国,0,0,0
315,尔滨,20221111,全国,全国,0,0,0
316,尔滨,20221112,全国,全国,0,0,0
317,尔滨,20221113,全国,全国,0,0,0
318,尔滨,20221114,全国,全国,0,0,0
319,尔滨,20221115,全国,全国,0,0,0
320,尔滨,20221116,全国,全国,0,0,0
321,尔滨,20221117,全国,全国,0,0,0
322,尔滨,20221118,全国,全国,0,0,0
323,尔滨,20221119,全国,全国,0,0,0
324,尔滨,20221120,全国,全国,0,0,0
325,尔滨,20221121,全国,全国,0,0,0
326,尔滨,20221122,全国,全国,0,0,0
327,尔滨,20221123,全国,全国,0,0,0
328,尔滨,20221124,全国,全国,0,0,0
329,尔滨,20221125,全国,全国,0,0,0
330,尔滨,20221126,全国,全国,0,0,0
331,尔滨,20221127,全国,全国,0,0,0
332,尔滨,20221128,全国,全国,0,0,0
333,尔滨,20221129,全国,全国,0,0,0
334,尔滨,20221130,全国,全国,0,0,0
335,尔滨,20221201,全国,全国,0,0,0
336,尔滨,20221202,全国,全国,0,0,0
337,尔滨,20221203,全国,全国,0,0,0
338,尔滨,20221204,全国,全国,0,0,0
339,尔滨,20221205,全国,全国,0,0,0
340,尔滨,20221206,全国,全国,0,0,0
341,尔滨,20221207,全国,全国,0,0,0
342,尔滨,20221208,全国,全国,0,0,0
343,尔滨,20221209,全国,全国,0,0,0
344,尔滨,20221210,全国,全国,0,0,0
345,尔滨,20221211,全国,全国,0,0,0
346,尔滨,20221212,全国,全国,0,0,0
347,尔滨,20221213,全国,全国,0,0,0
348,尔滨,20221214,全国,全国,0,0,0
349,尔滨,20221215,全国,全国,0,0,0
350,尔滨,20221216,全国,全国,0,0,0
351,尔滨,20221217,全国,全国,0,0,0
352,尔滨,20221218,全国,全国,0,0,0
353,尔滨,20221219,全国,全国,0,0,0
354,尔滨,20221220,全国,全国,0,0,0
355,尔滨,20221221,全国,全国,0,0,0
356,尔滨,20221222,全国,全国,0,0,0
357,尔滨,20221223,全国,全国,0,0,0
358,尔滨,20221224,全国,全国,0,0,0
359,尔滨,20221225,全国,全国,0,0,0
360,尔滨,20221226,全国,全国,0,0,0
361,尔滨,20221227,全国,全国,0,0,0
362,尔滨,20221228,全国,全国,0,0,0
363,尔滨,20221229,全国,全国,0,0,0
364,尔滨,20221230,全国,全国,0,0,0
365,尔滨,20221231,全国,全国,0,0,0
366,尔滨,20230101,全国,全国,0,0,0
367,尔滨,20230102,全国,全国,0,0,0
368,尔滨,20230103,全国,全国,0,0,0
369,尔滨,20230104,全国,全国,0,0,0
370,尔滨,20230105,全国,全国,0,0,0
371,尔滨,20230106,全国,全国,0,0,0
372,尔滨,20230107,全国,全国,0,0,0
373,尔滨,20230108,全国,全国,0,0,0
374,尔滨,20230109,全国,全国,0,0,0
375,尔滨,20230110,全国,全国,0,0,0
376,尔滨,20230111,全国,全国,0,0,0
377,尔滨,20230112,全国,全国,0,0,0
378,尔滨,20230113,全国,全国,0,0,0
379,尔滨,20230114,全国,全国,0,0,0
380,尔滨,20230115,全国,全国,0,0,0
381,尔滨,20230116,全国,全国,0,0,0
382,尔滨,20230117,全国,全国,0,0,0
383,尔滨,20230118,全国,全国,0,0,0
384,尔滨,20230119,全国,全国,0,0,0
385,尔滨,20230120,全国,全国,0,0,0
386,尔滨,20230121,全国,全国,0,0,0
387,尔滨,20230122,全国,全国,0,0,0
388,尔滨,20230123,全国,全国,0,0,0
389,尔滨,20230124,全国,全国,0,0,0
390,尔滨,20230125,全国,全国,0,0,0
391,尔滨,20230126,全国,全国,0,0,0
392,尔滨,20230127,全国,全国,0,0,0
393,尔滨,20230128,全国,全国,0,0,0
394,尔滨,20230129,全国,全国,0,0,0
395,尔滨,20230130,全国,全国,0,0,0
396,尔滨,20230131,全国,全国,0,0,0
397,尔滨,20230201,全国,全国,0,0,0
398,尔滨,20230202,全国,全国,0,0,0
399,尔滨,20230203,全国,全国,0,0,0
400,尔滨,20230204,全国,全国,0,0,0
401,尔滨,20230205,全国,全国,0,0,0
402,尔滨,20230206,全国,全国,0,0,0
403,尔滨,20230207,全国,全国,0,0,0
404,尔滨,20230208,全国,全国,0,0,0
405,尔滨,20230209,全国,全国,0,0,0
406,尔滨,20230210,全国,全国,0,0,0
407,尔滨,20230211,全国,全国,0,0,0
408,尔滨,20230212,全国,全国,0,0,0
409,尔滨,20230213,全国,全国,0,0,0
410,尔滨,20230214,全国,全国,0,0,0
411,尔滨,20230215,全国,全国,0,0,0
412,尔滨,20230216,全国,全国,0,0,0
413,尔滨,20230217,全国,全国,0,0,0
414,尔滨,20230218,全国,全国,0,0,0
415,尔滨,20230219,全国,全国,0,0,0
416,尔滨,20230220,全国,全国,0,0,0
417,尔滨,20230221,全国,全国,0,0,0
418,尔滨,20230222,全国,全国,0,0,0
419,尔滨,20230223,全国,全国,0,0,0
420,尔滨,20230224,全国,全国,0,0,0
421,尔滨,20230225,全国,全国,0,0,0
422,尔滨,20230226,全国,全国,0,0,0
423,尔滨,20230227,全国,全国,0,0,0
424,尔滨,20230228,全国,全国,0,0,0
425,尔滨,20230301,全国,全国,0,0,0
426,尔滨,20230302,全国,全国,0,0,0
427,尔滨,20230303,全国,全国,0,0,0
428,尔滨,20230304,全国,全国,0,0,0
429,尔滨,20230305,全国,全国,0,0,0
430,尔滨,20230306,全国,全国,0,0,0
431,尔滨,20230307,全国,全国,0,0,0
432,尔滨,20230308,全国,全国,0,0,0
433,尔滨,20230309,全国,全国,0,0,0
434,尔滨,20230310,全国,全国,0,0,0
435,尔滨,20230311,全国,全国,0,0,0
436,尔滨,20230312,全国,全国,0,0,0
437,尔滨,20230313,全国,全国,0,0,0
438,尔滨,20230314,全国,全国,0,0,0
439,尔滨,20230315,全国,全国,0,0,0
440,尔滨,20230316,全国,全国,0,0,0
441,尔滨,20230317,全国,全国,0,0,0
442,尔滨,20230318,全国,全国,0,0,0
443,尔滨,20230319,全国,全国,0,0,0
444,尔滨,20230320,全国,全国,0,0,0
445,尔滨,20230321,全国,全国,0,0,0
446,尔滨,20230322,全国,全国,0,0,0
447,尔滨,20230323,全国,全国,0,0,0
448,尔滨,20230324,全国,全国,0,0,0
449,尔滨,20230325,全国,全国,0,0,0
450,尔滨,20230326,全国,全国,0,0,0
451,尔滨,20230327,全国,全国,0,0,0
452,尔滨,20230328,全国,全国,0,0,0
453,尔滨,20230329,全国,全国,0,0,0
454,尔滨,20230330,全国,全国,0,0,0
455,尔滨,20230331,全国,全国,0,0,0
456,尔滨,20230401,全国,全国,0,0,0
457,尔滨,20230402,全国,全国,0,0,0
458,尔滨,20230403,全国,全国,0,0,0
459,尔滨,20230404,全国,全国,0,0,0
460,尔滨,20230405,全国,全国,0,0,0
461,尔滨,20230406,全国,全国,0,0,0
462,尔滨,20230407,全国,全国,0,0,0
463,尔滨,20230408,全国,全国,0,0,0
464,尔滨,20230409,全国,全国,0,0,0
465,尔滨,20230410,全国,全国,0,0,0
466,尔滨,20230411,全国,全国,0,0,0
467,尔滨,20230412,全国,全国,0,0,0
468,尔滨,20230413,全国,全国,0,0,0
469,尔滨,20230414,全国,全国,0,0,0
470,尔滨,20230415,全国,全国,0,0,0
471,尔滨,20230416,全国,全国,0,0,0
472,尔滨,20230417,全国,全国,0,0,0
473,尔滨,20230418,全国,全国,0,0,0
474,尔滨,20230419,全国,全国,0,0,0
475,尔滨,20230420,全国,全国,0,0,0
476,尔滨,20230421,全国,全国,0,0,0
477,尔滨,20230422,全国,全国,0,0,0
478,尔滨,20230423,全国,全国,0,0,0
479,尔滨,20230424,全国,全国,0,0,0
480,尔滨,20230425,全国,全国,0,0,0
481,尔滨,20230426,全国,全国,0,0,0
482,尔滨,20230427,全国,全国,0,0,0
483,尔滨,20230428,全国,全国,0,0,0
484,尔滨,20230429,全国,全国,0,0,0
485,尔滨,20230430,全国,全国,0,0,0
486,尔滨,20230501,全国,全国,0,0,0
487,尔滨,20230502,全国,全国,0,0,0
488,尔滨,20230503,全国,全国,0,0,0
489,尔滨,20230504,全国,全国,0,0,0
490,尔滨,20230505,全国,全国,0,0,0
491,尔滨,20230506,全国,全国,0,0,0
492,尔滨,20230507,全国,全国,0,0,0
493,尔滨,20230508,全国,全国,0,0,0
494,尔滨,20230509,全国,全国,0,0,0
495,尔滨,20230510,全国,全国,0,0,0
496,尔滨,20230511,全国,全国,0,0,0
497,尔滨,20230512,全国,全国,0,0,0
498,尔滨,20230513,全国,全国,0,0,0
499,尔滨,20230514,全国,全国,0,0,0
500,尔滨,20230515,全国,全国,0,0,0
501,尔滨,20230516,全国,全国,0,0,0
502,尔滨,20230517,全国,全国,0,0,0
503,尔滨,20230518,全国,全国,0,0,0
504,尔滨,20230519,全国,全国,0,0,0
505,尔滨,20230520,全国,全国,0,0,0
506,尔滨,20230521,全国,全国,0,0,0
507,尔滨,20230522,全国,全国,0,0,0
508,尔滨,20230523,全国,全国,0,0,0
509,尔滨,20230524,全国,全国,0,0,0
510,尔滨,20230525,全国,全国,0,0,0
511,尔滨,20230526,全国,全国,0,0,0
512,尔滨,20230527,全国,全国,0,0,0
513,尔滨,20230528,全国,全国,0,0,0
514,尔滨,20230529,全国,全国,0,0,0
515,尔滨,20230530,全国,全国,0,0,0
516,尔滨,20230531,全国,全国,0,0,0
517,尔滨,20230601,全国,全国,0,0,0
518,尔滨,20230602,全国,全国,0,0,0
519,尔滨,20230603,全国,全国,0,0,0
520,尔滨,20230604,全国,全国,0,0,0
521,尔滨,20230605,全国,全国,0,0,0
522,尔滨,20230606,全国,全国,0,0,0
523,尔滨,20230607,全国,全国,0,0,0
524,尔滨,20230608,全国,全国,0,0,0
525,尔滨,20230609,全国,全国,0,0,0
526,尔滨,20230610,全国,全国,0,0,0
527,尔滨,20230611,全国,全国,0,0,0
528,尔滨,20230612,全国,全国,0,0,0
529,尔滨,20230613,全国,全国,0,0,0
530,尔滨,20230614,全国,全国,0,0,0
531,尔滨,20230615,全国,全国,0,0,0
532,尔滨,20230616,全国,全国,0,0,0
533,尔滨,20230617,全国,全国,0,0,0
534,尔滨,20230618,全国,全国,0,0,0
535,尔滨,20230619,全国,全国,0,0,0
536,尔滨,20230620,全国,全国,0,0,0
537,尔滨,20230621,全国,全国,0,0,0
538,尔滨,20230622,全国,全国,0,0,0
539,尔滨,20230623,全国,全国,0,0,0
540,尔滨,20230624,全国,全国,0,0,0
541,尔滨,20230625,全国,全国,0,0,0
542,尔滨,20230626,全国,全国,0,0,0
543,尔滨,20230627,全国,全国,0,0,0
544,尔滨,20230628,全国,全国,0,0,0
545,尔滨,20230629,全国,全国,0,0,0
546,尔滨,20230630,全国,全国,0,0,0
547,尔滨,20230701,全国,全国,0,0,0
548,尔滨,20230702,全国,全国,0,0,0
549,尔滨,20230703,全国,全国,0,0,0
550,尔滨,20230704,全国,全国,0,0,0
551,尔滨,20230705,全国,全国,0,0,0
552,尔滨,20230706,全国,全国,0,0,0
553,尔滨,20230707,全国,全国,0,0,0
554,尔滨,20230708,全国,全国,0,0,0
555,尔滨,20230709,全国,全国,0,0,0
556,尔滨,20230710,全国,全国,0,0,0
557,尔滨,20230711,全国,全国,0,0,0
558,尔滨,20230712,全国,全国,0,0,0
559,尔滨,20230713,全国,全国,0,0,0
560,尔滨,20230714,全国,全国,0,0,0
561,尔滨,20230715,全国,全国,0,0,0
562,尔滨,20230716,全国,全国,0,0,0
563,尔滨,20230717,全国,全国,0,0,0
564,尔滨,20230718,全国,全国,0,0,0
565,尔滨,20230719,全国,全国,0,0,0
566,尔滨,20230720,全国,全国,0,0,0
567,尔滨,20230721,全国,全国,0,0,0
568,尔滨,20230722,全国,全国,0,0,0
569,尔滨,20230723,全国,全国,0,0,0
570,尔滨,20230724,全国,全国,0,0,0
571,尔滨,20230725,全国,全国,0,0,0
572,尔滨,20230726,全国,全国,0,0,0
573,尔滨,20230727,全国,全国,0,0,0
574,尔滨,20230728,全国,全国,0,0,0
575,尔滨,20230729,全国,全国,0,0,0
576,尔滨,20230730,全国,全国,0,0,0
577,尔滨,20230731,全国,全国,0,0,0
578,尔滨,20230801,全国,全国,0,0,0
579,尔滨,20230802,全国,全国,0,0,0
580,尔滨,20230803,全国,全国,0,0,0
581,尔滨,20230804,全国,全国,0,0,0
582,尔滨,20230805,全国,全国,0,0,0
583,尔滨,20230806,全国,全国,0,0,0
584,尔滨,20230807,全国,全国,0,0,0
585,尔滨,20230808,全国,全国,0,0,0
586,尔滨,20230809,全国,全国,0,0,0
587,尔滨,20230810,全国,全国,0,0,0
588,尔滨,20230811,全国,全国,0,0,0
589,尔滨,20230812,全国,全国,0,0,0
590,尔滨,20230813,全国,全国,0,0,0
591,尔滨,20230814,全国,全国,0,0,0
592,尔滨,20230815,全国,全国,0,0,0
593,尔滨,20230816,全国,全国,0,0,0
594,尔滨,20230817,全国,全国,0,0,0
595,尔滨,20230818,全国,全国,0,0,0
596,尔滨,20230819,全国,全国,0,0,0
597,尔滨,20230820,全国,全国,0,0,0
598,尔滨,20230821,全国,全国,0,0,0
599,尔滨,20230822,全国,全国,0,0,0
600,尔滨,20230823,全国,全国,0,0,0
601,尔滨,20230824,全国,全国,0,0,0
602,尔滨,20230825,全国,全国,0,0,0
603,尔滨,20230826,全国,全国,0,0,0
604,尔滨,20230827,全国,全国,0,0,0
605,尔滨,20230828,全国,全国,0,0,0
606,尔滨,20230829,全国,全国,0,0,0
607,尔滨,20230830,全国,全国,0,0,0
608,尔滨,20230831,全国,全国,0,0,0
609,尔滨,20230901,全国,全国,0,0,0
610,尔滨,20230902,全国,全国,0,0,0
611,尔滨,20230903,全国,全国,0,0,0
612,尔滨,20230904,全国,全国,0,0,0
613,尔滨,20230905,全国,全国,0,0,0
614,尔滨,20230906,全国,全国,0,0,0
615,尔滨,20230907,全国,全国,0,0,0
616,尔滨,20230908,全国,全国,0,0,0
617,尔滨,20230909,全国,全国,0,0,0
618,尔滨,20230910,全国,全国,0,0,0
619,尔滨,20230911,全国,全国,0,0,0
620,尔滨,20230912,全国,全国,0,0,0
621,尔滨,20230913,全国,全国,0,0,0
622,尔滨,20230914,全国,全国,0,0,0
623,尔滨,20230915,全国,全国,0,0,0
624,尔滨,20230916,全国,全国,0,0,0
625,尔滨,20230917,全国,全国,0,0,0
626,尔滨,20230918,全国,全国,0,0,0
627,尔滨,20230919,全国,全国,0,0,0
628,尔滨,20230920,全国,全国,0,0,0
629,尔滨,20230921,全国,全国,0,0,0
630,尔滨,20230922,全国,全国,0,0,0
631,尔滨,20230923,全国,全国,0,0,0
632,尔滨,20230924,全国,全国,0,0,0
633,尔滨,20230925,全国,全国,0,0,0
634,尔滨,20230926,全国,全国,0,0,0
635,尔滨,20230927,全国,全国,0,0,0
636,尔滨,20230928,全国,全国,0,0,0
637,尔滨,20230929,全国,全国,0,0,0
638,尔滨,20230930,全国,全国,0,0,0
639,尔滨,20231001,全国,全国,0,0,0
640,尔滨,20231002,全国,全国,0,0,0
641,尔滨,20231003,全国,全国,0,0,0
642,尔滨,20231004,全国,全国,0,0,0
643,尔滨,20231005,全国,全国,0,0,0
644,尔滨,20231006,全国,全国,0,0,0
645,尔滨,20231007,全国,全国,0,0,0
646,尔滨,20231008,全国,全国,0,0,0
647,尔滨,20231009,全国,全国,0,0,0
648,尔滨,20231010,全国,全国,0,0,0
649,尔滨,20231011,全国,全国,0,0,0
650,尔滨,20231012,全国,全国,0,0,0
651,尔滨,20231013,全国,全国,0,0,0
652,尔滨,20231014,全国,全国,0,0,0
653,尔滨,20231015,全国,全国,0,0,0
654,尔滨,20231016,全国,全国,0,0,0
655,尔滨,20231017,全国,全国,0,0,0
656,尔滨,20231018,全国,全国,0,0,0
657,尔滨,20231019,全国,全国,0,0,0
658,尔滨,20231020,全国,全国,0,0,0
659,尔滨,20231021,全国,全国,0,0,0
660,尔滨,20231022,全国,全国,0,0,0
661,尔滨,20231023,全国,全国,0,0,0
662,尔滨,20231024,全国,全国,0,0,0
663,尔滨,20231025,全国,全国,0,0,0
664,尔滨,20231026,全国,全国,0,0,0
665,尔滨,20231027,全国,全国,0,0,0
666,尔滨,20231028,全国,全国,0,0,0
667,尔滨,20231029,全国,全国,0,0,0
668,尔滨,20231030,全国,全国,0,0,0
669,尔滨,20231031,全国,全国,0,0,0
670,尔滨,20231101,全国,全国,0,0,0
671,尔滨,20231102,全国,全国,0,0,0
672,尔滨,20231103,全国,全国,0,0,0
673,尔滨,20231104,全国,全国,0,0,0
674,尔滨,20231105,全国,全国,0,0,0
675,尔滨,20231106,全国,全国,0,0,0
676,尔滨,20231107,全国,全国,0,0,0
677,尔滨,20231108,全国,全国,0,0,0
678,尔滨,20231109,全国,全国,0,0,0
679,尔滨,20231110,全国,全国,0,0,0
680,尔滨,20231111,全国,全国,0,0,0
681,尔滨,20231112,全国,全国,0,0,0
682,尔滨,20231113,全国,全国,0,0,0
683,尔滨,20231114,全国,全国,0,0,0
684,尔滨,20231115,全国,全国,0,0,0
685,尔滨,20231116,全国,全国,0,0,0
686,尔滨,20231117,全国,全国,0,0,0
687,尔滨,20231118,全国,全国,0,0,0
688,尔滨,20231119,全国,全国,0,0,0
689,尔滨,20231120,全国,全国,0,0,0
690,尔滨,20231121,全国,全国,0,0,0
691,尔滨,20231122,全国,全国,0,0,0
692,尔滨,20231123,全国,全国,0,0,0
693,尔滨,20231124,全国,全国,0,0,0
694,尔滨,20231125,全国,全国,0,0,0
695,尔滨,20231126,全国,全国,0,0,0
696,尔滨,20231127,全国,全国,0,0,0
697,尔滨,20231128,全国,全国,0,0,0
698,尔滨,20231129,全国,全国,0,0,0
699,尔滨,20231130,全国,全国,0,0,0
700,尔滨,20231201,全国,全国,0,0,0
701,尔滨,20231202,全国,全国,0,0,0
702,尔滨,20231203,全国,全国,0,0,0
703,尔滨,20231204,全国,全国,0,0,0
704,尔滨,20231205,全国,全国,0,0,0
705,尔滨,20231206,全国,全国,0,0,0
706,尔滨,20231207,全国,全国,0,0,0
707,尔滨,20231208,全国,全国,0,0,0
708,尔滨,20231209,全国,全国,0,0,0
709,尔滨,20231210,全国,全国,0,0,0
710,尔滨,20231211,全国,全国,0,0,0
711,尔滨,20231212,全国,全国,0,0,0
712,尔滨,20231213,全国,全国,0,0,0
713,尔滨,20231214,全国,全国,0,0,0
714,尔滨,20231215,全国,全国,0,0,0
715,尔滨,20231216,全国,全国,0,0,0
716,尔滨,20231217,全国,全国,0,0,0
717,尔滨,20231218,全国,全国,0,0,0
718,尔滨,20231219,全国,全国,0,0,0
719,尔滨,20231220,全国,全国,0,0,0
720,尔滨,20231221,全国,全国,0,0,0
721,尔滨,20231222,全国,全国,0,0,0
722,尔滨,20231223,全国,全国,0,0,0
723,尔滨,20231224,全国,全国,0,0,0
724,尔滨,20231225,全国,全国,0,0,0
725,尔滨,20231226,全国,全国,0,0,0
726,尔滨,20231227,全国,全国,0,0,0
727,尔滨,20231228,全国,全国,0,0,0
728,尔滨,20231229,全国,全国,0,0,0
729,尔滨,20231230,全国,全国,0,0,0
730,尔滨,20231231,全国,全国,0,0,0
731,尔滨,20240101,全国,全国,0,0,0
732,尔滨,20240102,全国,全国,0,0,0
733,尔滨,20240103,全国,全国,0,0,0
734,尔滨,20240104,全国,全国,0,0,0
735,尔滨,20240105,全国,全国,2746,928,1818
736,尔滨,20240106,全国,全国,0,0,0
737,尔滨,20240107,全国,全国,1902,412,1490
738,尔滨,20240108,全国,全国,1673,456,1217
739,尔滨,20240109,全国,全国,1874,894,980
740,尔滨,20240110,全国,全国,1811,889,922
741,尔滨,20240111,全国,全国,2306,1380,926
742,尔滨,20240112,全国,全国,2269,1165,1104
743,尔滨,20240113,全国,全国,1588,642,946
744,尔滨,20240114,全国,全国,1270,372,898
745,尔滨,20240115,全国,全国,1628,749,879
746,尔滨,20240116,全国,全国,1736,884,852
747,尔滨,20240117,全国,全国,1423,605,818
748,尔滨,20240118,全国,全国,1213,473,740
749,尔滨,20240119,全国,全国,1350,564,786
750,尔滨,20240120,全国,全国,855,204,651
751,尔滨,20240121,全国,全国,1190,349,841
752,尔滨,20240122,全国,全国,1126,428,698
753,尔滨,20240123,全国,全国,1061,388,673
754,尔滨,20240124,全国,全国,861,316,545
755,尔滨,20240125,全国,全国,783,265,518
756,尔滨,20240126,全国,全国,734,251,483
757,尔滨,20240127,全国,全国,671,184,487
758,尔滨,20240128,全国,全国,620,172,448
759,尔滨,20240129,全国,全国,654,270,384
760,尔滨,20240130,全国,全国,759,293,466
761,尔滨,20240131,全国,全国,669,260,409
762,尔滨,20240201,全国,全国,585,223,362
763,尔滨,20240202,全国,全国,527,187,340
764,尔滨,20240203,全国,全国,648,253,395
765,尔滨,20240204,全国,全国,621,226,395
766,尔滨,20240205,全国,全国,486,172,314
767,尔滨,20240206,全国,全国,541,169,372
768,尔滨,20240207,全国,全国,396,133,263
769,尔滨,20240208,全国,全国,368,101,267
770,尔滨,20240209,全国,全国,376,78,298
771,尔滨,20240210,全国,全国,350,70,280
772,尔滨,20240211,全国,全国,334,72,262
773,尔滨,20240212,全国,全国,358,70,288
774,尔滨,20240213,全国,全国,383,91,292
775,尔滨,20240214,全国,全国,372,91,281
776,尔滨,20240215,全国,全国,429,108,321
777,尔滨,20240216,全国,全国,384,102,282
778,尔滨,20240217,全国,全国,417,129,288
779,尔滨,20240218,全国,全国,457,180,277
780,尔滨,20240219,全国,全国,440,179,261
781,尔滨,20240220,全国,全国,386,169,217
782,尔滨,20240221,全国,全国,332,121,211
783,尔滨,20240222,全国,全国,343,169,174
784,尔滨,20240223,全国,全国,348,144,204
785,尔滨,20240224,全国,全国,296,97,199
786,尔滨,20240225,全国,全国,264,101,163
787,尔滨,20240226,全国,全国,631,349,282
788,尔滨,20240227,全国,全国,430,218,212
789,尔滨,20240228,全国,全国,343,157,186
790,尔滨,20240229,全国,全国,278,127,151
791,尔滨,20240301,全国,全国,248,97,151
792,尔滨,20240302,全国,全国,233,85,148
793,尔滨,20240303,全国,全国,225,95,130
794,尔滨,20240304,全国,全国,282,116,166
795,尔滨,20240305,全国,全国,239,121,118
796,尔滨,20240306,全国,全国,262,127,135
797,尔滨,20240307,全国,全国,322,144,178
798,尔滨,20240308,全国,全国,230,102,128
799,尔滨,20240309,全国,全国,185,76,109
800,尔滨,20240310,全国,全国,201,76,125
801,尔滨,20240311,全国,全国,221,104,117
802,尔滨,20240312,全国,全国,239,129,110
803,尔滨,20240313,全国,全国,219,91,128
804,尔滨,20240314,全国,全国,241,123,118
805,尔滨,20240315,全国,全国,253,106,147
806,尔滨,20240316,全国,全国,227,78,149
807,尔滨,20240317,全国,全国,210,78,132
808,尔滨,20240318,全国,全国,249,127,122
809,尔滨,20240319,全国,全国,243,120,123
810,尔滨,20240320,全国,全国,208,104,104
811,尔滨,20240321,全国,全国,210,110,100
812,尔滨,20240322,全国,全国,186,99,87
813,尔滨,20240323,全国,全国,179,80,99
814,尔滨,20240324,全国,全国,214,82,132
815,尔滨,20240325,全国,全国,186,89,97
816,尔滨,20240326,全国,全国,218,106,112
817,尔滨,20240327,全国,全国,217,95,122
818,尔滨,20240328,全国,全国,198,102,96
819,尔滨,20240329,全国,全国,186,78,108
820,尔滨,20240330,全国,全国,178,76,102
821,尔滨,20240331,全国,全国,160,68,92
822,尔滨,20240401,全国,全国,194,95,99
823,尔滨,20240402,全国,全国,192,101,91
824,尔滨,20240403,全国,全国,177,80,97
825,尔滨,20240404,全国,全国,163,68,95
826,尔滨,20240405,全国,全国,163,66,97
827,尔滨,20240406,全国,全国,177,82,95
828,尔滨,20240407,全国,全国,209,104,105
829,尔滨,20240408,全国,全国,185,89,96
830,尔滨,20240409,全国,全国,194,99,95
831,尔滨,20240410,全国,全国,190,99,91
832,尔滨,20240411,全国,全国,177,93,84
833,尔滨,20240412,全国,全国,177,93,84
834,尔滨,20240413,全国,全国,171,76,95
835,尔滨,20240414,全国,全国,177,82,95
836,尔滨,20240415,全国,全国,181,97,84
837,尔滨,20240416,全国,全国,195,87,108
838,尔滨,20240417,全国,全国,193,101,92
839,尔滨,20240418,全国,全国,180,85,95
840,尔滨,20240419,全国,全国,170,74,96
841,尔滨,20240420,全国,全国,167,80,87
842,尔滨,20240421,全国,全国,195,83,112
843,尔滨,20240422,全国,全国,182,83,99
844,尔滨,20240423,全国,全国,175,97,78
845,尔滨,20240424,全国,全国,179,82,97
846,尔滨,20240425,全国,全国,174,85,89
847,尔滨,20240426,全国,全国,179,87,92
848,尔滨,20240427,全国,全国,175,66,109
849,尔滨,20240428,全国,全国,194,95,99
850,尔滨,20240429,全国,全国,158,78,80
851,尔滨,20240430,全国,全国,163,76,87
1,冰雪大世界,20220101,全国,全国,1027,114,913
2,冰雪大世界,20220102,全国,全国,993,129,864
3,冰雪大世界,20220103,全国,全国,986,142,844
4,冰雪大世界,20220104,全国,全国,1035,193,842
5,冰雪大世界,20220105,全国,全国,966,166,800
6,冰雪大世界,20220106,全国,全国,956,176,780
7,冰雪大世界,20220107,全国,全国,845,162,683
8,冰雪大世界,20220108,全国,全国,879,97,782
9,冰雪大世界,20220109,全国,全国,849,114,735
10,冰雪大世界,20220110,全国,全国,847,163,684
11,冰雪大世界,20220111,全国,全国,776,148,628
12,冰雪大世界,20220112,全国,全国,754,157,597
13,冰雪大世界,20220113,全国,全国,836,170,666
14,冰雪大世界,20220114,全国,全国,826,168,658
15,冰雪大世界,20220115,全国,全国,790,95,695
16,冰雪大世界,20220116,全国,全国,730,102,628
17,冰雪大世界,20220117,全国,全国,712,172,540
18,冰雪大世界,20220118,全国,全国,680,127,553
19,冰雪大世界,20220119,全国,全国,600,129,471
20,冰雪大世界,20220120,全国,全国,655,159,496
21,冰雪大世界,20220121,全国,全国,727,118,609
22,冰雪大世界,20220122,全国,全国,727,118,609
23,冰雪大世界,20220123,全国,全国,715,95,620
24,冰雪大世界,20220124,全国,全国,654,108,546
25,冰雪大世界,20220125,全国,全国,617,110,507
26,冰雪大世界,20220126,全国,全国,656,125,531
27,冰雪大世界,20220127,全国,全国,655,131,524
28,冰雪大世界,20220128,全国,全国,690,152,538
29,冰雪大世界,20220129,全国,全国,696,125,571
30,冰雪大世界,20220130,全国,全国,568,93,475
31,冰雪大世界,20220131,全国,全国,592,70,522
32,冰雪大世界,20220201,全国,全国,898,91,807
33,冰雪大世界,20220202,全国,全国,974,106,868
34,冰雪大世界,20220203,全国,全国,965,85,880
35,冰雪大世界,20220204,全国,全国,983,91,892
36,冰雪大世界,20220205,全国,全国,975,106,869
37,冰雪大世界,20220206,全国,全国,938,97,841
38,冰雪大世界,20220207,全国,全国,918,166,752
39,冰雪大世界,20220208,全国,全国,855,150,705
40,冰雪大世界,20220209,全国,全国,757,150,607
41,冰雪大世界,20220210,全国,全国,813,161,652
42,冰雪大世界,20220211,全国,全国,794,157,637
43,冰雪大世界,20220212,全国,全国,747,104,643
44,冰雪大世界,20220213,全国,全国,776,106,670
45,冰雪大世界,20220214,全国,全国,742,165,577
46,冰雪大世界,20220215,全国,全国,842,161,681
47,冰雪大世界,20220216,全国,全国,631,121,510
48,冰雪大世界,20220217,全国,全国,627,154,473
49,冰雪大世界,20220218,全国,全国,647,151,496
50,冰雪大世界,20220219,全国,全国,604,99,505
51,冰雪大世界,20220220,全国,全国,633,93,540
52,冰雪大世界,20220221,全国,全国,544,137,407
53,冰雪大世界,20220222,全国,全国,553,139,414
54,冰雪大世界,20220223,全国,全国,573,123,450
55,冰雪大世界,20220224,全国,全国,623,133,490
56,冰雪大世界,20220225,全国,全国,576,118,458
57,冰雪大世界,20220226,全国,全国,572,83,489
58,冰雪大世界,20220227,全国,全国,531,83,448
59,冰雪大世界,20220228,全国,全国,430,99,331
60,冰雪大世界,20220301,全国,全国,356,120,236
61,冰雪大世界,20220302,全国,全国,314,99,215
62,冰雪大世界,20220303,全国,全国,295,87,208
63,冰雪大世界,20220304,全国,全国,287,95,192
64,冰雪大世界,20220305,全国,全国,312,93,219
65,冰雪大世界,20220306,全国,全国,300,68,232
66,冰雪大世界,20220307,全国,全国,290,95,195
67,冰雪大世界,20220308,全国,全国,296,91,205
68,冰雪大世界,20220309,全国,全国,278,97,181
69,冰雪大世界,20220310,全国,全国,271,87,184
70,冰雪大世界,20220311,全国,全国,285,104,181
71,冰雪大世界,20220312,全国,全国,259,76,183
72,冰雪大世界,20220313,全国,全国,265,70,195
73,冰雪大世界,20220314,全国,全国,241,83,158
74,冰雪大世界,20220315,全国,全国,282,102,180
75,冰雪大世界,20220316,全国,全国,243,91,152
76,冰雪大世界,20220317,全国,全国,291,102,189
77,冰雪大世界,20220318,全国,全国,272,99,173
78,冰雪大世界,20220319,全国,全国,264,87,177
79,冰雪大世界,20220320,全国,全国,244,76,168
80,冰雪大世界,20220321,全国,全国,248,80,168
81,冰雪大世界,20220322,全国,全国,276,91,185
82,冰雪大世界,20220323,全国,全国,271,74,197
83,冰雪大世界,20220324,全国,全国,246,85,161
84,冰雪大世界,20220325,全国,全国,254,91,163
85,冰雪大世界,20220326,全国,全国,254,83,171
86,冰雪大世界,20220327,全国,全国,261,78,183
87,冰雪大世界,20220328,全国,全国,233,82,151
88,冰雪大世界,20220329,全国,全国,236,93,143
89,冰雪大世界,20220330,全国,全国,248,78,170
90,冰雪大世界,20220331,全国,全国,246,89,157
91,冰雪大世界,20220401,全国,全国,225,76,149
92,冰雪大世界,20220402,全国,全国,198,64,134
93,冰雪大世界,20220403,全国,全国,217,72,145
94,冰雪大世界,20220404,全国,全国,226,66,160
95,冰雪大世界,20220405,全国,全国,224,70,154
96,冰雪大世界,20220406,全国,全国,241,82,159
97,冰雪大世界,20220407,全国,全国,242,87,155
98,冰雪大世界,20220408,全国,全国,227,72,155
99,冰雪大世界,20220409,全国,全国,250,74,176
100,冰雪大世界,20220410,全国,全国,252,70,182
101,冰雪大世界,20220411,全国,全国,224,76,148
102,冰雪大世界,20220412,全国,全国,240,80,160
103,冰雪大世界,20220413,全国,全国,225,74,151
104,冰雪大世界,20220414,全国,全国,235,68,167
105,冰雪大世界,20220415,全国,全国,229,70,159
106,冰雪大世界,20220416,全国,全国,257,74,183
107,冰雪大世界,20220417,全国,全国,255,70,185
108,冰雪大世界,20220418,全国,全国,236,72,164
109,冰雪大世界,20220419,全国,全国,247,89,158
110,冰雪大世界,20220420,全国,全国,253,102,151
111,冰雪大世界,20220421,全国,全国,254,80,174
112,冰雪大世界,20220422,全国,全国,260,93,167
113,冰雪大世界,20220423,全国,全国,240,66,174
114,冰雪大世界,20220424,全国,全国,248,78,170
115,冰雪大世界,20220425,全国,全国,238,83,155
116,冰雪大世界,20220426,全国,全国,263,83,180
117,冰雪大世界,20220427,全国,全国,254,80,174
118,冰雪大世界,20220428,全国,全国,236,63,173
119,冰雪大世界,20220429,全国,全国,223,72,151
120,冰雪大世界,20220430,全国,全国,234,63,171
121,冰雪大世界,20220501,全国,全国,231,63,168
122,冰雪大世界,20220502,全国,全国,247,68,179
123,冰雪大世界,20220503,全国,全国,236,66,170
124,冰雪大世界,20220504,全国,全国,263,74,189
125,冰雪大世界,20220505,全国,全国,206,74,132
126,冰雪大世界,20220506,全国,全国,223,74,149
127,冰雪大世界,20220507,全国,全国,221,72,149
128,冰雪大世界,20220508,全国,全国,228,63,165
129,冰雪大世界,20220509,全国,全国,255,101,154
130,冰雪大世界,20220510,全国,全国,243,85,158
131,冰雪大世界,20220511,全国,全国,240,82,158
132,冰雪大世界,20220512,全国,全国,238,87,151
133,冰雪大世界,20220513,全国,全国,241,82,159
134,冰雪大世界,20220514,全国,全国,261,76,185
135,冰雪大世界,20220515,全国,全国,240,66,174
136,冰雪大世界,20220516,全国,全国,235,80,155
137,冰雪大世界,20220517,全国,全国,242,87,155
138,冰雪大世界,20220518,全国,全国,247,80,167
139,冰雪大世界,20220519,全国,全国,219,78,141
140,冰雪大世界,20220520,全国,全国,222,70,152
141,冰雪大世界,20220521,全国,全国,215,68,147
142,冰雪大世界,20220522,全国,全国,258,74,184
143,冰雪大世界,20220523,全国,全国,245,78,167
144,冰雪大世界,20220524,全国,全国,244,83,161
145,冰雪大世界,20220525,全国,全国,253,76,177
146,冰雪大世界,20220526,全国,全国,258,95,163
147,冰雪大世界,20220527,全国,全国,229,78,151
148,冰雪大世界,20220528,全国,全国,231,72,159
149,冰雪大世界,20220529,全国,全国,242,74,168
150,冰雪大世界,20220530,全国,全国,249,85,164
151,冰雪大世界,20220531,全国,全国,231,76,155
152,冰雪大世界,20220601,全国,全国,259,89,170
153,冰雪大世界,20220602,全国,全国,225,74,151
154,冰雪大世界,20220603,全国,全国,257,72,185
155,冰雪大世界,20220604,全国,全国,259,72,187
156,冰雪大世界,20220605,全国,全国,258,80,178
157,冰雪大世界,20220606,全国,全国,227,83,144
158,冰雪大世界,20220607,全国,全国,264,97,167
159,冰雪大世界,20220608,全国,全国,268,83,185
160,冰雪大世界,20220609,全国,全国,8154,2423,5731
161,冰雪大世界,20220610,全国,全国,2467,831,1636
162,冰雪大世界,20220611,全国,全国,685,108,577
163,冰雪大世界,20220612,全国,全国,390,89,301
164,冰雪大世界,20220613,全国,全国,465,131,334
165,冰雪大世界,20220614,全国,全国,365,101,264
166,冰雪大世界,20220615,全国,全国,281,83,198
167,冰雪大世界,20220616,全国,全国,288,95,193
168,冰雪大世界,20220617,全国,全国,288,99,189
169,冰雪大世界,20220618,全国,全国,281,63,218
170,冰雪大世界,20220619,全国,全国,282,70,212
171,冰雪大世界,20220620,全国,全国,253,83,170
172,冰雪大世界,20220621,全国,全国,283,83,200
173,冰雪大世界,20220622,全国,全国,272,85,187
174,冰雪大世界,20220623,全国,全国,284,78,206
175,冰雪大世界,20220624,全国,全国,265,80,185
176,冰雪大世界,20220625,全国,全国,238,64,174
177,冰雪大世界,20220626,全国,全国,235,78,157
178,冰雪大世界,20220627,全国,全国,280,102,178
179,冰雪大世界,20220628,全国,全国,282,93,189
180,冰雪大世界,20220629,全国,全国,279,112,167
181,冰雪大世界,20220630,全国,全国,253,82,171
182,冰雪大世界,20220701,全国,全国,284,89,195
183,冰雪大世界,20220702,全国,全国,259,70,189
184,冰雪大世界,20220703,全国,全国,290,85,205
185,冰雪大世界,20220704,全国,全国,264,87,177
186,冰雪大世界,20220705,全国,全国,268,101,167
187,冰雪大世界,20220706,全国,全国,253,76,177
188,冰雪大世界,20220707,全国,全国,270,97,173
189,冰雪大世界,20220708,全国,全国,259,85,174
190,冰雪大世界,20220709,全国,全国,270,70,200
191,冰雪大世界,20220710,全国,全国,263,64,199
192,冰雪大世界,20220711,全国,全国,266,82,184
193,冰雪大世界,20220712,全国,全国,284,95,189
194,冰雪大世界,20220713,全国,全国,267,87,180
195,冰雪大世界,20220714,全国,全国,272,87,185
196,冰雪大世界,20220715,全国,全国,262,72,190
197,冰雪大世界,20220716,全国,全国,251,80,171
198,冰雪大世界,20220717,全国,全国,286,80,206
199,冰雪大世界,20220718,全国,全国,284,104,180
200,冰雪大世界,20220719,全国,全国,282,89,193
201,冰雪大世界,20220720,全国,全国,269,85,184
202,冰雪大世界,20220721,全国,全国,297,101,196
203,冰雪大世界,20220722,全国,全国,295,87,208
204,冰雪大世界,20220723,全国,全国,289,64,225
205,冰雪大世界,20220724,全国,全国,307,76,231
206,冰雪大世界,20220725,全国,全国,294,89,205
207,冰雪大世界,20220726,全国,全国,274,68,206
208,冰雪大世界,20220727,全国,全国,281,82,199
209,冰雪大世界,20220728,全国,全国,268,76,192
210,冰雪大世界,20220729,全国,全国,275,78,197
211,冰雪大世界,20220730,全国,全国,314,66,248
212,冰雪大世界,20220731,全国,全国,304,80,224
213,冰雪大世界,20220801,全国,全国,263,74,189
214,冰雪大世界,20220802,全国,全国,282,85,197
215,冰雪大世界,20220803,全国,全国,300,97,203
216,冰雪大世界,20220804,全国,全国,301,97,204
217,冰雪大世界,20220805,全国,全国,302,97,205
218,冰雪大世界,20220806,全国,全国,276,61,215
219,冰雪大世界,20220807,全国,全国,283,61,222
220,冰雪大世界,20220808,全国,全国,296,97,199
221,冰雪大世界,20220809,全国,全国,333,85,248
222,冰雪大世界,20220810,全国,全国,310,89,221
223,冰雪大世界,20220811,全国,全国,309,95,214
224,冰雪大世界,20220812,全国,全国,292,91,201
225,冰雪大世界,20220813,全国,全国,293,66,227
226,冰雪大世界,20220814,全国,全国,301,63,238
227,冰雪大世界,20220815,全国,全国,302,87,215
228,冰雪大世界,20220816,全国,全国,297,80,217
229,冰雪大世界,20220817,全国,全国,292,80,212
230,冰雪大世界,20220818,全国,全国,292,83,209
231,冰雪大世界,20220819,全国,全国,329,101,228
232,冰雪大世界,20220820,全国,全国,275,76,199
233,冰雪大世界,20220821,全国,全国,281,70,211
234,冰雪大世界,20220822,全国,全国,299,91,208
235,冰雪大世界,20220823,全国,全国,296,101,195
236,冰雪大世界,20220824,全国,全国,306,87,219
237,冰雪大世界,20220825,全国,全国,320,116,204
238,冰雪大世界,20220826,全国,全国,297,85,212
239,冰雪大世界,20220827,全国,全国,267,66,201
240,冰雪大世界,20220828,全国,全国,267,66,201
241,冰雪大世界,20220829,全国,全国,297,89,208
242,冰雪大世界,20220830,全国,全国,261,99,162
243,冰雪大世界,20220831,全国,全国,265,80,185
244,冰雪大世界,20220901,全国,全国,259,80,179
245,冰雪大世界,20220902,全国,全国,247,85,162
246,冰雪大世界,20220903,全国,全国,252,78,174
247,冰雪大世界,20220904,全国,全国,241,76,165
248,冰雪大世界,20220905,全国,全国,268,89,179
249,冰雪大世界,20220906,全国,全国,258,76,182
250,冰雪大世界,20220907,全国,全国,301,82,219
251,冰雪大世界,20220908,全国,全国,283,106,177
252,冰雪大世界,20220909,全国,全国,278,74,204
253,冰雪大世界,20220910,全国,全国,274,63,211
254,冰雪大世界,20220911,全国,全国,317,74,243
255,冰雪大世界,20220912,全国,全国,307,76,231
256,冰雪大世界,20220913,全国,全国,302,97,205
257,冰雪大世界,20220914,全国,全国,332,104,228
258,冰雪大世界,20220915,全国,全国,312,101,211
259,冰雪大世界,20220916,全国,全国,291,87,204
260,冰雪大世界,20220917,全国,全国,261,72,189
261,冰雪大世界,20220918,全国,全国,356,76,280
262,冰雪大世界,20220919,全国,全国,315,97,218
263,冰雪大世界,20220920,全国,全国,307,95,212
264,冰雪大世界,20220921,全国,全国,300,102,198
265,冰雪大世界,20220922,全国,全国,274,97,177
266,冰雪大世界,20220923,全国,全国,297,95,202
267,冰雪大世界,20220924,全国,全国,291,82,209
268,冰雪大世界,20220925,全国,全国,274,74,200
269,冰雪大世界,20220926,全国,全国,289,91,198
270,冰雪大世界,20220927,全国,全国,302,104,198
271,冰雪大世界,20220928,全国,全国,283,82,201
272,冰雪大世界,20220929,全国,全国,273,80,193
273,冰雪大世界,20220930,全国,全国,298,99,199
274,冰雪大世界,20221001,全国,全国,297,80,217
275,冰雪大世界,20221002,全国,全国,306,74,232
276,冰雪大世界,20221003,全国,全国,312,70,242
277,冰雪大世界,20221004,全国,全国,305,70,235
278,冰雪大世界,20221005,全国,全国,325,83,242
279,冰雪大世界,20221006,全国,全国,345,95,250
280,冰雪大世界,20221007,全国,全国,326,83,243
281,冰雪大世界,20221008,全国,全国,318,97,221
282,冰雪大世界,20221009,全国,全国,330,101,229
283,冰雪大世界,20221010,全国,全国,326,104,222
284,冰雪大世界,20221011,全国,全国,333,116,217
285,冰雪大世界,20221012,全国,全国,311,106,205
286,冰雪大世界,20221013,全国,全国,321,97,224
287,冰雪大世界,20221014,全国,全国,319,101,218
288,冰雪大世界,20221015,全国,全国,290,91,199
289,冰雪大世界,20221016,全国,全国,312,80,232
290,冰雪大世界,20221017,全国,全国,378,116,262
291,冰雪大世界,20221018,全国,全国,388,127,261
292,冰雪大世界,20221019,全国,全国,342,118,224
293,冰雪大世界,20221020,全国,全国,347,120,227
294,冰雪大世界,20221021,全国,全国,364,116,248
295,冰雪大世界,20221022,全国,全国,335,82,253
296,冰雪大世界,20221023,全国,全国,340,83,257
297,冰雪大世界,20221024,全国,全国,318,104,214
298,冰雪大世界,20221025,全国,全国,330,116,214
299,冰雪大世界,20221026,全国,全国,368,104,264
300,冰雪大世界,20221027,全国,全国,374,142,232
301,冰雪大世界,20221028,全国,全国,342,97,245
302,冰雪大世界,20221029,全国,全国,317,85,232
303,冰雪大世界,20221030,全国,全国,303,64,239
304,冰雪大世界,20221031,全国,全国,340,99,241
305,冰雪大世界,20221101,全国,全国,315,87,228
306,冰雪大世界,20221102,全国,全国,376,112,264
307,冰雪大世界,20221103,全国,全国,356,104,252
308,冰雪大世界,20221104,全国,全国,343,129,214
309,冰雪大世界,20221105,全国,全国,333,74,259
310,冰雪大世界,20221106,全国,全国,343,95,248
311,冰雪大世界,20221107,全国,全国,336,83,253
312,冰雪大世界,20221108,全国,全国,359,106,253
313,冰雪大世界,20221109,全国,全国,431,121,310
314,冰雪大世界,20221110,全国,全国,578,183,395
315,冰雪大世界,20221111,全国,全国,416,118,298
316,冰雪大世界,20221112,全国,全国,466,101,365
317,冰雪大世界,20221113,全国,全国,459,78,381
318,冰雪大世界,20221114,全国,全国,432,127,305
319,冰雪大世界,20221115,全国,全国,428,125,303
320,冰雪大世界,20221116,全国,全国,452,125,327
321,冰雪大世界,20221117,全国,全国,481,127,354
322,冰雪大世界,20221118,全国,全国,493,131,362
323,冰雪大世界,20221119,全国,全国,395,83,312
324,冰雪大世界,20221120,全国,全国,395,76,319
325,冰雪大世界,20221121,全国,全国,435,114,321
326,冰雪大世界,20221122,全国,全国,514,148,366
327,冰雪大世界,20221123,全国,全国,461,144,317
328,冰雪大世界,20221124,全国,全国,457,104,353
329,冰雪大世界,20221125,全国,全国,473,120,353
330,冰雪大世界,20221126,全国,全国,457,83,374
331,冰雪大世界,20221127,全国,全国,456,97,359
332,冰雪大世界,20221128,全国,全国,567,123,444
333,冰雪大世界,20221129,全国,全国,661,140,521
334,冰雪大世界,20221130,全国,全国,653,170,483
335,冰雪大世界,20221201,全国,全国,669,168,501
336,冰雪大世界,20221202,全国,全国,582,152,430
337,冰雪大世界,20221203,全国,全国,617,121,496
338,冰雪大世界,20221204,全国,全国,655,104,551
339,冰雪大世界,20221205,全国,全国,813,182,631
340,冰雪大世界,20221206,全国,全国,771,158,613
341,冰雪大世界,20221207,全国,全国,906,242,664
342,冰雪大世界,20221208,全国,全国,1108,253,855
343,冰雪大世界,20221209,全国,全国,947,213,734
344,冰雪大世界,20221210,全国,全国,813,142,671
345,冰雪大世界,20221211,全国,全国,949,146,803
346,冰雪大世界,20221212,全国,全国,893,220,673
347,冰雪大世界,20221213,全国,全国,767,186,581
348,冰雪大世界,20221214,全国,全国,850,198,652
349,冰雪大世界,20221215,全国,全国,864,194,670
350,冰雪大世界,20221216,全国,全国,829,179,650
351,冰雪大世界,20221217,全国,全国,1021,179,842
352,冰雪大世界,20221218,全国,全国,811,151,660
353,冰雪大世界,20221219,全国,全国,772,201,571
354,冰雪大世界,20221220,全国,全国,729,175,554
355,冰雪大世界,20221221,全国,全国,765,161,604
356,冰雪大世界,20221222,全国,全国,782,162,620
357,冰雪大世界,20221223,全国,全国,789,187,602
358,冰雪大世界,20221224,全国,全国,782,127,655
359,冰雪大世界,20221225,全国,全国,858,148,710
360,冰雪大世界,20221226,全国,全国,947,205,742
361,冰雪大世界,20221227,全国,全国,976,233,743
362,冰雪大世界,20221228,全国,全国,1062,218,844
363,冰雪大世界,20221229,全国,全国,1056,226,830
364,冰雪大世界,20221230,全国,全国,1096,233,863
365,冰雪大世界,20221231,全国,全国,1068,159,909
366,冰雪大世界,20230101,全国,全国,1013,152,861
367,冰雪大世界,20230102,全国,全国,996,180,816
368,冰雪大世界,20230103,全国,全国,1118,268,850
369,冰雪大世界,20230104,全国,全国,1143,290,853
370,冰雪大世界,20230105,全国,全国,1206,316,890
371,冰雪大世界,20230106,全国,全国,1142,287,855
372,冰雪大世界,20230107,全国,全国,1041,182,859
373,冰雪大世界,20230108,全国,全国,1029,168,861
374,冰雪大世界,20230109,全国,全国,1134,270,864
375,冰雪大世界,20230110,全国,全国,1161,274,887
376,冰雪大世界,20230111,全国,全国,1161,264,897
377,冰雪大世界,20230112,全国,全国,1192,271,921
378,冰雪大世界,20230113,全国,全国,1153,256,897
379,冰雪大世界,20230114,全国,全国,1090,179,911
380,冰雪大世界,20230115,全国,全国,1091,163,928
381,冰雪大世界,20230116,全国,全国,1196,276,920
382,冰雪大世界,20230117,全国,全国,1160,256,904
383,冰雪大世界,20230118,全国,全国,1130,212,918
384,冰雪大世界,20230119,全国,全国,1080,193,887
385,冰雪大世界,20230120,全国,全国,1050,166,884
386,冰雪大世界,20230121,全国,全国,941,99,842
387,冰雪大世界,20230122,全国,全国,1050,102,948
388,冰雪大世界,20230123,全国,全国,1099,137,962
389,冰雪大世界,20230124,全国,全国,1126,142,984
390,冰雪大世界,20230125,全国,全国,1163,121,1042
391,冰雪大世界,20230126,全国,全国,1109,95,1014
392,冰雪大世界,20230127,全国,全国,1076,114,962
393,冰雪大世界,20230128,全国,全国,1186,233,953
394,冰雪大世界,20230129,全国,全国,1143,229,914
395,冰雪大世界,20230130,全国,全国,1129,229,900
396,冰雪大世界,20230131,全国,全国,1143,234,909
397,冰雪大世界,20230201,全国,全国,1105,218,887
398,冰雪大世界,20230202,全国,全国,1079,200,879
399,冰雪大世界,20230203,全国,全国,1101,197,904
400,冰雪大世界,20230204,全国,全国,1082,190,892
401,冰雪大世界,20230205,全国,全国,1028,137,891
402,冰雪大世界,20230206,全国,全国,1026,183,843
403,冰雪大世界,20230207,全国,全国,1042,201,841
404,冰雪大世界,20230208,全国,全国,978,212,766
405,冰雪大世界,20230209,全国,全国,1057,215,842
406,冰雪大世界,20230210,全国,全国,1034,176,858
407,冰雪大世界,20230211,全国,全国,979,139,840
408,冰雪大世界,20230212,全国,全国,889,154,735
409,冰雪大世界,20230213,全国,全国,853,175,678
410,冰雪大世界,20230214,全国,全国,779,166,613
411,冰雪大世界,20230215,全国,全国,773,155,618
412,冰雪大世界,20230216,全国,全国,806,175,631
413,冰雪大世界,20230217,全国,全国,820,175,645
414,冰雪大世界,20230218,全国,全国,776,89,687
415,冰雪大世界,20230219,全国,全国,740,112,628
416,冰雪大世界,20230220,全国,全国,686,154,532
417,冰雪大世界,20230221,全国,全国,664,152,512
418,冰雪大世界,20230222,全国,全国,636,137,499
419,冰雪大世界,20230223,全国,全国,679,155,524
420,冰雪大世界,20230224,全国,全国,674,146,528
421,冰雪大世界,20230225,全国,全国,660,93,567
422,冰雪大世界,20230226,全国,全国,535,123,412
423,冰雪大世界,20230227,全国,全国,408,110,298
424,冰雪大世界,20230228,全国,全国,415,146,269
425,冰雪大世界,20230301,全国,全国,388,131,257
426,冰雪大世界,20230302,全国,全国,361,114,247
427,冰雪大世界,20230303,全国,全国,369,121,248
428,冰雪大世界,20230304,全国,全国,370,89,281
429,冰雪大世界,20230305,全国,全国,354,87,267
430,冰雪大世界,20230306,全国,全国,330,125,205
431,冰雪大世界,20230307,全国,全国,331,114,217
432,冰雪大世界,20230308,全国,全国,323,91,232
433,冰雪大世界,20230309,全国,全国,269,85,184
434,冰雪大世界,20230310,全国,全国,275,83,192
435,冰雪大世界,20230311,全国,全国,297,82,215
436,冰雪大世界,20230312,全国,全国,315,91,224
437,冰雪大世界,20230313,全国,全国,323,104,219
438,冰雪大世界,20230314,全国,全国,307,95,212
439,冰雪大世界,20230315,全国,全国,295,108,187
440,冰雪大世界,20230316,全国,全国,310,99,211
441,冰雪大世界,20230317,全国,全国,278,83,195
442,冰雪大世界,20230318,全国,全国,271,78,193
443,冰雪大世界,20230319,全国,全国,300,82,218
444,冰雪大世界,20230320,全国,全国,282,97,185
445,冰雪大世界,20230321,全国,全国,301,131,170
446,冰雪大世界,20230322,全国,全国,307,120,187
447,冰雪大世界,20230323,全国,全国,259,85,174
448,冰雪大世界,20230324,全国,全国,256,82,174
449,冰雪大世界,20230325,全国,全国,291,85,206
450,冰雪大世界,20230326,全国,全国,281,80,201
451,冰雪大世界,20230327,全国,全国,283,85,198
452,冰雪大世界,20230328,全国,全国,286,93,193
453,冰雪大世界,20230329,全国,全国,273,89,184
454,冰雪大世界,20230330,全国,全国,276,99,177
455,冰雪大世界,20230331,全国,全国,259,85,174
456,冰雪大世界,20230401,全国,全国,244,74,170
457,冰雪大世界,20230402,全国,全国,268,83,185
458,冰雪大世界,20230403,全国,全国,282,102,180
459,冰雪大世界,20230404,全国,全国,306,101,205
460,冰雪大世界,20230405,全国,全国,280,80,200
461,冰雪大世界,20230406,全国,全国,284,95,189
462,冰雪大世界,20230407,全国,全国,320,140,180
463,冰雪大世界,20230408,全国,全国,281,70,211
464,冰雪大世界,20230409,全国,全国,289,70,219
465,冰雪大世界,20230410,全国,全国,256,85,171
466,冰雪大世界,20230411,全国,全国,270,87,183
467,冰雪大世界,20230412,全国,全国,274,89,185
468,冰雪大世界,20230413,全国,全国,255,76,179
469,冰雪大世界,20230414,全国,全国,286,89,197
470,冰雪大世界,20230415,全国,全国,245,63,182
471,冰雪大世界,20230416,全国,全国,256,66,190
472,冰雪大世界,20230417,全国,全国,288,80,208
473,冰雪大世界,20230418,全国,全国,282,93,189
474,冰雪大世界,20230419,全国,全国,321,97,224
475,冰雪大世界,20230420,全国,全国,286,97,189
476,冰雪大世界,20230421,全国,全国,314,93,221
477,冰雪大世界,20230422,全国,全国,325,76,249
478,冰雪大世界,20230423,全国,全国,317,102,215
479,冰雪大世界,20230424,全国,全国,278,80,198
480,冰雪大世界,20230425,全国,全国,279,83,196
481,冰雪大世界,20230426,全国,全国,297,89,208
482,冰雪大世界,20230427,全国,全国,269,83,186
483,冰雪大世界,20230428,全国,全国,274,87,187
484,冰雪大世界,20230429,全国,全国,295,66,229
485,冰雪大世界,20230430,全国,全国,312,64,248
486,冰雪大世界,20230501,全国,全国,273,59,214
487,冰雪大世界,20230502,全国,全国,296,64,232
488,冰雪大世界,20230503,全国,全国,267,72,195
489,冰雪大世界,20230504,全国,全国,267,85,182
490,冰雪大世界,20230505,全国,全国,263,87,176
491,冰雪大世界,20230506,全国,全国,248,80,168
492,冰雪大世界,20230507,全国,全国,244,64,180
493,冰雪大世界,20230508,全国,全国,273,97,176
494,冰雪大世界,20230509,全国,全国,289,97,192
495,冰雪大世界,20230510,全国,全国,300,97,203
496,冰雪大世界,20230511,全国,全国,313,102,211
497,冰雪大世界,20230512,全国,全国,260,99,161
498,冰雪大世界,20230513,全国,全国,220,61,159
499,冰雪大世界,20230514,全国,全国,258,68,190
500,冰雪大世界,20230515,全国,全国,243,78,165
501,冰雪大世界,20230516,全国,全国,245,87,158
502,冰雪大世界,20230517,全国,全国,253,83,170
503,冰雪大世界,20230518,全国,全国,241,74,167
504,冰雪大世界,20230519,全国,全国,254,93,161
505,冰雪大世界,20230520,全国,全国,233,66,167
506,冰雪大世界,20230521,全国,全国,244,70,174
507,冰雪大世界,20230522,全国,全国,243,78,165
508,冰雪大世界,20230523,全国,全国,248,74,174
509,冰雪大世界,20230524,全国,全国,253,104,149
510,冰雪大世界,20230525,全国,全国,241,87,154
511,冰雪大世界,20230526,全国,全国,241,97,144
512,冰雪大世界,20230527,全国,全国,237,76,161
513,冰雪大世界,20230528,全国,全国,269,76,193
514,冰雪大世界,20230529,全国,全国,277,99,178
515,冰雪大世界,20230530,全国,全国,271,91,180
516,冰雪大世界,20230531,全国,全国,242,74,168
517,冰雪大世界,20230601,全国,全国,268,104,164
518,冰雪大世界,20230602,全国,全国,257,93,164
519,冰雪大世界,20230603,全国,全国,243,72,171
520,冰雪大世界,20230604,全国,全国,246,66,180
521,冰雪大世界,20230605,全国,全国,248,78,170
522,冰雪大世界,20230606,全国,全国,233,95,138
523,冰雪大世界,20230607,全国,全国,265,95,170
524,冰雪大世界,20230608,全国,全国,256,82,174
525,冰雪大世界,20230609,全国,全国,268,102,166
526,冰雪大世界,20230610,全国,全国,243,78,165
527,冰雪大世界,20230611,全国,全国,255,68,187
528,冰雪大世界,20230612,全国,全国,265,89,176
529,冰雪大世界,20230613,全国,全国,268,101,167
530,冰雪大世界,20230614,全国,全国,244,76,168
531,冰雪大世界,20230615,全国,全国,248,78,170
532,冰雪大世界,20230616,全国,全国,268,82,186
533,冰雪大世界,20230617,全国,全国,246,70,176
534,冰雪大世界,20230618,全国,全国,244,68,176
535,冰雪大世界,20230619,全国,全国,250,76,174
536,冰雪大世界,20230620,全国,全国,309,120,189
537,冰雪大世界,20230621,全国,全国,275,99,176
538,冰雪大世界,20230622,全国,全国,270,72,198
539,冰雪大世界,20230623,全国,全国,252,74,178
540,冰雪大世界,20230624,全国,全国,257,61,196
541,冰雪大世界,20230625,全国,全国,259,78,181
542,冰雪大世界,20230626,全国,全国,265,87,178
543,冰雪大世界,20230627,全国,全国,262,83,179
544,冰雪大世界,20230628,全国,全国,286,97,189
545,冰雪大世界,20230629,全国,全国,262,97,165
546,冰雪大世界,20230630,全国,全国,248,78,170
547,冰雪大世界,20230701,全国,全国,252,72,180
548,冰雪大世界,20230702,全国,全国,267,74,193
549,冰雪大世界,20230703,全国,全国,264,72,192
550,冰雪大世界,20230704,全国,全国,275,85,190
551,冰雪大世界,20230705,全国,全国,256,95,161
552,冰雪大世界,20230706,全国,全国,284,80,204
553,冰雪大世界,20230707,全国,全国,262,85,177
554,冰雪大世界,20230708,全国,全国,284,76,208
555,冰雪大世界,20230709,全国,全国,271,63,208
556,冰雪大世界,20230710,全国,全国,295,87,208
557,冰雪大世界,20230711,全国,全国,281,95,186
558,冰雪大世界,20230712,全国,全国,294,80,214
559,冰雪大世界,20230713,全国,全国,308,91,217
560,冰雪大世界,20230714,全国,全国,263,80,183
561,冰雪大世界,20230715,全国,全国,265,66,199
562,冰雪大世界,20230716,全国,全国,264,66,198
563,冰雪大世界,20230717,全国,全国,268,72,196
564,冰雪大世界,20230718,全国,全国,290,89,201
565,冰雪大世界,20230719,全国,全国,301,95,206
566,冰雪大世界,20230720,全国,全国,345,74,271
567,冰雪大世界,20230721,全国,全国,352,93,259
568,冰雪大世界,20230722,全国,全国,303,76,227
569,冰雪大世界,20230723,全国,全国,306,68,238
570,冰雪大世界,20230724,全国,全国,308,93,215
571,冰雪大世界,20230725,全国,全国,327,95,232
572,冰雪大世界,20230726,全国,全国,308,93,215
573,冰雪大世界,20230727,全国,全国,295,89,206
574,冰雪大世界,20230728,全国,全国,286,80,206
575,冰雪大世界,20230729,全国,全国,297,68,229
576,冰雪大世界,20230730,全国,全国,304,66,238
577,冰雪大世界,20230731,全国,全国,302,91,211
578,冰雪大世界,20230801,全国,全国,274,82,192
579,冰雪大世界,20230802,全国,全国,280,82,198
580,冰雪大世界,20230803,全国,全国,297,91,206
581,冰雪大世界,20230804,全国,全国,336,93,243
582,冰雪大世界,20230805,全国,全国,325,78,247
583,冰雪大世界,20230806,全国,全国,311,80,231
584,冰雪大世界,20230807,全国,全国,301,76,225
585,冰雪大世界,20230808,全国,全国,288,82,206
586,冰雪大世界,20230809,全国,全国,295,80,215
587,冰雪大世界,20230810,全国,全国,288,82,206
588,冰雪大世界,20230811,全国,全国,309,89,220
589,冰雪大世界,20230812,全国,全国,314,72,242
590,冰雪大世界,20230813,全国,全国,309,64,245
591,冰雪大世界,20230814,全国,全国,306,78,228
592,冰雪大世界,20230815,全国,全国,324,112,212
593,冰雪大世界,20230816,全国,全国,332,91,241
594,冰雪大世界,20230817,全国,全国,338,106,232
595,冰雪大世界,20230818,全国,全国,313,85,228
596,冰雪大世界,20230819,全国,全国,329,70,259
597,冰雪大世界,20230820,全国,全国,309,74,235
598,冰雪大世界,20230821,全国,全国,303,91,212
599,冰雪大世界,20230822,全国,全国,277,74,203
600,冰雪大世界,20230823,全国,全国,300,97,203
601,冰雪大世界,20230824,全国,全国,312,83,229
602,冰雪大世界,20230825,全国,全国,336,93,243
603,冰雪大世界,20230826,全国,全国,294,70,224
604,冰雪大世界,20230827,全国,全国,291,70,221
605,冰雪大世界,20230828,全国,全国,297,80,217
606,冰雪大世界,20230829,全国,全国,319,99,220
607,冰雪大世界,20230830,全国,全国,313,95,218
608,冰雪大世界,20230831,全国,全国,320,102,218
609,冰雪大世界,20230901,全国,全国,272,74,198
610,冰雪大世界,20230902,全国,全国,264,80,184
611,冰雪大世界,20230903,全国,全国,288,76,212
612,冰雪大世界,20230904,全国,全国,272,85,187
613,冰雪大世界,20230905,全国,全国,284,87,197
614,冰雪大世界,20230906,全国,全国,297,99,198
615,冰雪大世界,20230907,全国,全国,275,83,192
616,冰雪大世界,20230908,全国,全国,288,102,186
617,冰雪大世界,20230909,全国,全国,319,72,247
618,冰雪大世界,20230910,全国,全国,358,74,284
619,冰雪大世界,20230911,全国,全国,309,97,212
620,冰雪大世界,20230912,全国,全国,346,118,228
621,冰雪大世界,20230913,全国,全国,354,106,248
622,冰雪大世界,20230914,全国,全国,380,110,270
623,冰雪大世界,20230915,全国,全国,363,106,257
624,冰雪大世界,20230916,全国,全国,379,74,305
625,冰雪大世界,20230917,全国,全国,412,82,330
626,冰雪大世界,20230918,全国,全国,338,99,239
627,冰雪大世界,20230919,全国,全国,329,93,236
628,冰雪大世界,20230920,全国,全国,356,135,221
629,冰雪大世界,20230921,全国,全国,337,106,231
630,冰雪大世界,20230922,全国,全国,307,93,214
631,冰雪大世界,20230923,全国,全国,301,70,231
632,冰雪大世界,20230924,全国,全国,343,83,260
633,冰雪大世界,20230925,全国,全国,348,101,247
634,冰雪大世界,20230926,全国,全国,298,97,201
635,冰雪大世界,20230927,全国,全国,348,110,238
636,冰雪大世界,20230928,全国,全国,361,116,245
637,冰雪大世界,20230929,全国,全国,327,61,266
638,冰雪大世界,20230930,全国,全国,365,70,295
639,冰雪大世界,20231001,全国,全国,358,76,282
640,冰雪大世界,20231002,全国,全国,395,85,310
641,冰雪大世界,20231003,全国,全国,414,76,338
642,冰雪大世界,20231004,全国,全国,484,87,397
643,冰雪大世界,20231005,全国,全国,406,83,323
644,冰雪大世界,20231006,全国,全国,406,93,313
645,冰雪大世界,20231007,全国,全国,482,152,330
646,冰雪大世界,20231008,全国,全国,521,184,337
647,冰雪大世界,20231009,全国,全国,502,172,330
648,冰雪大世界,20231010,全国,全国,527,161,366
649,冰雪大世界,20231011,全国,全国,586,154,432
650,冰雪大世界,20231012,全国,全国,777,205,572
651,冰雪大世界,20231013,全国,全国,1055,290,765
652,冰雪大世界,20231014,全国,全国,1002,150,852
653,冰雪大世界,20231015,全国,全国,1081,155,926
654,冰雪大世界,20231016,全国,全国,1480,554,926
655,冰雪大世界,20231017,全国,全国,1317,431,886
656,冰雪大世界,20231018,全国,全国,1228,380,848
657,冰雪大世界,20231019,全国,全国,1158,319,839
658,冰雪大世界,20231020,全国,全国,1137,332,805
659,冰雪大世界,20231021,全国,全国,852,165,687
660,冰雪大世界,20231022,全国,全国,850,146,704
661,冰雪大世界,20231023,全国,全国,1047,369,678
662,冰雪大世界,20231024,全国,全国,913,332,581
663,冰雪大世界,20231025,全国,全国,1070,456,614
664,冰雪大世界,20231026,全国,全国,888,341,547
665,冰雪大世界,20231027,全国,全国,940,298,642
666,冰雪大世界,20231028,全国,全国,854,173,681
667,冰雪大世界,20231029,全国,全国,807,157,650
668,冰雪大世界,20231030,全国,全国,1046,349,697
669,冰雪大世界,20231031,全国,全国,940,298,642
670,冰雪大世界,20231101,全国,全国,1228,344,884
671,冰雪大世界,20231102,全国,全国,1024,357,667
672,冰雪大世界,20231103,全国,全国,1043,288,755
673,冰雪大世界,20231104,全国,全国,938,173,765
674,冰雪大世界,20231105,全国,全国,1045,197,848
675,冰雪大世界,20231106,全国,全国,1698,720,978
676,冰雪大世界,20231107,全国,全国,1446,533,913
677,冰雪大世界,20231108,全国,全国,1434,513,921
678,冰雪大世界,20231109,全国,全国,1422,524,898
679,冰雪大世界,20231110,全国,全国,1347,422,925
680,冰雪大世界,20231111,全国,全国,1088,204,884
681,冰雪大世界,20231112,全国,全国,1122,218,904
682,冰雪大世界,20231113,全国,全国,1471,549,922
683,冰雪大世界,20231114,全国,全国,1541,577,964
684,冰雪大世界,20231115,全国,全国,1463,561,902
685,冰雪大世界,20231116,全国,全国,1455,549,906
686,冰雪大世界,20231117,全国,全国,1434,499,935
687,冰雪大世界,20231118,全国,全国,1132,220,912
688,冰雪大世界,20231119,全国,全国,1215,257,958
689,冰雪大世界,20231120,全国,全国,1786,656,1130
690,冰雪大世界,20231121,全国,全国,1706,606,1100
691,冰雪大世界,20231122,全国,全国,1772,620,1152
692,冰雪大世界,20231123,全国,全国,1546,549,997
693,冰雪大世界,20231124,全国,全国,1622,521,1101
694,冰雪大世界,20231125,全国,全国,1268,257,1011
695,冰雪大世界,20231126,全国,全国,1346,259,1087
696,冰雪大世界,20231127,全国,全国,1935,791,1144
697,冰雪大世界,20231128,全国,全国,1659,692,967
698,冰雪大世界,20231129,全国,全国,1743,727,1016
699,冰雪大世界,20231130,全国,全国,1761,772,989
700,冰雪大世界,20231201,全国,全国,1838,709,1129
701,冰雪大世界,20231202,全国,全国,1515,360,1155
702,冰雪大世界,20231203,全国,全国,1541,285,1256
703,冰雪大世界,20231204,全国,全国,1963,864,1099
704,冰雪大世界,20231205,全国,全国,1976,760,1216
705,冰雪大世界,20231206,全国,全国,1984,844,1140
706,冰雪大世界,20231207,全国,全国,1802,768,1034
707,冰雪大世界,20231208,全国,全国,1716,696,1020
708,冰雪大世界,20231209,全国,全国,1284,309,975
709,冰雪大世界,20231210,全国,全国,1484,307,1177
710,冰雪大世界,20231211,全国,全国,1939,905,1034
711,冰雪大世界,20231212,全国,全国,1774,851,923
712,冰雪大世界,20231213,全国,全国,1914,810,1104
713,冰雪大世界,20231214,全国,全国,2450,871,1579
714,冰雪大世界,20231215,全国,全国,2475,864,1611
715,冰雪大世界,20231216,全国,全国,2046,391,1655
716,冰雪大世界,20231217,全国,全国,2237,420,1817
717,冰雪大世界,20231218,全国,全国,3969,1040,2929
718,冰雪大世界,20231219,全国,全国,4247,1193,3054
719,冰雪大世界,20231220,全国,全国,5039,1404,3635
720,冰雪大世界,20231221,全国,全国,5353,1285,4068
721,冰雪大世界,20231222,全国,全国,4085,928,3157
722,冰雪大世界,20231223,全国,全国,3250,516,2734
723,冰雪大世界,20231224,全国,全国,2934,563,2371
724,冰雪大世界,20231225,全国,全国,3236,941,2295
725,冰雪大世界,20231226,全国,全国,3218,876,2342
726,冰雪大世界,20231227,全国,全国,3052,855,2197
727,冰雪大世界,20231228,全国,全国,3130,854,2276
728,冰雪大世界,20231229,全国,全国,3467,849,2618
729,冰雪大世界,20231230,全国,全国,3248,399,2849
730,冰雪大世界,20231231,全国,全国,3495,532,2963
731,冰雪大世界,20240101,全国,全国,3069,490,2579
732,冰雪大世界,20240102,全国,全国,2829,914,1915
733,冰雪大世界,20240103,全国,全国,3583,985,2598
734,冰雪大世界,20240104,全国,全国,3927,1017,2910
735,冰雪大世界,20240105,全国,全国,5494,1067,4427
736,冰雪大世界,20240106,全国,全国,9699,704,8995
737,冰雪大世界,20240107,全国,全国,6540,602,5938
738,冰雪大世界,20240108,全国,全国,10539,986,9553
739,冰雪大世界,20240109,全国,全国,8943,902,8041
740,冰雪大世界,20240110,全国,全国,8537,875,7662
741,冰雪大世界,20240111,全国,全国,7235,883,6352
742,冰雪大世界,20240112,全国,全国,8274,822,7452
743,冰雪大世界,20240113,全国,全国,7028,395,6633
744,冰雪大世界,20240114,全国,全国,5234,436,4798
745,冰雪大世界,20240115,全国,全国,8112,870,7242
746,冰雪大世界,20240116,全国,全国,6507,794,5713
747,冰雪大世界,20240117,全国,全国,7152,741,6411
748,冰雪大世界,20240118,全国,全国,6943,575,6368
749,冰雪大世界,20240119,全国,全国,7017,578,6439
750,冰雪大世界,20240120,全国,全国,6494,332,6162
751,冰雪大世界,20240121,全国,全国,4357,349,4008
752,冰雪大世界,20240122,全国,全国,6527,582,5945
753,冰雪大世界,20240123,全国,全国,5460,572,4888
754,冰雪大世界,20240124,全国,全国,2491,478,2013
755,冰雪大世界,20240125,全国,全国,2318,515,1803
756,冰雪大世界,20240126,全国,全国,2122,403,1719
757,冰雪大世界,20240127,全国,全国,1840,262,1578
758,冰雪大世界,20240128,全国,全国,1753,247,1506
759,冰雪大世界,20240129,全国,全国,1820,419,1401
760,冰雪大世界,20240130,全国,全国,1785,433,1352
761,冰雪大世界,20240131,全国,全国,1623,330,1293
762,冰雪大世界,20240201,全国,全国,1578,386,1192
763,冰雪大世界,20240202,全国,全国,1501,310,1191
764,冰雪大世界,20240203,全国,全国,1438,209,1229
765,冰雪大世界,20240204,全国,全国,1695,378,1317
766,冰雪大世界,20240205,全国,全国,1556,318,1238
767,冰雪大世界,20240206,全国,全国,1529,276,1253
768,冰雪大世界,20240207,全国,全国,1447,251,1196
769,冰雪大世界,20240208,全国,全国,1487,220,1267
770,冰雪大世界,20240209,全国,全国,1184,157,1027
771,冰雪大世界,20240210,全国,全国,1526,168,1358
772,冰雪大世界,20240211,全国,全国,1891,146,1745
773,冰雪大世界,20240212,全国,全国,1927,154,1773
774,冰雪大世界,20240213,全国,全国,3253,307,2946
775,冰雪大世界,20240214,全国,全国,3310,296,3014
776,冰雪大世界,20240215,全国,全国,2417,315,2102
777,冰雪大世界,20240216,全国,全国,1742,228,1514
778,冰雪大世界,20240217,全国,全国,1416,225,1191
779,冰雪大世界,20240218,全国,全国,1364,354,1010
780,冰雪大世界,20240219,全国,全国,1353,383,970
781,冰雪大世界,20240220,全国,全国,1216,288,928
782,冰雪大世界,20240221,全国,全国,1180,271,909
783,冰雪大世界,20240222,全国,全国,1152,248,904
784,冰雪大世界,20240223,全国,全国,1156,274,882
785,冰雪大世界,20240224,全国,全国,1045,159,886
786,冰雪大世界,20240225,全国,全国,1075,188,887
787,冰雪大世界,20240226,全国,全国,1059,248,811
788,冰雪大世界,20240227,全国,全国,1022,226,796
789,冰雪大世界,20240228,全国,全国,1001,228,773
790,冰雪大世界,20240229,全国,全国,1072,257,815
791,冰雪大世界,20240301,全国,全国,708,202,506
792,冰雪大世界,20240302,全国,全国,635,144,491
793,冰雪大世界,20240303,全国,全国,723,158,565
794,冰雪大世界,20240304,全国,全国,594,201,393
795,冰雪大世界,20240305,全国,全国,607,193,414
796,冰雪大世界,20240306,全国,全国,584,186,398
797,冰雪大世界,20240307,全国,全国,607,233,374
798,冰雪大世界,20240308,全国,全国,469,110,359
799,冰雪大世界,20240309,全国,全国,494,120,374
800,冰雪大世界,20240310,全国,全国,580,112,468
801,冰雪大世界,20240311,全国,全国,542,182,360
802,冰雪大世界,20240312,全国,全国,534,188,346
803,冰雪大世界,20240313,全国,全国,617,190,427
804,冰雪大世界,20240314,全国,全国,592,180,412
805,冰雪大世界,20240315,全国,全国,479,159,320
806,冰雪大世界,20240316,全国,全国,548,133,415
807,冰雪大世界,20240317,全国,全国,622,123,499
808,冰雪大世界,20240318,全国,全国,540,179,361
809,冰雪大世界,20240319,全国,全国,470,179,291
810,冰雪大世界,20240320,全国,全国,454,163,291
811,冰雪大世界,20240321,全国,全国,489,219,270
812,冰雪大世界,20240322,全国,全国,396,150,246
813,冰雪大世界,20240323,全国,全国,360,97,263
814,冰雪大世界,20240324,全国,全国,439,106,333
815,冰雪大世界,20240325,全国,全国,385,125,260
816,冰雪大世界,20240326,全国,全国,416,139,277
817,冰雪大世界,20240327,全国,全国,447,137,310
818,冰雪大世界,20240328,全国,全国,466,161,305
819,冰雪大世界,20240329,全国,全国,394,131,263
820,冰雪大世界,20240330,全国,全国,413,142,271
821,冰雪大世界,20240331,全国,全国,433,110,323
822,冰雪大世界,20240401,全国,全国,407,150,257
823,冰雪大世界,20240402,全国,全国,370,142,228
824,冰雪大世界,20240403,全国,全国,360,125,235
825,冰雪大世界,20240404,全国,全国,406,91,315
826,冰雪大世界,20240405,全国,全国,387,93,294
827,冰雪大世界,20240406,全国,全国,388,110,278
828,冰雪大世界,20240407,全国,全国,425,148,277
829,冰雪大世界,20240408,全国,全国,385,146,239
830,冰雪大世界,20240409,全国,全国,352,121,231
831,冰雪大世界,20240410,全国,全国,370,118,252
832,冰雪大世界,20240411,全国,全国,364,152,212
833,冰雪大世界,20240412,全国,全国,340,91,249
834,冰雪大世界,20240413,全国,全国,299,87,212
835,冰雪大世界,20240414,全国,全国,365,101,264
836,冰雪大世界,20240415,全国,全国,367,110,257
837,冰雪大世界,20240416,全国,全国,370,121,249
838,冰雪大世界,20240417,全国,全国,325,93,232
839,冰雪大世界,20240418,全国,全国,353,112,241
840,冰雪大世界,20240419,全国,全国,320,112,208
841,冰雪大世界,20240420,全国,全国,310,76,234
842,冰雪大世界,20240421,全国,全国,359,93,266
843,冰雪大世界,20240422,全国,全国,319,118,201
844,冰雪大世界,20240423,全国,全国,337,129,208
845,冰雪大世界,20240424,全国,全国,318,118,200
846,冰雪大世界,20240425,全国,全国,320,108,212
847,冰雪大世界,20240426,全国,全国,320,127,193
848,冰雪大世界,20240427,全国,全国,373,95,278
849,冰雪大世界,20240428,全国,全国,350,112,238
850,冰雪大世界,20240429,全国,全国,307,112,195
851,冰雪大世界,20240430,全国,全国,382,129,253