关键词,日期,省份,城市,PC+移动端,PC端,移动端
哈尔滨旅游,20220101,全国,全国,217,66,151
哈尔滨旅游,20220102,全国,全国,239,74,165
哈尔滨旅游,20220103,全国,全国,247,63,184
哈尔滨旅游,20220104,全国,全国,258,93,165
哈尔滨旅游,20220105,全国,全国,252,104,148
哈尔滨旅游,20220106,全国,全国,241,78,163
哈尔滨旅游,20220107,全国,全国,243,78,165
哈尔滨旅游,20220108,全国,全国,228,68,160
哈尔滨旅游,20220109,全国,全国,225,74,151
哈尔滨旅游,20220110,全国,全国,210,80,130
哈尔滨旅游,20220111,全国,全国,210,74,136
哈尔滨旅游,20220112,全国,全国,232,85,147
哈尔滨旅游,20220113,全国,全国,219,68,151
哈尔滨旅游,20220114,全国,全国,189,68,121
哈尔滨旅游,20220115,全国,全国,208,78,130
哈尔滨旅游,20220116,全国,全国,235,68,167
哈尔滨旅游,20220117,全国,全国,221,78,143
哈尔滨旅游,20220118,全国,全国,204,74,130
哈尔滨旅游,20220119,全国,全国,216,68,148
哈尔滨旅游,20220120,全国,全国,204,72,132
哈尔滨旅游,20220121,全国,全国,217,74,143
哈尔滨旅游,20220122,全国,全国,220,72,148
哈尔滨旅游,20220123,全国,全国,198,72,126
哈尔滨旅游,20220124,全国,全国,219,76,143
哈尔滨旅游,20220125,全国,全国,217,74,143
哈尔滨旅游,20220126,全国,全国,241,80,161
哈尔滨旅游,20220127,全国,全国,215,74,141
哈尔滨旅游,20220128,全国,全国,211,68,143
哈尔滨旅游,20220129,全国,全国,159,0,159
哈尔滨旅游,20220130,全国,全国,209,68,141
哈尔滨旅游,20220131,全国,全国,188,63,125
哈尔滨旅游,20220201,全国,全国,204,59,145
哈尔滨旅游,20220202,全国,全国,225,61,164
哈尔滨旅游,20220203,全国,全国,224,66,158
哈尔滨旅游,20220204,全国,全国,218,61,157
哈尔滨旅游,20220205,全国,全国,236,66,170
哈尔滨旅游,20220206,全国,全国,222,59,163
哈尔滨旅游,20220207,全国,全国,248,80,168
哈尔滨旅游,20220208,全国,全国,255,82,173
哈尔滨旅游,20220209,全国,全国,225,74,151
哈尔滨旅游,20220210,全国,全国,220,68,152
哈尔滨旅游,20220211,全国,全国,221,74,147
哈尔滨旅游,20220212,全国,全国,240,72,168
哈尔滨旅游,20220213,全国,全国,232,66,166
哈尔滨旅游,20220214,全国,全国,238,83,155
哈尔滨旅游,20220215,全国,全国,229,74,155
哈尔滨旅游,20220216,全国,全国,246,85,161
哈尔滨旅游,20220217,全国,全国,246,76,170
哈尔滨旅游,20220218,全国,全国,246,78,168
哈尔滨旅游,20220219,全国,全国,247,76,171
哈尔滨旅游,20220220,全国,全国,248,72,176
哈尔滨旅游,20220221,全国,全国,247,83,164
哈尔滨旅游,20220222,全国,全国,250,76,174
哈尔滨旅游,20220223,全国,全国,227,72,155
哈尔滨旅游,20220224,全国,全国,200,82,118
哈尔滨旅游,20220225,全国,全国,197,76,121
哈尔滨旅游,20220226,全国,全国,177,72,105
哈尔滨旅游,20220227,全国,全国,105,0,105
哈尔滨旅游,20220228,全国,全国,188,76,112
哈尔滨旅游,20220301,全国,全国,191,76,115
哈尔滨旅游,20220302,全国,全国,172,63,109
哈尔滨旅游,20220303,全国,全国,172,72,100
哈尔滨旅游,20220304,全国,全国,157,64,93
哈尔滨旅游,20220305,全国,全国,174,61,113
哈尔滨旅游,20220306,全国,全国,188,66,122
哈尔滨旅游,20220307,全国,全国,179,66,113
哈尔滨旅游,20220308,全国,全国,164,68,96
哈尔滨旅游,20220309,全国,全国,199,76,123
哈尔滨旅游,20220310,全国,全国,190,78,112
哈尔滨旅游,20220311,全国,全国,195,74,121
哈尔滨旅游,20220312,全国,全国,140,64,76
哈尔滨旅游,20220313,全国,全国,156,64,92
哈尔滨旅游,20220314,全国,全国,155,72,83
哈尔滨旅游,20220315,全国,全国,162,70,92
哈尔滨旅游,20220316,全国,全国,162,70,92
哈尔滨旅游,20220317,全国,全国,147,64,83
哈尔滨旅游,20220318,全国,全国,157,70,87
哈尔滨旅游,20220319,全国,全国,163,59,104
哈尔滨旅游,20220320,全国,全国,154,68,86
哈尔滨旅游,20220321,全国,全国,158,61,97
哈尔滨旅游,20220322,全国,全国,168,63,105
哈尔滨旅游,20220323,全国,全国,144,70,74
哈尔滨旅游,20220324,全国,全国,160,63,97
哈尔滨旅游,20220325,全国,全国,169,72,97
哈尔滨旅游,20220326,全国,全国,148,61,87
哈尔滨旅游,20220327,全国,全国,138,59,79
哈尔滨旅游,20220328,全国,全国,148,64,84
哈尔滨旅游,20220329,全国,全国,158,72,86
哈尔滨旅游,20220330,全国,全国,154,61,93
哈尔滨旅游,20220331,全国,全国,142,68,74
哈尔滨旅游,20220401,全国,全国,160,68,92
哈尔滨旅游,20220402,全国,全国,143,61,82
哈尔滨旅游,20220403,全国,全国,148,59,89
哈尔滨旅游,20220404,全国,全国,151,59,92
哈尔滨旅游,20220405,全国,全国,154,70,84
哈尔滨旅游,20220406,全国,全国,163,64,99
哈尔滨旅游,20220407,全国,全国,167,68,99
哈尔滨旅游,20220408,全国,全国,150,68,82
哈尔滨旅游,20220409,全国,全国,168,68,100
哈尔滨旅游,20220410,全国,全国,182,72,110
哈尔滨旅游,20220411,全国,全国,150,66,84
哈尔滨旅游,20220412,全国,全国,167,63,104
哈尔滨旅游,20220413,全国,全国,169,72,97
哈尔滨旅游,20220414,全国,全国,169,74,95
哈尔滨旅游,20220415,全国,全国,157,66,91
哈尔滨旅游,20220416,全国,全国,160,68,92
哈尔滨旅游,20220417,全国,全国,157,61,96
哈尔滨旅游,20220418,全国,全国,163,64,99
哈尔滨旅游,20220419,全国,全国,147,68,79
哈尔滨旅游,20220420,全国,全国,157,61,96
哈尔滨旅游,20220421,全国,全国,171,66,105
哈尔滨旅游,20220422,全国,全国,162,70,92
哈尔滨旅游,20220423,全国,全国,163,61,102
哈尔滨旅游,20220424,全国,全国,152,66,86
哈尔滨旅游,20220425,全国,全国,150,66,84
哈尔滨旅游,20220426,全国,全国,159,68,91
哈尔滨旅游,20220427,全国,全国,163,63,100
哈尔滨旅游,20220428,全国,全国,171,63,108
哈尔滨旅游,20220429,全国,全国,169,70,99
哈尔滨旅游,20220430,全国,全国,160,64,96
哈尔滨旅游,20220501,全国,全国,166,64,102
哈尔滨旅游,20220502,全国,全国,159,63,96
哈尔滨旅游,20220503,全国,全国,140,61,79
哈尔滨旅游,20220504,全国,全国,169,63,106
哈尔滨旅游,20220505,全国,全国,167,70,97
哈尔滨旅游,20220506,全国,全国,144,61,83
哈尔滨旅游,20220507,全国,全国,172,72,100
哈尔滨旅游,20220508,全国,全国,154,59,95
哈尔滨旅游,20220509,全国,全国,169,64,105
哈尔滨旅游,20220510,全国,全国,172,66,106
哈尔滨旅游,20220511,全国,全国,214,76,138
哈尔滨旅游,20220512,全国,全国,293,74,219
哈尔滨旅游,20220513,全国,全国,238,64,174
哈尔滨旅游,20220514,全国,全国,187,64,123
哈尔滨旅游,20220515,全国,全国,177,64,113
哈尔滨旅游,20220516,全国,全国,179,70,109
哈尔滨旅游,20220517,全国,全国,213,66,147
哈尔滨旅游,20220518,全国,全国,164,64,100
哈尔滨旅游,20220519,全国,全国,179,64,115
哈尔滨旅游,20220520,全国,全国,230,72,158
哈尔滨旅游,20220521,全国,全国,225,68,157
哈尔滨旅游,20220522,全国,全国,213,68,145
哈尔滨旅游,20220523,全国,全国,232,66,166
哈尔滨旅游,20220524,全国,全国,215,72,143
哈尔滨旅游,20220525,全国,全国,234,83,151
哈尔滨旅游,20220526,全国,全国,236,74,162
哈尔滨旅游,20220527,全国,全国,219,68,151
哈尔滨旅游,20220528,全国,全国,248,74,174
哈尔滨旅游,20220529,全国,全国,217,66,151
哈尔滨旅游,20220530,全国,全国,238,93,145
哈尔滨旅游,20220531,全国,全国,205,80,125
哈尔滨旅游,20220601,全国,全国,208,74,134
哈尔滨旅游,20220602,全国,全国,268,97,171
哈尔滨旅游,20220603,全国,全国,232,68,164
哈尔滨旅游,20220604,全国,全国,218,61,157
哈尔滨旅游,20220605,全国,全国,219,59,160
哈尔滨旅游,20220606,全国,全国,268,72,196
哈尔滨旅游,20220607,全国,全国,246,76,170
哈尔滨旅游,20220608,全国,全国,269,83,186
哈尔滨旅游,20220609,全国,全国,359,97,262
哈尔滨旅游,20220610,全国,全国,263,85,178
哈尔滨旅游,20220611,全国,全国,238,68,170
哈尔滨旅游,20220612,全国,全国,227,63,164
哈尔滨旅游,20220613,全国,全国,283,85,198
哈尔滨旅游,20220614,全国,全国,269,91,178
哈尔滨旅游,20220615,全国,全国,246,78,168
哈尔滨旅游,20220616,全国,全国,250,74,176
哈尔滨旅游,20220617,全国,全国,286,85,201
哈尔滨旅游,20220618,全国,全国,256,66,190
哈尔滨旅游,20220619,全国,全国,287,66,221
哈尔滨旅游,20220620,全国,全国,281,72,209
哈尔滨旅游,20220621,全国,全国,270,91,179
哈尔滨旅游,20220622,全国,全国,295,83,212
哈尔滨旅游,20220623,全国,全国,314,89,225
哈尔滨旅游,20220624,全国,全国,347,99,248
哈尔滨旅游,20220625,全国,全国,249,63,186
哈尔滨旅游,20220626,全国,全国,293,85,208
哈尔滨旅游,20220627,全国,全国,312,97,215
哈尔滨旅游,20220628,全国,全国,336,121,215
哈尔滨旅游,20220629,全国,全国,367,108,259
哈尔滨旅游,20220630,全国,全国,382,125,257
哈尔滨旅游,20220701,全国,全国,353,93,260
哈尔滨旅游,20220702,全国,全国,351,87,264
哈尔滨旅游,20220703,全国,全国,356,72,284
哈尔滨旅游,20220704,全国,全国,391,121,270
哈尔滨旅游,20220705,全国,全国,419,123,296
哈尔滨旅游,20220706,全国,全国,408,116,292
哈尔滨旅游,20220707,全国,全国,392,93,299
哈尔滨旅游,20220708,全国,全国,407,101,306
哈尔滨旅游,20220709,全国,全国,395,83,312
哈尔滨旅游,20220710,全国,全国,408,66,342
哈尔滨旅游,20220711,全国,全国,477,139,338
哈尔滨旅游,20220712,全国,全国,509,121,388
哈尔滨旅游,20220713,全国,全国,500,120,380
哈尔滨旅游,20220714,全国,全国,531,144,387
哈尔滨旅游,20220715,全国,全国,510,133,377
哈尔滨旅游,20220716,全国,全国,409,89,320
哈尔滨旅游,20220717,全国,全国,348,93,255
哈尔滨旅游,20220718,全国,全国,401,159,242
哈尔滨旅游,20220719,全国,全国,415,123,292
哈尔滨旅游,20220720,全国,全国,388,110,278
哈尔滨旅游,20220721,全国,全国,449,116,333
哈尔滨旅游,20220722,全国,全国,433,125,308
哈尔滨旅游,20220723,全国,全国,390,78,312
哈尔滨旅游,20220724,全国,全国,394,82,312
哈尔滨旅游,20220725,全国,全国,515,150,365
哈尔滨旅游,20220726,全国,全国,444,118,326
哈尔滨旅游,20220727,全国,全国,448,121,327
哈尔滨旅游,20220728,全国,全国,416,116,300
哈尔滨旅游,20220729,全国,全国,436,110,326
哈尔滨旅游,20220730,全国,全国,440,99,341
哈尔滨旅游,20220731,全国,全国,437,95,342
哈尔滨旅游,20220801,全国,全国,493,158,335
哈尔滨旅游,20220802,全国,全国,445,137,308
哈尔滨旅游,20220803,全国,全国,436,140,296
哈尔滨旅游,20220804,全国,全国,485,152,333
哈尔滨旅游,20220805,全国,全国,502,129,373
哈尔滨旅游,20220806,全国,全国,386,74,312
哈尔滨旅游,20220807,全国,全国,402,72,330
哈尔滨旅游,20220808,全国,全国,450,137,313
哈尔滨旅游,20220809,全国,全国,392,121,271
哈尔滨旅游,20220810,全国,全国,409,125,284
哈尔滨旅游,20220811,全国,全国,356,102,254
哈尔滨旅游,20220812,全国,全国,344,112,232
哈尔滨旅游,20220813,全国,全国,317,70,247
哈尔滨旅游,20220814,全国,全国,325,82,243
哈尔滨旅游,20220815,全国,全国,383,120,263
哈尔滨旅游,20220816,全国,全国,354,101,253
哈尔滨旅游,20220817,全国,全国,331,102,229
哈尔滨旅游,20220818,全国,全国,322,114,208
哈尔滨旅游,20220819,全国,全国,323,99,224
哈尔滨旅游,20220820,全国,全国,285,82,203
哈尔滨旅游,20220821,全国,全国,245,72,173
哈尔滨旅游,20220822,全国,全国,291,99,192
哈尔滨旅游,20220823,全国,全国,297,121,176
哈尔滨旅游,20220824,全国,全国,329,104,225
哈尔滨旅游,20220825,全国,全国,284,97,187
哈尔滨旅游,20220826,全国,全国,338,85,253
哈尔滨旅游,20220827,全国,全国,256,74,182
哈尔滨旅游,20220828,全国,全国,228,63,165
哈尔滨旅游,20220829,全国,全国,194,82,112
哈尔滨旅游,20220830,全国,全国,193,87,106
哈尔滨旅游,20220831,全国,全国,201,80,121
哈尔滨旅游,20220901,全国,全国,197,87,110
哈尔滨旅游,20220902,全国,全国,165,76,89
哈尔滨旅游,20220903,全国,全国,179,64,115
哈尔滨旅游,20220904,全国,全国,192,61,131
哈尔滨旅游,20220905,全国,全国,186,76,110
哈尔滨旅游,20220906,全国,全国,174,74,100
哈尔滨旅游,20220907,全国,全国,193,80,113
哈尔滨旅游,20220908,全国,全国,199,82,117
哈尔滨旅游,20220909,全国,全国,178,61,117
哈尔滨旅游,20220910,全国,全国,173,63,110
哈尔滨旅游,20220911,全国,全国,207,68,139
哈尔滨旅游,20220912,全国,全国,189,63,126
哈尔滨旅游,20220913,全国,全国,221,83,138
哈尔滨旅游,20220914,全国,全国,218,83,135
哈尔滨旅游,20220915,全国,全国,218,83,135
哈尔滨旅游,20220916,全国,全国,228,85,143
哈尔滨旅游,20220917,全国,全国,256,70,186
哈尔滨旅游,20220918,全国,全国,243,82,161
哈尔滨旅游,20220919,全国,全国,276,106,170
哈尔滨旅游,20220920,全国,全国,230,89,141
哈尔滨旅游,20220921,全国,全国,217,95,122
哈尔滨旅游,20220922,全国,全国,229,91,138
哈尔滨旅游,20220923,全国,全国,227,93,134
哈尔滨旅游,20220924,全国,全国,197,66,131
哈尔滨旅游,20220925,全国,全国,215,68,147
哈尔滨旅游,20220926,全国,全国,246,108,138
哈尔滨旅游,20220927,全国,全国,246,116,130
哈尔滨旅游,20220928,全国,全国,204,83,121
哈尔滨旅游,20220929,全国,全国,227,76,151
哈尔滨旅游,20220930,全国,全国,257,83,174
哈尔滨旅游,20221001,全国,全国,194,64,130
哈尔滨旅游,20221002,全国,全国,200,74,126
哈尔滨旅游,20221003,全国,全国,211,68,143
哈尔滨旅游,20221004,全国,全国,194,64,130
哈尔滨旅游,20221005,全国,全国,172,64,108
哈尔滨旅游,20221006,全国,全国,215,66,149
哈尔滨旅游,20221007,全国,全国,264,85,179
哈尔滨旅游,20221008,全国,全国,222,101,121
哈尔滨旅游,20221009,全国,全国,238,97,141
哈尔滨旅游,20221010,全国,全国,206,91,115
哈尔滨旅游,20221011,全国,全国,230,95,135
哈尔滨旅游,20221012,全国,全国,195,74,121
哈尔滨旅游,20221013,全国,全国,189,89,100
哈尔滨旅游,20221014,全国,全国,201,89,112
哈尔滨旅游,20221015,全国,全国,202,66,136
哈尔滨旅游,20221016,全国,全国,188,80,108
哈尔滨旅游,20221017,全国,全国,227,101,126
哈尔滨旅游,20221018,全国,全国,232,91,141
哈尔滨旅游,20221019,全国,全国,208,82,126
哈尔滨旅游,20221020,全国,全国,248,104,144
哈尔滨旅游,20221021,全国,全国,241,87,154
哈尔滨旅游,20221022,全国,全国,213,74,139
哈尔滨旅游,20221023,全国,全国,215,72,143
哈尔滨旅游,20221024,全国,全国,235,74,161
哈尔滨旅游,20221025,全国,全国,221,85,136
哈尔滨旅游,20221026,全国,全国,234,99,135
哈尔滨旅游,20221027,全国,全国,220,85,135
哈尔滨旅游,20221028,全国,全国,208,83,125
哈尔滨旅游,20221029,全国,全国,214,78,136
哈尔滨旅游,20221030,全国,全国,190,59,131
哈尔滨旅游,20221031,全国,全国,217,82,135
哈尔滨旅游,20221101,全国,全国,193,80,113
哈尔滨旅游,20221102,全国,全国,218,83,135
哈尔滨旅游,20221103,全国,全国,198,83,115
哈尔滨旅游,20221104,全国,全国,186,74,112
哈尔滨旅游,20221105,全国,全国,199,63,136
哈尔滨旅游,20221106,全国,全国,209,66,143
哈尔滨旅游,20221107,全国,全国,229,101,128
哈尔滨旅游,20221108,全国,全国,206,89,117
哈尔滨旅游,20221109,全国,全国,216,82,134
哈尔滨旅游,20221110,全国,全国,190,78,112
哈尔滨旅游,20221111,全国,全国,215,74,141
哈尔滨旅游,20221112,全国,全国,220,63,157
哈尔滨旅游,20221113,全国,全国,223,66,157
哈尔滨旅游,20221114,全国,全国,247,102,145
哈尔滨旅游,20221115,全国,全国,229,106,123
哈尔滨旅游,20221116,全国,全国,255,110,145
哈尔滨旅游,20221117,全国,全国,275,110,165
哈尔滨旅游,20221118,全国,全国,260,97,163
哈尔滨旅游,20221119,全国,全国,233,78,155
哈尔滨旅游,20221120,全国,全国,238,72,166
哈尔滨旅游,20221121,全国,全国,260,97,163
哈尔滨旅游,20221122,全国,全国,252,91,161
哈尔滨旅游,20221123,全国,全国,224,85,139
哈尔滨旅游,20221124,全国,全国,213,70,143
哈尔滨旅游,20221125,全国,全国,217,85,132
哈尔滨旅游,20221126,全国,全国,190,68,122
哈尔滨旅游,20221127,全国,全国,131,0,131
哈尔滨旅游,20221128,全国,全国,242,99,143
哈尔滨旅游,20221129,全国,全国,204,78,126
哈尔滨旅游,20221130,全国,全国,199,78,121
哈尔滨旅游,20221201,全国,全国,209,78,131
哈尔滨旅游,20221202,全国,全国,230,87,143
哈尔滨旅游,20221203,全国,全国,227,82,145
哈尔滨旅游,20221204,全国,全国,219,78,141
哈尔滨旅游,20221205,全国,全国,335,108,227
哈尔滨旅游,20221206,全国,全国,319,118,201
哈尔滨旅游,20221207,全国,全国,333,135,198
哈尔滨旅游,20221208,全国,全国,405,142,263
哈尔滨旅游,20221209,全国,全国,328,133,195
哈尔滨旅游,20221210,全国,全国,292,95,197
哈尔滨旅游,20221211,全国,全国,287,91,196
哈尔滨旅游,20221212,全国,全国,333,127,206
哈尔滨旅游,20221213,全国,全国,313,120,193
哈尔滨旅游,20221214,全国,全国,294,108,186
哈尔滨旅游,20221215,全国,全国,314,148,166
哈尔滨旅游,20221216,全国,全国,259,102,157
哈尔滨旅游,20221217,全国,全国,241,82,159
哈尔滨旅游,20221218,全国,全国,253,76,177
哈尔滨旅游,20221219,全国,全国,288,112,176
哈尔滨旅游,20221220,全国,全国,256,93,163
哈尔滨旅游,20221221,全国,全国,311,112,199
哈尔滨旅游,20221222,全国,全国,288,114,174
哈尔滨旅游,20221223,全国,全国,330,102,228
哈尔滨旅游,20221224,全国,全国,270,83,187
哈尔滨旅游,20221225,全国,全国,348,87,261
哈尔滨旅游,20221226,全国,全国,399,139,260
哈尔滨旅游,20221227,全国,全国,429,154,275
哈尔滨旅游,20221228,全国,全国,409,140,269
哈尔滨旅游,20221229,全国,全国,429,175,254
哈尔滨旅游,20221230,全国,全国,378,131,247
哈尔滨旅游,20221231,全国,全国,359,91,268
哈尔滨旅游,20230101,全国,全国,355,93,262
哈尔滨旅游,20230102,全国,全国,390,102,288
哈尔滨旅游,20230103,全国,全国,460,159,301
哈尔滨旅游,20230104,全国,全国,473,182,291
哈尔滨旅游,20230105,全国,全国,524,175,349
哈尔滨旅游,20230106,全国,全国,517,179,338
哈尔滨旅游,20230107,全国,全国,482,129,353
哈尔滨旅游,20230108,全国,全国,491,110,381
哈尔滨旅游,20230109,全国,全国,556,191,365
哈尔滨旅游,20230110,全国,全国,510,172,338
哈尔滨旅游,20230111,全国,全国,573,155,418
哈尔滨旅游,20230112,全国,全国,561,163,398
哈尔滨旅游,20230113,全国,全国,703,142,561
哈尔滨旅游,20230114,全国,全国,638,110,528
哈尔滨旅游,20230115,全国,全国,782,118,664
哈尔滨旅游,20230116,全国,全国,654,162,492
哈尔滨旅游,20230117,全国,全国,769,177,592
哈尔滨旅游,20230118,全国,全国,992,151,841
哈尔滨旅游,20230119,全国,全国,601,133,468
哈尔滨旅游,20230120,全国,全国,559,91,468
哈尔滨旅游,20230121,全国,全国,360,80,280
哈尔滨旅游,20230122,全国,全国,1071,87,984
哈尔滨旅游,20230123,全国,全国,735,78,657
哈尔滨旅游,20230124,全国,全国,725,112,613
哈尔滨旅游,20230125,全国,全国,561,89,472
哈尔滨旅游,20230126,全国,全国,566,87,479
哈尔滨旅游,20230127,全国,全国,595,91,504
哈尔滨旅游,20230128,全国,全国,644,157,487
哈尔滨旅游,20230129,全国,全国,620,162,458
哈尔滨旅游,20230130,全国,全国,574,144,430
哈尔滨旅游,20230131,全国,全国,544,112,432
哈尔滨旅游,20230201,全国,全国,560,123,437
哈尔滨旅游,20230202,全国,全国,485,116,369
哈尔滨旅游,20230203,全国,全国,482,112,370
哈尔滨旅游,20230204,全国,全国,548,76,472
哈尔滨旅游,20230205,全国,全国,511,74,437
哈尔滨旅游,20230206,全国,全国,442,112,330
哈尔滨旅游,20230207,全国,全国,494,110,384
哈尔滨旅游,20230208,全国,全国,451,82,369
哈尔滨旅游,20230209,全国,全国,443,102,341
哈尔滨旅游,20230210,全国,全国,451,89,362
哈尔滨旅游,20230211,全国,全国,482,74,408
哈尔滨旅游,20230212,全国,全国,372,76,296
哈尔滨旅游,20230213,全国,全国,398,91,307
哈尔滨旅游,20230214,全国,全国,418,80,338
哈尔滨旅游,20230215,全国,全国,391,93,298
哈尔滨旅游,20230216,全国,全国,352,85,267
哈尔滨旅游,20230217,全国,全国,382,87,295
哈尔滨旅游,20230218,全国,全国,421,72,349
哈尔滨旅游,20230219,全国,全国,519,76,443
哈尔滨旅游,20230220,全国,全国,430,85,345
哈尔滨旅游,20230221,全国,全国,902,104,798
哈尔滨旅游,20230222,全国,全国,679,101,578
哈尔滨旅游,20230223,全国,全国,967,87,880
哈尔滨旅游,20230224,全国,全国,396,83,313
哈尔滨旅游,20230225,全国,全国,314,66,248
哈尔滨旅游,20230226,全国,全国,263,74,189
哈尔滨旅游,20230227,全国,全国,374,80,294
哈尔滨旅游,20230228,全国,全国,368,97,271
哈尔滨旅游,20230301,全国,全国,457,76,381
哈尔滨旅游,20230302,全国,全国,328,74,254
哈尔滨旅游,20230303,全国,全国,263,89,174
哈尔滨旅游,20230304,全国,全国,234,80,154
哈尔滨旅游,20230305,全国,全国,227,63,164
哈尔滨旅游,20230306,全国,全国,240,83,157
哈尔滨旅游,20230307,全国,全国,230,85,145
哈尔滨旅游,20230308,全国,全国,217,72,145
哈尔滨旅游,20230309,全国,全国,236,82,154
哈尔滨旅游,20230310,全国,全国,221,66,155
哈尔滨旅游,20230311,全国,全国,211,64,147
哈尔滨旅游,20230312,全国,全国,265,66,199
哈尔滨旅游,20230313,全国,全国,258,85,173
哈尔滨旅游,20230314,全国,全国,248,85,163
哈尔滨旅游,20230315,全国,全国,258,85,173
哈尔滨旅游,20230316,全国,全国,275,101,174
哈尔滨旅游,20230317,全国,全国,269,89,180
哈尔滨旅游,20230318,全国,全国,261,64,197
哈尔滨旅游,20230319,全国,全国,232,70,162
哈尔滨旅游,20230320,全国,全国,281,95,186
哈尔滨旅游,20230321,全国,全国,286,101,185
哈尔滨旅游,20230322,全国,全国,268,95,173
哈尔滨旅游,20230323,全国,全国,262,102,160
哈尔滨旅游,20230324,全国,全国,280,99,181
哈尔滨旅游,20230325,全国,全国,248,78,170
哈尔滨旅游,20230326,全国,全国,275,85,190
哈尔滨旅游,20230327,全国,全国,288,104,184
哈尔滨旅游,20230328,全国,全国,288,108,180
哈尔滨旅游,20230329,全国,全国,317,125,192
哈尔滨旅游,20230330,全国,全国,311,135,176
哈尔滨旅游,20230331,全国,全国,299,112,187
哈尔滨旅游,20230401,全国,全国,272,76,196
哈尔滨旅游,20230402,全国,全国,265,68,197
哈尔滨旅游,20230403,全国,全国,325,121,204
哈尔滨旅游,20230404,全国,全国,343,104,239
哈尔滨旅游,20230405,全国,全国,289,83,206
哈尔滨旅游,20230406,全国,全国,309,104,205
哈尔滨旅游,20230407,全国,全国,312,133,179
哈尔滨旅游,20230408,全国,全国,283,85,198
哈尔滨旅游,20230409,全国,全国,282,70,212
哈尔滨旅游,20230410,全国,全国,343,125,218
哈尔滨旅游,20230411,全国,全国,313,120,193
哈尔滨旅游,20230412,全国,全国,322,129,193
哈尔滨旅游,20230413,全国,全国,321,129,192
哈尔滨旅游,20230414,全国,全国,350,116,234
哈尔滨旅游,20230415,全国,全国,292,87,205
哈尔滨旅游,20230416,全国,全国,317,82,235
哈尔滨旅游,20230417,全国,全国,364,137,227
哈尔滨旅游,20230418,全国,全国,335,118,217
哈尔滨旅游,20230419,全国,全国,343,118,225
哈尔滨旅游,20230420,全国,全国,375,137,238
哈尔滨旅游,20230421,全国,全国,356,118,238
哈尔滨旅游,20230422,全国,全国,341,95,246
哈尔滨旅游,20230423,全国,全国,346,121,225
哈尔滨旅游,20230424,全国,全国,340,120,220
哈尔滨旅游,20230425,全国,全国,538,116,422
哈尔滨旅游,20230426,全国,全国,380,127,253
哈尔滨旅游,20230427,全国,全国,402,135,267
哈尔滨旅游,20230428,全国,全国,433,110,323
哈尔滨旅游,20230429,全国,全国,451,74,377
哈尔滨旅游,20230430,全国,全国,489,83,406
哈尔滨旅游,20230501,全国,全国,504,72,432
哈尔滨旅游,20230502,全国,全国,324,68,256
哈尔滨旅游,20230503,全国,全国,291,74,217
哈尔滨旅游,20230504,全国,全国,307,121,186
哈尔滨旅游,20230505,全国,全国,280,110,170
哈尔滨旅游,20230506,全国,全国,258,99,159
哈尔滨旅游,20230507,全国,全国,263,80,183
哈尔滨旅游,20230508,全国,全国,275,101,174
哈尔滨旅游,20230509,全国,全国,271,89,182
哈尔滨旅游,20230510,全国,全国,289,112,177
哈尔滨旅游,20230511,全国,全国,254,99,155
哈尔滨旅游,20230512,全国,全国,270,102,168
哈尔滨旅游,20230513,全国,全国,262,78,184
哈尔滨旅游,20230514,全国,全国,284,76,208
哈尔滨旅游,20230515,全国,全国,289,102,187
哈尔滨旅游,20230516,全国,全国,260,89,171
哈尔滨旅游,20230517,全国,全国,266,85,181
哈尔滨旅游,20230518,全国,全国,283,110,173
哈尔滨旅游,20230519,全国,全国,259,89,170
哈尔滨旅游,20230520,全国,全国,261,72,189
哈尔滨旅游,20230521,全国,全国,234,61,173
哈尔滨旅游,20230522,全国,全国,246,85,161
哈尔滨旅游,20230523,全国,全国,279,82,197
哈尔滨旅游,20230524,全国,全国,295,106,189
哈尔滨旅游,20230525,全国,全国,254,83,171
哈尔滨旅游,20230526,全国,全国,238,83,155
哈尔滨旅游,20230527,全国,全国,267,74,193
哈尔滨旅游,20230528,全国,全国,288,74,214
哈尔滨旅游,20230529,全国,全国,320,125,195
哈尔滨旅游,20230530,全国,全国,270,97,173
哈尔滨旅游,20230531,全国,全国,281,99,182
哈尔滨旅游,20230601,全国,全国,244,93,151
哈尔滨旅游,20230602,全国,全国,317,106,211
哈尔滨旅游,20230603,全国,全国,278,85,193
哈尔滨旅游,20230604,全国,全国,273,72,201
哈尔滨旅游,20230605,全国,全国,311,116,195
哈尔滨旅游,20230606,全国,全国,311,121,190
哈尔滨旅游,20230607,全国,全国,331,123,208
哈尔滨旅游,20230608,全国,全国,344,139,205
哈尔滨旅游,20230609,全国,全国,330,129,201
哈尔滨旅游,20230610,全国,全国,272,76,196
哈尔滨旅游,20230611,全国,全国,344,80,264
哈尔滨旅游,20230612,全国,全国,340,118,222
哈尔滨旅游,20230613,全国,全国,389,155,234
哈尔滨旅游,20230614,全国,全国,367,140,227
哈尔滨旅游,20230615,全国,全国,349,125,224
哈尔滨旅游,20230616,全国,全国,342,108,234
哈尔滨旅游,20230617,全国,全国,334,95,239
哈尔滨旅游,20230618,全国,全国,359,91,268
哈尔滨旅游,20230619,全国,全国,358,140,218
哈尔滨旅游,20230620,全国,全国,389,144,245
哈尔滨旅游,20230621,全国,全国,421,125,296
哈尔滨旅游,20230622,全国,全国,384,78,306
哈尔滨旅游,20230623,全国,全国,345,76,269
哈尔滨旅游,20230624,全国,全国,391,93,298
哈尔滨旅游,20230625,全国,全国,432,154,278
哈尔滨旅游,20230626,全国,全国,405,148,257
哈尔滨旅游,20230627,全国,全国,465,158,307
哈尔滨旅游,20230628,全国,全国,445,161,284
哈尔滨旅游,20230629,全国,全国,466,135,331
哈尔滨旅游,20230630,全国,全国,435,129,306
哈尔滨旅游,20230701,全国,全国,457,87,370
哈尔滨旅游,20230702,全国,全国,415,78,337
哈尔滨旅游,20230703,全国,全国,526,157,369
哈尔滨旅游,20230704,全国,全国,502,161,341
哈尔滨旅游,20230705,全国,全国,544,177,367
哈尔滨旅游,20230706,全国,全国,442,133,309
哈尔滨旅游,20230707,全国,全国,551,175,376
哈尔滨旅游,20230708,全国,全国,469,99,370
哈尔滨旅游,20230709,全国,全国,514,110,404
哈尔滨旅游,20230710,全国,全国,673,216,457
哈尔滨旅游,20230711,全国,全国,570,159,411
哈尔滨旅游,20230712,全国,全国,575,170,405
哈尔滨旅游,20230713,全国,全国,525,169,356
哈尔滨旅游,20230714,全国,全国,551,168,383
哈尔滨旅游,20230715,全国,全国,709,114,595
哈尔滨旅游,20230716,全国,全国,651,101,550
哈尔滨旅游,20230717,全国,全国,623,175,448
哈尔滨旅游,20230718,全国,全国,658,180,478
哈尔滨旅游,20230719,全国,全国,568,142,426
哈尔滨旅游,20230720,全国,全国,588,158,430
哈尔滨旅游,20230721,全国,全国,609,159,450
哈尔滨旅游,20230722,全国,全国,538,101,437
哈尔滨旅游,20230723,全国,全国,543,106,437
哈尔滨旅游,20230724,全国,全国,648,197,451
哈尔滨旅游,20230725,全国,全国,626,197,429
哈尔滨旅游,20230726,全国,全国,621,163,458
哈尔滨旅游,20230727,全国,全国,585,159,426
哈尔滨旅游,20230728,全国,全国,614,154,460
哈尔滨旅游,20230729,全国,全国,799,101,698
哈尔滨旅游,20230730,全国,全国,731,93,638
哈尔滨旅游,20230731,全国,全国,853,157,696
哈尔滨旅游,20230801,全国,全国,674,162,512
哈尔滨旅游,20230802,全国,全国,511,159,352
哈尔滨旅游,20230803,全国,全国,743,179,564
哈尔滨旅游,20230804,全国,全国,835,146,689
哈尔滨旅游,20230805,全国,全国,572,82,490
哈尔滨旅游,20230806,全国,全国,544,76,468
哈尔滨旅游,20230807,全国,全国,606,133,473
哈尔滨旅游,20230808,全国,全国,602,123,479
哈尔滨旅游,20230809,全国,全国,589,121,468
哈尔滨旅游,20230810,全国,全国,627,106,521
哈尔滨旅游,20230811,全国,全国,541,127,414
哈尔滨旅游,20230812,全国,全国,475,91,384
哈尔滨旅游,20230813,全国,全国,515,85,430
哈尔滨旅游,20230814,全国,全国,629,157,472
哈尔滨旅游,20230815,全国,全国,546,139,407
哈尔滨旅游,20230816,全国,全国,519,131,388
哈尔滨旅游,20230817,全国,全国,607,131,476
哈尔滨旅游,20230818,全国,全国,574,131,443
哈尔滨旅游,20230819,全国,全国,405,82,323
哈尔滨旅游,20230820,全国,全国,445,83,362
哈尔滨旅游,20230821,全国,全国,479,123,356
哈尔滨旅游,20230822,全国,全国,437,114,323
哈尔滨旅游,20230823,全国,全国,465,116,349
哈尔滨旅游,20230824,全国,全国,412,116,296
哈尔滨旅游,20230825,全国,全国,428,120,308
哈尔滨旅游,20230826,全国,全国,458,74,384
哈尔滨旅游,20230827,全国,全国,423,83,340
哈尔滨旅游,20230828,全国,全国,496,127,369
哈尔滨旅游,20230829,全国,全国,952,110,842
哈尔滨旅游,20230830,全国,全国,428,114,314
哈尔滨旅游,20230831,全国,全国,548,114,434
哈尔滨旅游,20230901,全国,全国,406,101,305
哈尔滨旅游,20230902,全国,全国,295,74,221
哈尔滨旅游,20230903,全国,全国,294,80,214
哈尔滨旅游,20230904,全国,全国,359,137,222
哈尔滨旅游,20230905,全国,全国,376,121,255
哈尔滨旅游,20230906,全国,全国,312,104,208
哈尔滨旅游,20230907,全国,全国,304,133,171
哈尔滨旅游,20230908,全国,全国,320,120,200
哈尔滨旅游,20230909,全国,全国,336,87,249
哈尔滨旅游,20230910,全国,全国,288,85,203
哈尔滨旅游,20230911,全国,全国,357,139,218
哈尔滨旅游,20230912,全国,全国,356,142,214
哈尔滨旅游,20230913,全国,全国,348,137,211
哈尔滨旅游,20230914,全国,全国,394,169,225
哈尔滨旅游,20230915,全国,全国,362,127,235
哈尔滨旅游,20230916,全国,全国,292,93,199
哈尔滨旅游,20230917,全国,全国,348,89,259
哈尔滨旅游,20230918,全国,全国,383,159,224
哈尔滨旅游,20230919,全国,全国,375,144,231
哈尔滨旅游,20230920,全国,全国,333,121,212
哈尔滨旅游,20230921,全国,全国,397,137,260
哈尔滨旅游,20230922,全国,全国,350,123,227
哈尔滨旅游,20230923,全国,全国,324,76,248
哈尔滨旅游,20230924,全国,全国,307,80,227
哈尔滨旅游,20230925,全国,全国,362,162,200
哈尔滨旅游,20230926,全国,全国,358,152,206
哈尔滨旅游,20230927,全国,全国,407,161,246
哈尔滨旅游,20230928,全国,全国,427,173,254
哈尔滨旅游,20230929,全国,全国,365,76,289
哈尔滨旅游,20230930,全国,全国,456,93,363
哈尔滨旅游,20231001,全国,全国,455,89,366
哈尔滨旅游,20231002,全国,全国,436,70,366
哈尔滨旅游,20231003,全国,全国,383,82,301
哈尔滨旅游,20231004,全国,全国,346,80,266
哈尔滨旅游,20231005,全国,全国,308,76,232
哈尔滨旅游,20231006,全国,全国,313,93,220
哈尔滨旅游,20231007,全国,全国,393,173,220
哈尔滨旅游,20231008,全国,全国,407,180,227
哈尔滨旅游,20231009,全国,全国,386,175,211
哈尔滨旅游,20231010,全国,全国,347,139,208
哈尔滨旅游,20231011,全国,全国,343,137,206
哈尔滨旅游,20231012,全国,全国,720,146,574
哈尔滨旅游,20231013,全国,全国,460,159,301
哈尔滨旅游,20231014,全国,全国,388,93,295
哈尔滨旅游,20231015,全国,全国,369,82,287
哈尔滨旅游,20231016,全国,全国,470,209,261
哈尔滨旅游,20231017,全国,全国,492,166,326
哈尔滨旅游,20231018,全国,全国,520,180,340
哈尔滨旅游,20231019,全国,全国,504,183,321
哈尔滨旅游,20231020,全国,全国,394,175,219
哈尔滨旅游,20231021,全国,全国,340,102,238
哈尔滨旅游,20231022,全国,全国,311,87,224
哈尔滨旅游,20231023,全国,全国,394,180,214
哈尔滨旅游,20231024,全国,全国,451,166,285
哈尔滨旅游,20231025,全国,全国,456,187,269
哈尔滨旅游,20231026,全国,全国,478,168,310
哈尔滨旅游,20231027,全国,全国,500,183,317
哈尔滨旅游,20231028,全国,全国,505,104,401
哈尔滨旅游,20231029,全国,全国,423,106,317
哈尔滨旅游,20231030,全国,全国,545,183,362
哈尔滨旅游,20231031,全国,全国,576,204,372
哈尔滨旅游,20231101,全国,全国,538,158,380
哈尔滨旅游,20231102,全国,全国,574,194,380
哈尔滨旅游,20231103,全国,全国,575,176,399
哈尔滨旅游,20231104,全国,全国,414,102,312
哈尔滨旅游,20231105,全国,全国,469,114,355
哈尔滨旅游,20231106,全国,全国,682,243,439
哈尔滨旅游,20231107,全国,全国,624,229,395
哈尔滨旅游,20231108,全国,全国,742,234,508
哈尔滨旅游,20231109,全国,全国,755,212,543
哈尔滨旅游,20231110,全国,全国,873,207,666
哈尔滨旅游,20231111,全国,全国,580,108,472
哈尔滨旅游,20231112,全国,全国,682,131,551
哈尔滨旅游,20231113,全国,全国,871,346,525
哈尔滨旅游,20231114,全国,全国,863,273,590
哈尔滨旅游,20231115,全国,全国,726,234,492
哈尔滨旅游,20231116,全国,全国,733,211,522
哈尔滨旅游,20231117,全国,全国,910,166,744
哈尔滨旅游,20231118,全国,全国,710,97,613
哈尔滨旅游,20231119,全国,全国,677,106,571
哈尔滨旅游,20231120,全国,全国,867,240,627
哈尔滨旅游,20231121,全国,全国,846,216,630
哈尔滨旅游,20231122,全国,全国,842,247,595
哈尔滨旅游,20231123,全国,全国,710,223,487
哈尔滨旅游,20231124,全国,全国,827,207,620
哈尔滨旅游,20231125,全国,全国,705,110,595
哈尔滨旅游,20231126,全国,全国,822,99,723
哈尔滨旅游,20231127,全国,全国,884,245,639
哈尔滨旅游,20231128,全国,全国,728,209,519
哈尔滨旅游,20231129,全国,全国,892,225,667
哈尔滨旅游,20231130,全国,全国,1083,234,849
哈尔滨旅游,20231201,全国,全国,852,172,680
哈尔滨旅游,20231202,全国,全国,853,108,745
哈尔滨旅游,20231203,全国,全国,848,114,734
哈尔滨旅游,20231204,全国,全国,953,245,708
哈尔滨旅游,20231205,全国,全国,956,229,727
哈尔滨旅游,20231206,全国,全国,883,226,657
哈尔滨旅游,20231207,全国,全国,959,211,748
哈尔滨旅游,20231208,全国,全国,780,163,617
哈尔滨旅游,20231209,全国,全国,896,106,790
哈尔滨旅游,20231210,全国,全国,778,108,670
哈尔滨旅游,20231211,全国,全国,769,223,546
哈尔滨旅游,20231212,全国,全国,724,233,491
哈尔滨旅游,20231213,全国,全国,837,212,625
哈尔滨旅游,20231214,全国,全国,1060,239,821
哈尔滨旅游,20231215,全国,全国,7887,198,7689
哈尔滨旅游,20231216,全国,全国,1069,102,967
哈尔滨旅游,20231217,全国,全国,772,120,652
哈尔滨旅游,20231218,全国,全国,814,216,598
哈尔滨旅游,20231219,全国,全国,735,213,522
哈尔滨旅游,20231220,全国,全国,744,215,529
哈尔滨旅游,20231221,全国,全国,890,180,710
哈尔滨旅游,20231222,全国,全国,731,161,570
哈尔滨旅游,20231223,全国,全国,738,106,632
哈尔滨旅游,20231224,全国,全国,695,121,574
哈尔滨旅游,20231225,全国,全国,1070,251,819
哈尔滨旅游,20231226,全国,全国,946,257,689
哈尔滨旅游,20231227,全国,全国,1086,228,858
哈尔滨旅游,20231228,全国,全国,1022,218,804
哈尔滨旅游,20231229,全国,全国,943,180,763
哈尔滨旅游,20231230,全国,全国,911,184,727
哈尔滨旅游,20231231,全国,全国,998,148,850
哈尔滨旅游,20240101,全国,全国,1069,175,894
哈尔滨旅游,20240102,全国,全国,1696,806,890
哈尔滨旅游,20240103,全国,全国,1788,846,942
哈尔滨旅游,20240104,全国,全国,2282,860,1422
哈尔滨旅游,20240105,全国,全国,1990,774,1216
哈尔滨旅游,20240106,全国,全国,1521,377,1144
哈尔滨旅游,20240107,全国,全国,2017,408,1609
哈尔滨旅游,20240108,全国,全国,2301,735,1566
哈尔滨旅游,20240109,全国,全国,5600,628,4972
哈尔滨旅游,20240110,全国,全国,1796,537,1259
哈尔滨旅游,20240111,全国,全国,1599,523,1076
哈尔滨旅游,20240112,全国,全国,2033,425,1608
哈尔滨旅游,20240113,全国,全国,1589,250,1339
哈尔滨旅游,20240114,全国,全国,2015,260,1755
哈尔滨旅游,20240115,全国,全国,1739,439,1300
哈尔滨旅游,20240116,全国,全国,4328,430,3898
哈尔滨旅游,20240117,全国,全国,3744,402,3342
哈尔滨旅游,20240118,全国,全国,3235,287,2948
哈尔滨旅游,20240119,全国,全国,2879,330,2549
哈尔滨旅游,20240120,全国,全国,1628,188,1440
哈尔滨旅游,20240121,全国,全国,2117,228,1889
哈尔滨旅游,20240122,全国,全国,1999,318,1681
哈尔滨旅游,20240123,全国,全国,3233,330,2903
哈尔滨旅游,20240124,全国,全国,3939,279,3660
哈尔滨旅游,20240125,全国,全国,6261,213,6048
哈尔滨旅游,20240126,全国,全国,6288,208,6080
哈尔滨旅游,20240127,全国,全国,4100,169,3931
哈尔滨旅游,20240128,全国,全国,3448,168,3280
哈尔滨旅游,20240129,全国,全国,5510,288,5222
哈尔滨旅游,20240130,全国,全国,10508,237,10271
哈尔滨旅游,20240131,全国,全国,10790,281,10509
哈尔滨旅游,20240201,全国,全国,10885,212,10673
哈尔滨旅游,20240202,全国,全国,15226,301,14925
哈尔滨旅游,20240203,全国,全国,16510,168,16342
哈尔滨旅游,20240204,全国,全国,18819,364,18455
哈尔滨旅游,20240205,全国,全国,18387,225,18162
哈尔滨旅游,20240206,全国,全国,15836,169,15667
哈尔滨旅游,20240207,全国,全国,15827,144,15683
哈尔滨旅游,20240208,全国,全国,13612,148,13464
哈尔滨旅游,20240209,全国,全国,12813,110,12703
哈尔滨旅游,20240210,全国,全国,11200,85,11115
哈尔滨旅游,20240211,全国,全国,12552,102,12450
哈尔滨旅游,20240212,全国,全国,13834,123,13711
哈尔滨旅游,20240213,全国,全国,14821,133,14688
哈尔滨旅游,20240214,全国,全国,15336,93,15243
哈尔滨旅游,20240215,全国,全国,12299,112,12187
哈尔滨旅游,20240216,全国,全国,15472,140,15332
哈尔滨旅游,20240217,全国,全国,12518,157,12361
哈尔滨旅游,20240218,全国,全国,13038,231,12807
哈尔滨旅游,20240219,全国,全国,10905,256,10649
哈尔滨旅游,20240220,全国,全国,12758,231,12527
哈尔滨旅游,20240221,全国,全国,10762,175,10587
哈尔滨旅游,20240222,全国,全国,11286,195,11091
哈尔滨旅游,20240223,全国,全国,10271,182,10089
哈尔滨旅游,20240224,全国,全国,7887,120,7767
哈尔滨旅游,20240225,全国,全国,3808,159,3649
哈尔滨旅游,20240226,全国,全国,3340,190,3150
哈尔滨旅游,20240227,全国,全国,2739,184,2555
哈尔滨旅游,20240228,全国,全国,2579,190,2389
哈尔滨旅游,20240229,全国,全国,2380,165,2215
哈尔滨旅游,20240301,全国,全国,2703,151,2552
哈尔滨旅游,20240302,全国,全国,3523,110,3413
哈尔滨旅游,20240303,全国,全国,3661,118,3543
哈尔滨旅游,20240304,全国,全国,2300,150,2150
哈尔滨旅游,20240305,全国,全国,2010,131,1879
哈尔滨旅游,20240306,全国,全国,2848,176,2672
哈尔滨旅游,20240307,全国,全国,2964,144,2820
哈尔滨旅游,20240308,全国,全国,8394,125,8269
哈尔滨旅游,20240309,全国,全国,5411,99,5312
哈尔滨旅游,20240310,全国,全国,5451,97,5354
哈尔滨旅游,20240311,全国,全国,5771,163,5608
哈尔滨旅游,20240312,全国,全国,5470,120,5350
哈尔滨旅游,20240313,全国,全国,5460,139,5321
哈尔滨旅游,20240314,全国,全国,4121,139,3982
哈尔滨旅游,20240315,全国,全国,6609,135,6474
哈尔滨旅游,20240316,全国,全国,2622,87,2535
哈尔滨旅游,20240317,全国,全国,1971,106,1865
哈尔滨旅游,20240318,全国,全国,2113,129,1984
哈尔滨旅游,20240319,全国,全国,1422,152,1270
哈尔滨旅游,20240320,全国,全国,1254,139,1115
哈尔滨旅游,20240321,全国,全国,1248,133,1115
哈尔滨旅游,20240322,全国,全国,5322,155,5167
哈尔滨旅游,20240323,全国,全国,4457,85,4372
哈尔滨旅游,20240324,全国,全国,4703,106,4597
哈尔滨旅游,20240325,全国,全国,4133,137,3996
哈尔滨旅游,20240326,全国,全国,4361,146,4215
哈尔滨旅游,20240327,全国,全国,4309,139,4170
哈尔滨旅游,20240328,全国,全国,4044,142,3902
哈尔滨旅游,20240329,全国,全国,2826,104,2722
哈尔滨旅游,20240330,全国,全国,5000,76,4924
哈尔滨旅游,20240331,全国,全国,3510,106,3404
哈尔滨旅游,20240401,全国,全国,2050,161,1889
哈尔滨旅游,20240402,全国,全国,1224,131,1093
哈尔滨旅游,20240403,全国,全国,2778,146,2632
哈尔滨旅游,20240404,全国,全国,3308,78,3230
哈尔滨旅游,20240405,全国,全国,1730,91,1639
哈尔滨旅游,20240406,全国,全国,1086,97,989
哈尔滨旅游,20240407,全国,全国,1538,162,1376
哈尔滨旅游,20240408,全国,全国,1067,150,917
哈尔滨旅游,20240409,全国,全国,1098,137,961
哈尔滨旅游,20240410,全国,全国,1106,131,975
哈尔滨旅游,20240411,全国,全国,1059,144,915
哈尔滨旅游,20240412,全国,全国,2653,123,2530
哈尔滨旅游,20240413,全国,全国,1085,97,988
哈尔滨旅游,20240414,全国,全国,934,85,849
哈尔滨旅游,20240415,全国,全国,1048,169,879
哈尔滨旅游,20240416,全国,全国,1016,154,862
哈尔滨旅游,20240417,全国,全国,958,140,818
哈尔滨旅游,20240418,全国,全国,986,135,851
哈尔滨旅游,20240419,全国,全国,983,116,867
哈尔滨旅游,20240420,全国,全国,934,76,858
哈尔滨旅游,20240421,全国,全国,1045,97,948
哈尔滨旅游,20240422,全国,全国,890,127,763
哈尔滨旅游,20240423,全国,全国,974,123,851
哈尔滨旅游,20240424,全国,全国,1048,146,902
哈尔滨旅游,20240425,全国,全国,1068,142,926
哈尔滨旅游,20240426,全国,全国,920,140,780
哈尔滨旅游,20240427,全国,全国,1093,89,1004
哈尔滨旅游,20240428,全国,全国,1453,172,1281
哈尔滨旅游,20240429,全国,全国,1049,186,863
哈尔滨旅游,20240430,全国,全国,1067,182,885
哈尔滨旅游,20240501,全国,全国,1286,83,1203
哈尔滨旅游,20240502,全国,全国,983,93,890
哈尔滨旅游,20240503,全国,全国,1335,104,1231
哈尔滨旅游,20240504,全国,全国,954,106,848
哈尔滨旅游,20240505,全国,全国,915,104,811
哈尔滨旅游,20240506,全国,全国,823,140,683
哈尔滨旅游,20240507,全国,全国,875,139,736
哈尔滨旅游,20240508,全国,全国,694,144,550
哈尔滨旅游,20240509,全国,全国,806,133,673
哈尔滨旅游,20240510,全国,全国,814,133,681
儿童公园,20220101,全国,全国,469,63,406
儿童公园,20220102,全国,全国,424,83,341
儿童公园,20220103,全国,全国,368,83,285
儿童公园,20220104,全国,全国,240,78,162
儿童公园,20220105,全国,全国,214,82,132
儿童公园,20220106,全国,全国,202,70,132
儿童公园,20220107,全国,全国,224,72,152
儿童公园,20220108,全国,全国,234,70,164
儿童公园,20220109,全国,全国,228,66,162
儿童公园,20220110,全国,全国,181,72,109
儿童公园,20220111,全国,全国,190,78,112
儿童公园,20220112,全国,全国,221,74,147
儿童公园,20220113,全国,全国,208,74,134
儿童公园,20220114,全国,全国,227,72,155
儿童公园,20220115,全国,全国,239,66,173
儿童公园,20220116,全国,全国,246,72,174
儿童公园,20220117,全国,全国,228,87,141
儿童公园,20220118,全国,全国,235,80,155
儿童公园,20220119,全国,全国,227,76,151
儿童公园,20220120,全国,全国,227,66,161
儿童公园,20220121,全国,全国,221,82,139
儿童公园,20220122,全国,全国,139,0,139
儿童公园,20220123,全国,全国,218,63,155
儿童公园,20220124,全国,全国,215,80,135
儿童公园,20220125,全国,全国,225,78,147
儿童公园,20220126,全国,全国,226,66,160
儿童公园,20220127,全国,全国,244,70,174
儿童公园,20220128,全国,全国,233,76,157
儿童公园,20220129,全国,全国,225,64,161
儿童公园,20220130,全国,全国,227,68,159
儿童公园,20220131,全国,全国,195,59,136
儿童公园,20220201,全国,全国,271,59,212
儿童公园,20220202,全国,全国,270,61,209
儿童公园,20220203,全国,全国,322,61,261
儿童公园,20220204,全国,全国,414,74,340
儿童公园,20220205,全国,全国,449,70,379
儿童公园,20220206,全国,全国,354,70,284
儿童公园,20220207,全国,全国,254,80,174
儿童公园,20220208,全国,全国,289,74,215
儿童公园,20220209,全国,全国,272,87,185
儿童公园,20220210,全国,全国,268,78,190
儿童公园,20220211,全国,全国,312,97,215
儿童公园,20220212,全国,全国,328,72,256
儿童公园,20220213,全国,全国,262,59,203
儿童公园,20220214,全国,全国,298,83,215
儿童公园,20220215,全国,全国,292,106,186
儿童公园,20220216,全国,全国,247,89,158
儿童公园,20220217,全国,全国,227,91,136
儿童公园,20220218,全国,全国,221,91,130
儿童公园,20220219,全国,全国,200,66,134
儿童公园,20220220,全国,全国,209,64,145
儿童公园,20220221,全国,全国,206,87,119
儿童公园,20220222,全国,全国,195,82,113
儿童公园,20220223,全国,全国,217,91,126
儿童公园,20220224,全国,全国,242,87,155
儿童公园,20220225,全国,全国,261,85,176
儿童公园,20220226,全国,全国,366,82,284
儿童公园,20220227,全国,全国,387,89,298
儿童公园,20220228,全国,全国,238,97,141
儿童公园,20220301,全国,全国,252,97,155
儿童公园,20220302,全国,全国,236,104,132
儿童公园,20220303,全国,全国,228,97,131
儿童公园,20220304,全国,全国,282,108,174
儿童公园,20220305,全国,全国,352,85,267
儿童公园,20220306,全国,全国,355,93,262
儿童公园,20220307,全国,全国,261,110,151
儿童公园,20220308,全国,全国,250,114,136
儿童公园,20220309,全国,全国,227,93,134
儿童公园,20220310,全国,全国,267,91,176
儿童公园,20220311,全国,全国,261,91,170
儿童公园,20220312,全国,全国,324,74,250
儿童公园,20220313,全国,全国,325,76,249
儿童公园,20220314,全国,全国,245,104,141
儿童公园,20220315,全国,全国,219,72,147
儿童公园,20220316,全国,全国,204,87,117
儿童公园,20220317,全国,全国,219,85,134
儿童公园,20220318,全国,全国,244,112,132
儿童公园,20220319,全国,全国,256,82,174
儿童公园,20220320,全国,全国,234,68,166
儿童公园,20220321,全国,全国,226,83,143
儿童公园,20220322,全国,全国,226,87,139
儿童公园,20220323,全国,全国,246,110,136
儿童公园,20220324,全国,全国,193,72,121
儿童公园,20220325,全国,全国,195,76,119
儿童公园,20220326,全国,全国,257,76,181
儿童公园,20220327,全国,全国,267,59,208
儿童公园,20220328,全国,全国,208,80,128
儿童公园,20220329,全国,全国,232,97,135
儿童公园,20220330,全国,全国,270,99,171
儿童公园,20220331,全国,全国,252,104,148
儿童公园,20220401,全国,全国,229,93,136
儿童公园,20220402,全国,全国,263,95,168
儿童公园,20220403,全国,全国,450,95,355
儿童公园,20220404,全国,全国,415,85,330
儿童公园,20220405,全国,全国,420,89,331
儿童公园,20220406,全国,全国,263,101,162
儿童公园,20220407,全国,全国,256,97,159
儿童公园,20220408,全国,全国,458,162,296
儿童公园,20220409,全国,全国,325,91,234
儿童公园,20220410,全国,全国,268,66,202
儿童公园,20220411,全国,全国,241,87,154
儿童公园,20220412,全国,全国,238,93,145
儿童公园,20220413,全国,全国,271,89,182
儿童公园,20220414,全国,全国,243,89,154
儿童公园,20220415,全国,全国,260,101,159
儿童公园,20220416,全国,全国,257,80,177
儿童公园,20220417,全国,全国,300,76,224
儿童公园,20220418,全国,全国,272,99,173
儿童公园,20220419,全国,全国,246,89,157
儿童公园,20220420,全国,全国,257,106,151
儿童公园,20220421,全国,全国,250,87,163
儿童公园,20220422,全国,全国,254,80,174
儿童公园,20220423,全国,全国,295,64,231
儿童公园,20220424,全国,全国,254,78,176
儿童公园,20220425,全国,全国,259,91,168
儿童公园,20220426,全国,全国,276,97,179
儿童公园,20220427,全国,全国,265,101,164
儿童公园,20220428,全国,全国,253,95,158
儿童公园,20220429,全国,全国,275,89,186
儿童公园,20220430,全国,全国,367,72,295
儿童公园,20220501,全国,全国,337,68,269
儿童公园,20220502,全国,全国,493,63,430
儿童公园,20220503,全国,全国,572,82,490
儿童公园,20220504,全国,全国,406,85,321
儿童公园,20220505,全国,全国,264,101,163
儿童公园,20220506,全国,全国,272,102,170
儿童公园,20220507,全国,全国,264,99,165
儿童公园,20220508,全国,全国,277,80,197
儿童公园,20220509,全国,全国,252,85,167
儿童公园,20220510,全国,全国,230,89,141
儿童公园,20220511,全国,全国,254,76,178
儿童公园,20220512,全国,全国,241,106,135
儿童公园,20220513,全国,全国,244,74,170
儿童公园,20220514,全国,全国,341,89,252
儿童公园,20220515,全国,全国,324,70,254
儿童公园,20220516,全国,全国,285,104,181
儿童公园,20220517,全国,全国,270,93,177
儿童公园,20220518,全国,全国,295,108,187
儿童公园,20220519,全国,全国,264,78,186
儿童公园,20220520,全国,全国,279,99,180
儿童公园,20220521,全国,全国,347,63,284
儿童公园,20220522,全国,全国,363,74,289
儿童公园,20220523,全国,全国,246,82,164
儿童公园,20220524,全国,全国,233,95,138
儿童公园,20220525,全国,全国,247,95,152
儿童公园,20220526,全国,全国,255,93,162
儿童公园,20220527,全国,全国,269,95,174
儿童公园,20220528,全国,全国,354,80,274
儿童公园,20220529,全国,全国,339,68,271
儿童公园,20220530,全国,全国,297,89,208
儿童公园,20220531,全国,全国,397,95,302
儿童公园,20220601,全国,全国,643,118,525
儿童公园,20220602,全国,全国,354,104,250
儿童公园,20220603,全国,全国,523,68,455
儿童公园,20220604,全国,全国,491,68,423
儿童公园,20220605,全国,全国,349,72,277
儿童公园,20220606,全国,全国,253,89,164
儿童公园,20220607,全国,全国,237,85,152
儿童公园,20220608,全国,全国,234,89,145
儿童公园,20220609,全国,全国,238,91,147
儿童公园,20220610,全国,全国,255,97,158
儿童公园,20220611,全国,全国,282,74,208
儿童公园,20220612,全国,全国,199,0,199
儿童公园,20220613,全国,全国,246,85,161
儿童公园,20220614,全国,全国,234,95,139
儿童公园,20220615,全国,全国,231,82,149
儿童公园,20220616,全国,全国,193,72,121
儿童公园,20220617,全国,全国,247,95,152
儿童公园,20220618,全国,全国,280,61,219
儿童公园,20220619,全国,全国,261,59,202
儿童公园,20220620,全国,全国,231,74,157
儿童公园,20220621,全国,全国,218,70,148
儿童公园,20220622,全国,全国,224,76,148
儿童公园,20220623,全国,全国,223,80,143
儿童公园,20220624,全国,全国,239,78,161
儿童公园,20220625,全国,全国,244,66,178
儿童公园,20220626,全国,全国,274,72,202
儿童公园,20220627,全国,全国,208,72,136
儿童公园,20220628,全国,全国,208,72,136
儿童公园,20220629,全国,全国,224,76,148
儿童公园,20220630,全国,全国,236,70,166
儿童公园,20220701,全国,全国,242,72,170
儿童公园,20220702,全国,全国,258,74,184
儿童公园,20220703,全国,全国,252,63,189
儿童公园,20220704,全国,全国,258,80,178
儿童公园,20220705,全国,全国,242,83,159
儿童公园,20220706,全国,全国,256,74,182
儿童公园,20220707,全国,全国,247,80,167
儿童公园,20220708,全国,全国,285,82,203
儿童公园,20220709,全国,全国,312,70,242
儿童公园,20220710,全国,全国,333,64,269
儿童公园,20220711,全国,全国,265,76,189
儿童公园,20220712,全国,全国,265,82,183
儿童公园,20220713,全国,全国,278,78,200
儿童公园,20220714,全国,全国,282,87,195
儿童公园,20220715,全国,全国,275,72,203
儿童公园,20220716,全国,全国,328,72,256
儿童公园,20220717,全国,全国,335,64,271
儿童公园,20220718,全国,全国,276,76,200
儿童公园,20220719,全国,全国,297,85,212
儿童公园,20220720,全国,全国,305,83,222
儿童公园,20220721,全国,全国,285,87,198
儿童公园,20220722,全国,全国,281,83,198
儿童公园,20220723,全国,全国,359,70,289
儿童公园,20220724,全国,全国,309,68,241
儿童公园,20220725,全国,全国,278,80,198
儿童公园,20220726,全国,全国,257,74,183
儿童公园,20220727,全国,全国,263,70,193
儿童公园,20220728,全国,全国,275,82,193
儿童公园,20220729,全国,全国,293,78,215
儿童公园,20220730,全国,全国,322,70,252
儿童公园,20220731,全国,全国,369,68,301
儿童公园,20220801,全国,全国,316,85,231
儿童公园,20220802,全国,全国,288,76,212
儿童公园,20220803,全国,全国,317,74,243
儿童公园,20220804,全国,全国,280,76,204
儿童公园,20220805,全国,全国,334,93,241
儿童公园,20220806,全国,全国,344,66,278
儿童公园,20220807,全国,全国,355,74,281
儿童公园,20220808,全国,全国,290,87,203
儿童公园,20220809,全国,全国,279,89,190
儿童公园,20220810,全国,全国,257,78,179
儿童公园,20220811,全国,全国,270,83,187
儿童公园,20220812,全国,全国,280,68,212
儿童公园,20220813,全国,全国,341,66,275
儿童公园,20220814,全国,全国,363,68,295
儿童公园,20220815,全国,全国,262,72,190
儿童公园,20220816,全国,全国,307,87,220
儿童公园,20220817,全国,全国,307,83,224
儿童公园,20220818,全国,全国,291,74,217
儿童公园,20220819,全国,全国,251,70,181
儿童公园,20220820,全国,全国,322,66,256
儿童公园,20220821,全国,全国,321,61,260
儿童公园,20220822,全国,全国,274,76,198
儿童公园,20220823,全国,全国,274,82,192
儿童公园,20220824,全国,全国,271,82,189
儿童公园,20220825,全国,全国,250,89,161
儿童公园,20220826,全国,全国,240,76,164
儿童公园,20220827,全国,全国,275,63,212
儿童公园,20220828,全国,全国,315,72,243
儿童公园,20220829,全国,全国,250,85,165
儿童公园,20220830,全国,全国,238,64,174
儿童公园,20220831,全国,全国,213,78,135
儿童公园,20220901,全国,全国,208,76,132
儿童公园,20220902,全国,全国,224,76,148
儿童公园,20220903,全国,全国,261,76,185
儿童公园,20220904,全国,全国,238,68,170
儿童公园,20220905,全国,全国,208,87,121
儿童公园,20220906,全国,全国,205,80,125
儿童公园,20220907,全国,全国,234,74,160
儿童公园,20220908,全国,全国,221,80,141
儿童公园,20220909,全国,全国,243,80,163
儿童公园,20220910,全国,全国,370,72,298
儿童公园,20220911,全国,全国,466,68,398
儿童公园,20220912,全国,全国,320,74,246
儿童公园,20220913,全国,全国,237,80,157
儿童公园,20220914,全国,全国,254,80,174
儿童公园,20220915,全国,全国,271,76,195
儿童公园,20220916,全国,全国,247,83,164
儿童公园,20220917,全国,全国,347,74,273
儿童公园,20220918,全国,全国,352,64,288
儿童公园,20220919,全国,全国,263,93,170
儿童公园,20220920,全国,全国,251,80,171
儿童公园,20220921,全国,全国,242,72,170
儿童公园,20220922,全国,全国,237,76,161
儿童公园,20220923,全国,全国,249,85,164
儿童公园,20220924,全国,全国,330,82,248
儿童公园,20220925,全国,全国,360,68,292
儿童公园,20220926,全国,全国,274,106,168
儿童公园,20220927,全国,全国,263,108,155
儿童公园,20220928,全国,全国,259,99,160
儿童公园,20220929,全国,全国,241,89,152
儿童公园,20220930,全国,全国,307,95,212
儿童公园,20221001,全国,全国,477,68,409
儿童公园,20221002,全国,全国,559,70,489
儿童公园,20221003,全国,全国,460,72,388
儿童公园,20221004,全国,全国,457,85,372
儿童公园,20221005,全国,全国,372,63,309
儿童公园,20221006,全国,全国,349,78,271
儿童公园,20221007,全国,全国,291,70,221
儿童公园,20221008,全国,全国,215,83,132
儿童公园,20221009,全国,全国,194,82,112
儿童公园,20221010,全国,全国,199,76,123
儿童公园,20221011,全国,全国,233,95,138
儿童公园,20221012,全国,全国,215,76,139
儿童公园,20221013,全国,全国,223,85,138
儿童公园,20221014,全国,全国,224,85,139
儿童公园,20221015,全国,全国,314,72,242
儿童公园,20221016,全国,全国,276,80,196
儿童公园,20221017,全国,全国,208,85,123
儿童公园,20221018,全国,全国,223,82,141
儿童公园,20221019,全国,全国,239,87,152
儿童公园,20221020,全国,全国,238,95,143
儿童公园,20221021,全国,全国,255,91,164
儿童公园,20221022,全国,全国,283,68,215
儿童公园,20221023,全国,全国,337,68,269
儿童公园,20221024,全国,全国,229,78,151
儿童公园,20221025,全国,全国,242,76,166
儿童公园,20221026,全国,全国,211,76,135
儿童公园,20221027,全国,全国,202,66,136
儿童公园,20221028,全国,全国,229,91,138
儿童公园,20221029,全国,全国,293,76,217
儿童公园,20221030,全国,全国,262,59,203
儿童公园,20221031,全国,全国,200,74,126
儿童公园,20221101,全国,全国,222,87,135
儿童公园,20221102,全国,全国,204,68,136
儿童公园,20221103,全国,全国,190,78,112
儿童公园,20221104,全国,全国,208,74,134
儿童公园,20221105,全国,全国,247,66,181
儿童公园,20221106,全国,全国,218,64,154
儿童公园,20221107,全国,全国,227,76,151
儿童公园,20221108,全国,全国,225,82,143
儿童公园,20221109,全国,全国,240,80,160
儿童公园,20221110,全国,全国,220,89,131
儿童公园,20221111,全国,全国,199,76,123
儿童公园,20221112,全国,全国,243,66,177
儿童公园,20221113,全国,全国,273,68,205
儿童公园,20221114,全国,全国,200,74,126
儿童公园,20221115,全国,全国,225,74,151
儿童公园,20221116,全国,全国,211,83,128
儿童公园,20221117,全国,全国,218,70,148
儿童公园,20221118,全国,全国,221,85,136
儿童公园,20221119,全国,全国,291,70,221
儿童公园,20221120,全国,全国,272,70,202
儿童公园,20221121,全国,全国,209,68,141
儿童公园,20221122,全国,全国,208,78,130
儿童公园,20221123,全国,全国,225,102,123
儿童公园,20221124,全国,全国,174,72,102
儿童公园,20221125,全国,全国,190,72,118
儿童公园,20221126,全国,全国,226,64,162
儿童公园,20221127,全国,全国,241,70,171
儿童公园,20221128,全国,全国,200,78,122
儿童公园,20221129,全国,全国,218,70,148
儿童公园,20221130,全国,全国,201,63,138
儿童公园,20221201,全国,全国,191,72,119
儿童公园,20221202,全国,全国,190,78,112
儿童公园,20221203,全国,全国,217,66,151
儿童公园,20221204,全国,全国,220,68,152
儿童公园,20221205,全国,全国,179,74,105
儿童公园,20221206,全国,全国,194,64,130
儿童公园,20221207,全国,全国,221,70,151
儿童公园,20221208,全国,全国,196,74,122
儿童公园,20221209,全国,全国,189,64,125
儿童公园,20221210,全国,全国,226,72,154
儿童公园,20221211,全国,全国,227,70,157
儿童公园,20221212,全国,全国,195,87,108
儿童公园,20221213,全国,全国,158,66,92
儿童公园,20221214,全国,全国,176,68,108
儿童公园,20221215,全国,全国,175,66,109
儿童公园,20221216,全国,全国,188,66,122
儿童公园,20221217,全国,全国,170,64,106
儿童公园,20221218,全国,全国,156,59,97
儿童公园,20221219,全国,全国,159,64,95
儿童公园,20221220,全国,全国,171,63,108
儿童公园,20221221,全国,全国,105,0,105
儿童公园,20221222,全国,全国,165,68,97
儿童公园,20221223,全国,全国,174,74,100
儿童公园,20221224,全国,全国,176,63,113
儿童公园,20221225,全国,全国,177,59,118
儿童公园,20221226,全国,全国,175,66,109
儿童公园,20221227,全国,全国,168,68,100
儿童公园,20221228,全国,全国,194,76,118
儿童公园,20221229,全国,全国,219,87,132
儿童公园,20221230,全国,全国,180,74,106
儿童公园,20221231,全国,全国,216,61,155
儿童公园,20230101,全国,全国,190,59,131
儿童公园,20230102,全国,全国,218,63,155
儿童公园,20230103,全国,全国,200,74,126
儿童公园,20230104,全国,全国,216,80,136
儿童公园,20230105,全国,全国,204,83,121
儿童公园,20230106,全国,全国,227,83,144
儿童公园,20230107,全国,全国,222,61,161
儿童公园,20230108,全国,全国,205,61,144
儿童公园,20230109,全国,全国,198,70,128
儿童公园,20230110,全国,全国,231,82,149
儿童公园,20230111,全国,全国,198,68,130
儿童公园,20230112,全国,全国,210,66,144
儿童公园,20230113,全国,全国,224,93,131
儿童公园,20230114,全国,全国,225,66,159
儿童公园,20230115,全国,全国,202,68,134
儿童公园,20230116,全国,全国,195,78,117
儿童公园,20230117,全国,全国,204,66,138
儿童公园,20230118,全国,全国,219,68,151
儿童公园,20230119,全国,全国,246,80,166
儿童公园,20230120,全国,全国,206,63,143
儿童公园,20230121,全国,全国,132,0,132
儿童公园,20230122,全国,全国,402,64,338
儿童公园,20230123,全国,全国,337,0,337
儿童公园,20230124,全国,全国,324,0,324
儿童公园,20230125,全国,全国,406,68,338
儿童公园,20230126,全国,全国,385,68,317
儿童公园,20230127,全国,全国,314,59,255
儿童公园,20230128,全国,全国,334,87,247
儿童公园,20230129,全国,全国,322,76,246
儿童公园,20230130,全国,全国,290,87,203
儿童公园,20230131,全国,全国,305,97,208
儿童公园,20230201,全国,全国,297,89,208
儿童公园,20230202,全国,全国,305,87,218
儿童公园,20230203,全国,全国,310,106,204
儿童公园,20230204,全国,全国,222,64,158
儿童公园,20230205,全国,全国,262,64,198
儿童公园,20230206,全国,全国,253,83,170
儿童公园,20230207,全国,全国,231,76,155
儿童公园,20230208,全国,全国,204,70,134
儿童公园,20230209,全国,全国,190,80,110
儿童公园,20230210,全国,全国,247,85,162
儿童公园,20230211,全国,全国,318,64,254
儿童公园,20230212,全国,全国,288,70,218
儿童公园,20230213,全国,全国,215,83,132
儿童公园,20230214,全国,全国,232,85,147
儿童公园,20230215,全国,全国,237,85,152
儿童公园,20230216,全国,全国,251,87,164
儿童公园,20230217,全国,全国,286,83,203
儿童公园,20230218,全国,全国,400,70,330
儿童公园,20230219,全国,全国,452,85,367
儿童公园,20230220,全国,全国,226,82,144
儿童公园,20230221,全国,全国,251,99,152
儿童公园,20230222,全国,全国,208,70,138
儿童公园,20230223,全国,全国,231,80,151
儿童公园,20230224,全国,全国,295,106,189
儿童公园,20230225,全国,全国,344,66,278
儿童公园,20230226,全国,全国,353,64,289
儿童公园,20230227,全国,全国,264,104,160
儿童公园,20230228,全国,全国,222,78,144
儿童公园,20230301,全国,全国,235,83,152
儿童公园,20230302,全国,全国,235,91,144
儿童公园,20230303,全国,全国,280,91,189
儿童公园,20230304,全国,全国,386,72,314
儿童公园,20230305,全国,全国,443,74,369
儿童公园,20230306,全国,全国,261,91,170
儿童公园,20230307,全国,全国,246,76,170
儿童公园,20230308,全国,全国,236,78,158
儿童公园,20230309,全国,全国,255,89,166
儿童公园,20230310,全国,全国,269,85,184
儿童公园,20230311,全国,全国,370,83,287
儿童公园,20230312,全国,全国,336,68,268
儿童公园,20230313,全国,全国,229,82,147
儿童公园,20230314,全国,全国,236,93,143
儿童公园,20230315,全国,全国,244,82,162
儿童公园,20230316,全国,全国,262,102,160
儿童公园,20230317,全国,全国,244,78,166
儿童公园,20230318,全国,全国,357,72,285
儿童公园,20230319,全国,全国,363,78,285
儿童公园,20230320,全国,全国,239,66,173
儿童公园,20230321,全国,全国,246,102,144
儿童公园,20230322,全国,全国,236,97,139
儿童公园,20230323,全国,全国,246,82,164
儿童公园,20230324,全国,全国,227,83,144
儿童公园,20230325,全国,全国,242,68,174
儿童公园,20230326,全国,全国,298,74,224
儿童公园,20230327,全国,全国,208,80,128
儿童公园,20230328,全国,全国,206,72,134
儿童公园,20230329,全国,全国,235,80,155
儿童公园,20230330,全国,全国,241,89,152
儿童公园,20230331,全国,全国,265,82,183
儿童公园,20230401,全国,全国,326,66,260
儿童公园,20230402,全国,全国,312,63,249
儿童公园,20230403,全国,全国,234,80,154
儿童公园,20230404,全国,全国,250,87,163
儿童公园,20230405,全国,全国,300,64,236
儿童公园,20230406,全国,全国,240,85,155
儿童公园,20230407,全国,全国,289,106,183
儿童公园,20230408,全国,全国,383,78,305
儿童公园,20230409,全国,全国,364,72,292
儿童公园,20230410,全国,全国,250,85,165
儿童公园,20230411,全国,全国,244,83,161
儿童公园,20230412,全国,全国,245,80,165
儿童公园,20230413,全国,全国,254,93,161
儿童公园,20230414,全国,全国,283,91,192
儿童公园,20230415,全国,全国,352,72,280
儿童公园,20230416,全国,全国,395,74,321
儿童公园,20230417,全国,全国,251,85,166
儿童公园,20230418,全国,全国,235,72,163
儿童公园,20230419,全国,全国,249,97,152
儿童公园,20230420,全国,全国,256,74,182
儿童公园,20230421,全国,全国,241,74,167
儿童公园,20230422,全国,全国,299,70,229
儿童公园,20230423,全国,全国,287,87,200
儿童公园,20230424,全国,全国,265,99,166
儿童公园,20230425,全国,全国,247,87,160
儿童公园,20230426,全国,全国,263,80,183
儿童公园,20230427,全国,全国,288,110,178
儿童公园,20230428,全国,全国,360,112,248
儿童公园,20230429,全国,全国,540,87,453
儿童公园,20230430,全国,全国,781,76,705
儿童公园,20230501,全国,全国,898,72,826
儿童公园,20230502,全国,全国,677,89,588
儿童公园,20230503,全国,全国,423,72,351
儿童公园,20230504,全国,全国,253,99,154
儿童公园,20230505,全国,全国,258,93,165
儿童公园,20230506,全国,全国,247,82,165
儿童公园,20230507,全国,全国,259,66,193
儿童公园,20230508,全国,全国,216,72,144
儿童公园,20230509,全国,全国,250,95,155
儿童公园,20230510,全国,全国,232,80,152
儿童公园,20230511,全国,全国,250,76,174
儿童公园,20230512,全国,全国,233,99,134
儿童公园,20230513,全国,全国,319,70,249
儿童公园,20230514,全国,全国,283,61,222
儿童公园,20230515,全国,全国,214,59,155
儿童公园,20230516,全国,全国,221,85,136
儿童公园,20230517,全国,全国,228,76,152
儿童公园,20230518,全国,全国,223,85,138
儿童公园,20230519,全国,全国,256,89,167
儿童公园,20230520,全国,全国,284,63,221
儿童公园,20230521,全国,全国,212,0,212
儿童公园,20230522,全国,全国,213,70,143
儿童公园,20230523,全国,全国,212,76,136
儿童公园,20230524,全国,全国,214,76,138
儿童公园,20230525,全国,全国,234,87,147
儿童公园,20230526,全国,全国,252,85,167
儿童公园,20230527,全国,全国,301,74,227
儿童公园,20230528,全国,全国,281,70,211
儿童公园,20230529,全国,全国,236,89,147
儿童公园,20230530,全国,全国,253,91,162
儿童公园,20230531,全国,全国,356,82,274
儿童公园,20230601,全国,全国,558,108,450
儿童公园,20230602,全国,全国,249,70,179
儿童公园,20230603,全国,全国,341,70,271
儿童公园,20230604,全国,全国,354,74,280
儿童公园,20230605,全国,全国,230,76,154
儿童公园,20230606,全国,全国,252,89,163
儿童公园,20230607,全国,全国,235,76,159
儿童公园,20230608,全国,全国,240,89,151
儿童公园,20230609,全国,全国,248,89,159
儿童公园,20230610,全国,全国,264,59,205
儿童公园,20230611,全国,全国,298,64,234
儿童公园,20230612,全国,全国,232,78,154
儿童公园,20230613,全国,全国,204,74,130
儿童公园,20230614,全国,全国,220,82,138
儿童公园,20230615,全国,全国,223,80,143
儿童公园,20230616,全国,全国,229,85,144
儿童公园,20230617,全国,全国,249,64,185
儿童公园,20230618,全国,全国,261,64,197
儿童公园,20230619,全国,全国,212,82,130
儿童公园,20230620,全国,全国,207,72,135
儿童公园,20230621,全国,全国,263,89,174
儿童公园,20230622,全国,全国,378,63,315
儿童公园,20230623,全国,全国,299,61,238
儿童公园,20230624,全国,全国,240,59,181
儿童公园,20230625,全国,全国,221,87,134
儿童公园,20230626,全国,全国,249,82,167
儿童公园,20230627,全国,全国,225,68,157
儿童公园,20230628,全国,全国,259,97,162
儿童公园,20230629,全国,全国,243,76,167
儿童公园,20230630,全国,全国,258,74,184
儿童公园,20230701,全国,全国,285,61,224
儿童公园,20230702,全国,全国,292,63,229
儿童公园,20230703,全国,全国,275,80,195
儿童公园,20230704,全国,全国,268,87,181
儿童公园,20230705,全国,全国,261,68,193
儿童公园,20230706,全国,全国,284,72,212
儿童公园,20230707,全国,全国,256,76,180
儿童公园,20230708,全国,全国,294,63,231
儿童公园,20230709,全国,全国,319,66,253
儿童公园,20230710,全国,全国,309,82,227
儿童公园,20230711,全国,全国,280,72,208
儿童公园,20230712,全国,全国,277,72,205
儿童公园,20230713,全国,全国,264,72,192
儿童公园,20230714,全国,全国,303,68,235
儿童公园,20230715,全国,全国,339,72,267
儿童公园,20230716,全国,全国,313,63,250
儿童公园,20230717,全国,全国,261,72,189
儿童公园,20230718,全国,全国,267,68,199
儿童公园,20230719,全国,全国,312,83,229
儿童公园,20230720,全国,全国,296,72,224
儿童公园,20230721,全国,全国,314,89,225
儿童公园,20230722,全国,全国,348,61,287
儿童公园,20230723,全国,全国,383,66,317
儿童公园,20230724,全国,全国,310,78,232
儿童公园,20230725,全国,全国,315,76,239
儿童公园,20230726,全国,全国,280,74,206
儿童公园,20230727,全国,全国,287,76,211
儿童公园,20230728,全国,全国,283,68,215
儿童公园,20230729,全国,全国,329,66,263
儿童公园,20230730,全国,全国,346,61,285
儿童公园,20230731,全国,全国,341,91,250
儿童公园,20230801,全国,全国,277,76,201
儿童公园,20230802,全国,全国,288,76,212
儿童公园,20230803,全国,全国,304,83,221
儿童公园,20230804,全国,全国,288,76,212
儿童公园,20230805,全国,全国,365,64,301
儿童公园,20230806,全国,全国,371,63,308
儿童公园,20230807,全国,全国,294,70,224
儿童公园,20230808,全国,全国,331,85,246
儿童公园,20230809,全国,全国,330,82,248
儿童公园,20230810,全国,全国,294,70,224
儿童公园,20230811,全国,全国,319,78,241
儿童公园,20230812,全国,全国,359,63,296
儿童公园,20230813,全国,全国,364,59,305
儿童公园,20230814,全国,全国,345,91,254
儿童公园,20230815,全国,全国,303,82,221
儿童公园,20230816,全国,全国,333,80,253
儿童公园,20230817,全国,全国,310,83,227
儿童公园,20230818,全国,全国,322,97,225
儿童公园,20230819,全国,全国,335,64,271
儿童公园,20230820,全国,全国,355,59,296
儿童公园,20230821,全国,全国,299,72,227
儿童公园,20230822,全国,全国,261,72,189
儿童公园,20230823,全国,全国,294,72,222
儿童公园,20230824,全国,全国,275,76,199
儿童公园,20230825,全国,全国,271,76,195
儿童公园,20230826,全国,全国,312,64,248
儿童公园,20230827,全国,全国,334,63,271
儿童公园,20230828,全国,全国,256,80,176
儿童公园,20230829,全国,全国,242,68,174
儿童公园,20230830,全国,全国,263,74,189
儿童公园,20230831,全国,全国,229,68,161
儿童公园,20230901,全国,全国,217,72,145
儿童公园,20230902,全国,全国,239,68,171
儿童公园,20230903,全国,全国,253,61,192
儿童公园,20230904,全国,全国,206,76,130
儿童公园,20230905,全国,全国,207,72,135
儿童公园,20230906,全国,全国,226,64,162
儿童公园,20230907,全国,全国,211,72,139
儿童公园,20230908,全国,全国,217,83,134
儿童公园,20230909,全国,全国,291,70,221
儿童公园,20230910,全国,全国,220,0,220
儿童公园,20230911,全国,全国,231,76,155
儿童公园,20230912,全国,全国,257,80,177
儿童公园,20230913,全国,全国,229,78,151
儿童公园,20230914,全国,全国,250,74,176
儿童公园,20230915,全国,全国,225,78,147
儿童公园,20230916,全国,全国,321,64,257
儿童公园,20230917,全国,全国,350,61,289
儿童公园,20230918,全国,全国,250,74,176
儿童公园,20230919,全国,全国,241,76,165
儿童公园,20230920,全国,全国,224,72,152
儿童公园,20230921,全国,全国,208,80,128
儿童公园,20230922,全国,全国,223,72,151
儿童公园,20230923,全国,全国,286,72,214
儿童公园,20230924,全国,全国,314,66,248
儿童公园,20230925,全国,全国,230,70,160
儿童公园,20230926,全国,全国,212,74,138
儿童公园,20230927,全国,全国,217,72,145
儿童公园,20230928,全国,全国,252,74,178
儿童公园,20230929,全国,全国,329,61,268
儿童公园,20230930,全国,全国,485,70,415
儿童公园,20231001,全国,全国,561,61,500
儿童公园,20231002,全国,全国,471,70,401
儿童公园,20231003,全国,全国,445,64,381
儿童公园,20231004,全国,全国,390,74,316
儿童公园,20231005,全国,全国,380,72,308
儿童公园,20231006,全国,全国,333,66,267
儿童公园,20231007,全国,全国,216,64,152
儿童公园,20231008,全国,全国,221,82,139
儿童公园,20231009,全国,全国,192,80,112
儿童公园,20231010,全国,全国,211,72,139
儿童公园,20231011,全国,全国,201,78,123
儿童公园,20231012,全国,全国,229,74,155
儿童公园,20231013,全国,全国,228,74,154
儿童公园,20231014,全国,全国,319,63,256
儿童公园,20231015,全国,全国,318,68,250
儿童公园,20231016,全国,全国,221,78,143
儿童公园,20231017,全国,全国,233,99,134
儿童公园,20231018,全国,全国,230,83,147
儿童公园,20231019,全国,全国,204,72,132
儿童公园,20231020,全国,全国,211,85,126
儿童公园,20231021,全国,全国,278,66,212
儿童公园,20231022,全国,全国,310,64,246
儿童公园,20231023,全国,全国,217,70,147
儿童公园,20231024,全国,全国,200,82,118
儿童公园,20231025,全国,全国,203,80,123
儿童公园,20231026,全国,全国,203,93,110
儿童公园,20231027,全国,全国,227,91,136
儿童公园,20231028,全国,全国,282,63,219
儿童公园,20231029,全国,全国,317,64,253
儿童公园,20231030,全国,全国,212,82,130
儿童公园,20231031,全国,全国,197,78,119
儿童公园,20231101,全国,全国,199,68,131
儿童公园,20231102,全国,全国,199,82,117
儿童公园,20231103,全国,全国,219,70,149
儿童公园,20231104,全国,全国,304,66,238
儿童公园,20231105,全国,全国,271,68,203
儿童公园,20231106,全国,全国,207,76,131
儿童公园,20231107,全国,全国,185,80,105
儿童公园,20231108,全国,全国,199,76,123
儿童公园,20231109,全国,全国,201,70,131
儿童公园,20231110,全国,全国,217,76,141
儿童公园,20231111,全国,全国,223,59,164
儿童公园,20231112,全国,全国,262,64,198
儿童公园,20231113,全国,全国,175,70,105
儿童公园,20231114,全国,全国,190,72,118
儿童公园,20231115,全国,全国,204,63,141
儿童公园,20231116,全国,全国,180,76,104
儿童公园,20231117,全国,全国,222,74,148
儿童公园,20231118,全国,全国,269,72,197
儿童公园,20231119,全国,全国,316,64,252
儿童公园,20231120,全国,全国,206,83,123
儿童公园,20231121,全国,全国,193,78,115
儿童公园,20231122,全国,全国,210,78,132
儿童公园,20231123,全国,全国,191,78,113
儿童公园,20231124,全国,全国,222,74,148
儿童公园,20231125,全国,全国,288,74,214
儿童公园,20231126,全国,全国,315,66,249
儿童公园,20231127,全国,全国,202,80,122
儿童公园,20231128,全国,全国,227,108,119
儿童公园,20231129,全国,全国,229,85,144
儿童公园,20231130,全国,全国,227,82,145
儿童公园,20231201,全国,全国,244,82,162
儿童公园,20231202,全国,全国,249,0,249
儿童公园,20231203,全国,全国,298,66,232
儿童公园,20231204,全国,全国,210,72,138
儿童公园,20231205,全国,全国,202,74,128
儿童公园,20231206,全国,全国,185,76,109
儿童公园,20231207,全国,全国,208,83,125
儿童公园,20231208,全国,全国,228,87,141
儿童公园,20231209,全国,全国,271,63,208
儿童公园,20231210,全国,全国,303,64,239
儿童公园,20231211,全国,全国,198,80,118
儿童公园,20231212,全国,全国,164,82,82
儿童公园,20231213,全国,全国,174,72,102
儿童公园,20231214,全国,全国,181,68,113
儿童公园,20231215,全国,全国,173,74,99
儿童公园,20231216,全国,全国,202,59,143
儿童公园,20231217,全国,全国,198,63,135
儿童公园,20231218,全国,全国,169,80,89
儿童公园,20231219,全国,全国,153,64,89
儿童公园,20231220,全国,全国,171,63,108
儿童公园,20231221,全国,全国,183,74,109
儿童公园,20231222,全国,全国,156,78,78
儿童公园,20231223,全国,全国,213,72,141
儿童公园,20231224,全国,全国,184,0,184
儿童公园,20231225,全国,全国,188,70,118
儿童公园,20231226,全国,全国,170,70,100
儿童公园,20231227,全国,全国,240,83,157
儿童公园,20231228,全国,全国,259,91,168
儿童公园,20231229,全国,全国,275,99,176
儿童公园,20231230,全国,全国,407,74,333
儿童公园,20231231,全国,全国,437,64,373
儿童公园,20240101,全国,全国,401,63,338
儿童公园,20240102,全国,全国,227,82,145
儿童公园,20240103,全国,全国,190,78,112
儿童公园,20240104,全国,全国,212,80,132
儿童公园,20240105,全国,全国,193,68,125
儿童公园,20240106,全国,全国,294,74,220
儿童公园,20240107,全国,全国,186,0,186
儿童公园,20240108,全国,全国,205,74,131
儿童公园,20240109,全国,全国,195,72,123
儿童公园,20240110,全国,全国,185,68,117
儿童公园,20240111,全国,全国,223,95,128
儿童公园,20240112,全国,全国,216,68,148
儿童公园,20240113,全国,全国,294,72,222
儿童公园,20240114,全国,全国,281,61,220
儿童公园,20240115,全国,全国,208,76,132
儿童公园,20240116,全国,全国,210,74,136
儿童公园,20240117,全国,全国,200,74,126
儿童公园,20240118,全国,全国,208,76,132
儿童公园,20240119,全国,全国,219,74,145
儿童公园,20240120,全国,全国,217,63,154
儿童公园,20240121,全国,全国,242,64,178
儿童公园,20240122,全国,全国,201,82,119
儿童公园,20240123,全国,全国,179,74,105
儿童公园,20240124,全国,全国,186,68,118
儿童公园,20240125,全国,全国,195,74,121
儿童公园,20240126,全国,全国,200,68,132
儿童公园,20240127,全国,全国,145,0,145
儿童公园,20240128,全国,全国,223,63,160
儿童公园,20240129,全国,全国,209,68,141
儿童公园,20240130,全国,全国,211,68,143
儿童公园,20240131,全国,全国,198,68,130
儿童公园,20240201,全国,全国,224,66,158
儿童公园,20240202,全国,全国,203,64,139
儿童公园,20240203,全国,全国,237,64,173
儿童公园,20240204,全国,全国,213,68,145
儿童公园,20240205,全国,全国,225,70,155
儿童公园,20240206,全国,全国,225,74,151
儿童公园,20240207,全国,全国,106,0,106
儿童公园,20240208,全国,全国,187,59,128
儿童公园,20240209,全国,全国,128,0,128
儿童公园,20240210,全国,全国,312,0,312
儿童公园,20240211,全国,全国,354,66,288
儿童公园,20240212,全国,全国,354,59,295
儿童公园,20240213,全国,全国,345,61,284
儿童公园,20240214,全国,全国,336,66,270
儿童公园,20240215,全国,全国,224,0,224
儿童公园,20240216,全国,全国,343,70,273
儿童公园,20240217,全国,全国,280,63,217
儿童公园,20240218,全国,全国,256,70,186
儿童公园,20240219,全国,全国,229,78,151
儿童公园,20240220,全国,全国,204,66,138
儿童公园,20240221,全国,全国,200,68,132
儿童公园,20240222,全国,全国,171,74,97
儿童公园,20240223,全国,全国,208,80,128
儿童公园,20240224,全国,全国,236,63,173
儿童公园,20240225,全国,全国,224,64,160
儿童公园,20240226,全国,全国,162,66,96
儿童公园,20240227,全国,全国,170,64,106
儿童公园,20240228,全国,全国,180,72,108
儿童公园,20240229,全国,全国,205,74,131
儿童公园,20240301,全国,全国,189,66,123
儿童公园,20240302,全国,全国,246,66,180
儿童公园,20240303,全国,全国,269,83,186
儿童公园,20240304,全国,全国,189,74,115
儿童公园,20240305,全国,全国,183,78,105
儿童公园,20240306,全国,全国,194,82,112
儿童公园,20240307,全国,全国,199,80,119
儿童公园,20240308,全国,全国,219,76,143
儿童公园,20240309,全国,全国,248,70,178
儿童公园,20240310,全国,全国,235,64,171
儿童公园,20240311,全国,全国,175,66,109
儿童公园,20240312,全国,全国,205,80,125
儿童公园,20240313,全国,全国,213,72,141
儿童公园,20240314,全国,全国,199,82,117
儿童公园,20240315,全国,全国,256,102,154
儿童公园,20240316,全国,全国,243,61,182
儿童公园,20240317,全国,全国,292,64,228
儿童公园,20240318,全国,全国,191,72,119
儿童公园,20240319,全国,全国,224,80,144
儿童公园,20240320,全国,全国,215,89,126
儿童公园,20240321,全国,全国,205,87,118
儿童公园,20240322,全国,全国,195,76,119
儿童公园,20240323,全国,全国,266,68,198
儿童公园,20240324,全国,全国,271,63,208
儿童公园,20240325,全国,全国,194,95,99
儿童公园,20240326,全国,全国,209,83,126
儿童公园,20240327,全国,全国,197,78,119
儿童公园,20240328,全国,全国,193,74,119
儿童公园,20240329,全国,全国,223,82,141
儿童公园,20240330,全国,全国,313,72,241
儿童公园,20240331,全国,全国,268,66,202
儿童公园,20240401,全国,全国,198,70,128
儿童公园,20240402,全国,全国,178,66,112
儿童公园,20240403,全国,全国,238,83,155
儿童公园,20240404,全国,全国,359,61,298
儿童公园,20240405,全国,全国,361,66,295
儿童公园,20240406,全国,全国,246,63,183
儿童公园,20240407,全国,全国,217,108,109
儿童公园,20240408,全国,全国,172,70,102
儿童公园,20240409,全国,全国,207,85,122
儿童公园,20240410,全国,全国,205,70,135
儿童公园,20240411,全国,全国,190,78,112
儿童公园,20240412,全国,全国,242,80,162
儿童公园,20240413,全国,全国,276,72,204
儿童公园,20240414,全国,全国,286,64,222
儿童公园,20240415,全国,全国,214,76,138
儿童公园,20240416,全国,全国,202,83,119
儿童公园,20240417,全国,全国,202,70,132
儿童公园,20240418,全国,全国,189,74,115
儿童公园,20240419,全国,全国,210,78,132
儿童公园,20240420,全国,全国,247,57,190
儿童公园,20240421,全国,全国,263,64,199
儿童公园,20240422,全国,全国,180,68,112
儿童公园,20240423,全国,全国,185,70,115
儿童公园,20240424,全国,全国,210,80,130
儿童公园,20240425,全国,全国,200,74,126
儿童公园,20240426,全国,全国,194,76,118
儿童公园,20240427,全国,全国,265,61,204
儿童公园,20240428,全国,全国,235,87,148
儿童公园,20240429,全国,全国,215,83,132
儿童公园,20240430,全国,全国,237,80,157
儿童公园,20240501,全国,全国,401,59,342
儿童公园,20240502,全国,全国,510,74,436
儿童公园,20240503,全国,全国,506,70,436
儿童公园,20240504,全国,全国,334,74,260
儿童公园,20240505,全国,全国,341,87,254
儿童公园,20240506,全国,全国,240,85,155
儿童公园,20240507,全国,全国,213,68,145
儿童公园,20240508,全国,全国,206,80,126
儿童公园,20240509,全国,全国,186,63,123
儿童公园,20240510,全国,全国,196,78,118
龙塔,20220101,全国,全国,154,0,154
龙塔,20220102,全国,全国,226,72,154
龙塔,20220103,全国,全国,246,66,180
龙塔,20220104,全国,全国,224,80,144
龙塔,20220105,全国,全国,219,74,145
龙塔,20220106,全国,全国,218,70,148
龙塔,20220107,全国,全国,208,76,132
龙塔,20220108,全国,全国,210,59,151
龙塔,20220109,全国,全国,213,64,149
龙塔,20220110,全国,全国,208,74,134
龙塔,20220111,全国,全国,198,66,132
龙塔,20220112,全国,全国,204,66,138
龙塔,20220113,全国,全国,222,68,154
龙塔,20220114,全国,全国,202,76,126
龙塔,20220115,全国,全国,186,68,118
龙塔,20220116,全国,全国,211,59,152
龙塔,20220117,全国,全国,216,59,157
龙塔,20220118,全国,全国,215,70,145
龙塔,20220119,全国,全国,237,80,157
龙塔,20220120,全国,全国,217,70,147
龙塔,20220121,全国,全国,214,70,144
龙塔,20220122,全国,全国,224,66,158
龙塔,20220123,全国,全国,210,76,134
龙塔,20220124,全国,全国,204,66,138
龙塔,20220125,全国,全国,246,85,161
龙塔,20220126,全国,全国,257,87,170
龙塔,20220127,全国,全国,297,131,166
龙塔,20220128,全国,全国,283,118,165
龙塔,20220129,全国,全国,265,104,161
龙塔,20220130,全国,全国,284,127,157
龙塔,20220131,全国,全国,260,116,144
龙塔,20220201,全国,全国,289,108,181
龙塔,20220202,全国,全国,279,116,163
龙塔,20220203,全国,全国,251,93,158
龙塔,20220204,全国,全国,327,118,209
龙塔,20220205,全国,全国,307,131,176
龙塔,20220206,全国,全国,301,131,170
龙塔,20220207,全国,全国,280,121,159
龙塔,20220208,全国,全国,304,139,165
龙塔,20220209,全国,全国,303,133,170
龙塔,20220210,全国,全国,287,139,148
龙塔,20220211,全国,全国,326,150,176
龙塔,20220212,全国,全国,318,139,179
龙塔,20220213,全国,全国,344,148,196
龙塔,20220214,全国,全国,338,155,183
龙塔,20220215,全国,全国,321,144,177
龙塔,20220216,全国,全国,306,152,154
龙塔,20220217,全国,全国,317,154,163
龙塔,20220218,全国,全国,364,180,184
龙塔,20220219,全国,全国,337,157,180
龙塔,20220220,全国,全国,340,154,186
龙塔,20220221,全国,全国,336,163,173
龙塔,20220222,全国,全国,381,184,197
龙塔,20220223,全国,全国,280,101,179
龙塔,20220224,全国,全国,309,116,193
龙塔,20220225,全国,全国,304,104,200
龙塔,20220226,全国,全国,292,89,203
龙塔,20220227,全国,全国,303,97,206
龙塔,20220228,全国,全国,309,106,203
龙塔,20220301,全国,全国,358,99,259
龙塔,20220302,全国,全国,318,110,208
龙塔,20220303,全国,全国,292,91,201
龙塔,20220304,全国,全国,280,102,178
龙塔,20220305,全国,全国,294,93,201
龙塔,20220306,全国,全国,286,99,187
龙塔,20220307,全国,全国,298,137,161
龙塔,20220308,全国,全国,307,104,203
龙塔,20220309,全国,全国,289,127,162
龙塔,20220310,全国,全国,299,125,174
龙塔,20220311,全国,全国,278,116,162
龙塔,20220312,全国,全国,282,120,162
龙塔,20220313,全国,全国,296,123,173
龙塔,20220314,全国,全国,329,152,177
龙塔,20220315,全国,全国,275,110,165
龙塔,20220316,全国,全国,261,106,155
龙塔,20220317,全国,全国,271,101,170
龙塔,20220318,全国,全国,286,129,157
龙塔,20220319,全国,全国,258,99,159
龙塔,20220320,全国,全国,283,102,181
龙塔,20220321,全国,全国,290,106,184
龙塔,20220322,全国,全国,327,146,181
龙塔,20220323,全国,全国,292,110,182
龙塔,20220324,全国,全国,303,114,189
龙塔,20220325,全国,全国,301,131,170
龙塔,20220326,全国,全国,308,123,185
龙塔,20220327,全国,全国,307,125,182
龙塔,20220328,全国,全国,321,148,173
龙塔,20220329,全国,全国,318,142,176
龙塔,20220330,全国,全国,306,139,167
龙塔,20220331,全国,全国,278,123,155
龙塔,20220401,全国,全国,325,152,173
龙塔,20220402,全国,全国,272,121,151
龙塔,20220403,全国,全国,310,121,189
龙塔,20220404,全国,全国,313,127,186
龙塔,20220405,全国,全国,296,120,176
龙塔,20220406,全国,全国,305,131,174
龙塔,20220407,全国,全国,304,139,165
龙塔,20220408,全国,全国,313,148,165
龙塔,20220409,全国,全国,263,80,183
龙塔,20220410,全国,全国,249,85,164
龙塔,20220411,全国,全国,261,97,164
龙塔,20220412,全国,全国,277,120,157
龙塔,20220413,全国,全国,297,137,160
龙塔,20220414,全国,全国,290,125,165
龙塔,20220415,全国,全国,307,140,167
龙塔,20220416,全国,全国,309,127,182
龙塔,20220417,全国,全国,270,110,160
龙塔,20220418,全国,全国,310,139,171
龙塔,20220419,全国,全国,265,127,138
龙塔,20220420,全国,全国,239,104,135
龙塔,20220421,全国,全国,262,101,161
龙塔,20220422,全国,全国,292,125,167
龙塔,20220423,全国,全国,259,97,162
龙塔,20220424,全国,全国,262,131,131
龙塔,20220425,全国,全国,311,140,171
龙塔,20220426,全国,全国,306,139,167
龙塔,20220427,全国,全国,258,110,148
龙塔,20220428,全国,全国,291,118,173
龙塔,20220429,全国,全国,310,150,160
龙塔,20220430,全国,全国,262,104,158
龙塔,20220501,全国,全国,285,112,173
龙塔,20220502,全国,全国,291,127,164
龙塔,20220503,全国,全国,294,116,178
龙塔,20220504,全国,全国,304,125,179
龙塔,20220505,全国,全国,281,118,163
龙塔,20220506,全国,全国,276,116,160
龙塔,20220507,全国,全国,316,120,196
龙塔,20220508,全国,全国,298,106,192
龙塔,20220509,全国,全国,299,121,178
龙塔,20220510,全国,全国,265,120,145
龙塔,20220511,全国,全国,314,131,183
龙塔,20220512,全国,全国,295,110,185
龙塔,20220513,全国,全国,272,121,151
龙塔,20220514,全国,全国,303,110,193
龙塔,20220515,全国,全国,286,120,166
龙塔,20220516,全国,全国,270,106,164
龙塔,20220517,全国,全国,327,142,185
龙塔,20220518,全国,全国,315,118,197
龙塔,20220519,全国,全国,293,112,181
龙塔,20220520,全国,全国,313,116,197
龙塔,20220521,全国,全国,311,99,212
龙塔,20220522,全国,全国,390,112,278
龙塔,20220523,全国,全国,297,114,183
龙塔,20220524,全国,全国,277,97,180
龙塔,20220525,全国,全国,278,104,174
龙塔,20220526,全国,全国,292,112,180
龙塔,20220527,全国,全国,335,127,208
龙塔,20220528,全国,全国,315,112,203
龙塔,20220529,全国,全国,309,78,231
龙塔,20220530,全国,全国,275,108,167
龙塔,20220531,全国,全国,326,123,203
龙塔,20220601,全国,全国,284,97,187
龙塔,20220602,全国,全国,327,118,209
龙塔,20220603,全国,全国,348,110,238
龙塔,20220604,全国,全国,320,99,221
龙塔,20220605,全国,全国,309,110,199
龙塔,20220606,全国,全国,294,101,193
龙塔,20220607,全国,全国,282,101,181
龙塔,20220608,全国,全国,336,135,201
龙塔,20220609,全国,全国,313,133,180
龙塔,20220610,全国,全国,291,121,170
龙塔,20220611,全国,全国,311,116,195
龙塔,20220612,全国,全国,328,106,222
龙塔,20220613,全国,全国,303,114,189
龙塔,20220614,全国,全国,322,114,208
龙塔,20220615,全国,全国,264,85,179
龙塔,20220616,全国,全国,303,104,199
龙塔,20220617,全国,全国,301,114,187
龙塔,20220618,全国,全国,265,66,199
龙塔,20220619,全国,全国,254,59,195
龙塔,20220620,全国,全国,242,72,170
龙塔,20220621,全国,全国,294,82,212
龙塔,20220622,全国,全国,256,72,184
龙塔,20220623,全国,全国,261,72,189
龙塔,20220624,全国,全国,253,68,185
龙塔,20220625,全国,全国,308,72,236
龙塔,20220626,全国,全国,275,64,211
龙塔,20220627,全国,全国,252,68,184
龙塔,20220628,全国,全国,278,78,200
龙塔,20220629,全国,全国,296,74,222
龙塔,20220630,全国,全国,292,70,222
龙塔,20220701,全国,全国,290,72,218
龙塔,20220702,全国,全国,253,66,187
龙塔,20220703,全国,全国,261,72,189
龙塔,20220704,全国,全国,276,72,204
龙塔,20220705,全国,全国,256,70,186
龙塔,20220706,全国,全国,255,72,183
龙塔,20220707,全国,全国,289,74,215
龙塔,20220708,全国,全国,272,72,200
龙塔,20220709,全国,全国,313,61,252
龙塔,20220710,全国,全国,301,66,235
龙塔,20220711,全国,全国,273,61,212
龙塔,20220712,全国,全国,322,74,248
龙塔,20220713,全国,全国,304,72,232
龙塔,20220714,全国,全国,347,72,275
龙塔,20220715,全国,全国,301,70,231
龙塔,20220716,全国,全国,348,63,285
龙塔,20220717,全国,全国,365,64,301
龙塔,20220718,全国,全国,295,70,225
龙塔,20220719,全国,全国,313,70,243
龙塔,20220720,全国,全国,312,66,246
龙塔,20220721,全国,全国,340,76,264
龙塔,20220722,全国,全国,363,78,285
龙塔,20220723,全国,全国,350,66,284
龙塔,20220724,全国,全国,397,74,323
龙塔,20220725,全国,全国,363,72,291
龙塔,20220726,全国,全国,311,72,239
龙塔,20220727,全国,全国,366,72,294
龙塔,20220728,全国,全国,374,82,292
龙塔,20220729,全国,全国,339,72,267
龙塔,20220730,全国,全国,419,82,337
龙塔,20220731,全国,全国,383,66,317
龙塔,20220801,全国,全国,379,70,309
龙塔,20220802,全国,全国,393,78,315
龙塔,20220803,全国,全国,367,83,284
龙塔,20220804,全国,全国,376,61,315
龙塔,20220805,全国,全国,402,74,328
龙塔,20220806,全国,全国,429,64,365
龙塔,20220807,全国,全国,387,72,315
龙塔,20220808,全国,全国,393,80,313
龙塔,20220809,全国,全国,376,87,289
龙塔,20220810,全国,全国,339,76,263
龙塔,20220811,全国,全国,341,70,271
龙塔,20220812,全国,全国,316,82,234
龙塔,20220813,全国,全国,385,68,317
龙塔,20220814,全国,全国,364,70,294
龙塔,20220815,全国,全国,340,76,264
龙塔,20220816,全国,全国,343,72,271
龙塔,20220817,全国,全国,346,72,274
龙塔,20220818,全国,全国,322,68,254
龙塔,20220819,全国,全国,340,83,257
龙塔,20220820,全国,全国,347,70,277
龙塔,20220821,全国,全国,318,61,257
龙塔,20220822,全国,全国,323,70,253
龙塔,20220823,全国,全国,328,83,245
龙塔,20220824,全国,全国,334,70,264
龙塔,20220825,全国,全国,295,64,231
龙塔,20220826,全国,全国,318,70,248
龙塔,20220827,全国,全国,308,61,247
龙塔,20220828,全国,全国,274,66,208
龙塔,20220829,全国,全国,261,72,189
龙塔,20220830,全国,全国,228,76,152
龙塔,20220831,全国,全国,216,61,155
龙塔,20220901,全国,全国,267,74,193
龙塔,20220902,全国,全国,248,64,184
龙塔,20220903,全国,全国,225,61,164
龙塔,20220904,全国,全国,250,72,178
龙塔,20220905,全国,全国,240,59,181
龙塔,20220906,全国,全国,264,74,190
龙塔,20220907,全国,全国,252,63,189
龙塔,20220908,全国,全国,280,91,189
龙塔,20220909,全国,全国,309,95,214
龙塔,20220910,全国,全国,307,85,222
龙塔,20220911,全国,全国,290,76,214
龙塔,20220912,全国,全国,277,82,195
龙塔,20220913,全国,全国,249,97,152
龙塔,20220914,全国,全国,235,76,159
龙塔,20220915,全国,全国,263,82,181
龙塔,20220916,全国,全国,235,78,157
龙塔,20220917,全国,全国,261,68,193
龙塔,20220918,全国,全国,276,74,202
龙塔,20220919,全国,全国,224,76,148
龙塔,20220920,全国,全国,277,87,190
龙塔,20220921,全国,全国,242,82,160
龙塔,20220922,全国,全国,234,68,166
龙塔,20220923,全国,全国,246,76,170
龙塔,20220924,全国,全国,246,72,174
龙塔,20220925,全国,全国,261,83,178
龙塔,20220926,全国,全国,212,68,144
龙塔,20220927,全国,全国,244,78,166
龙塔,20220928,全国,全国,219,64,155
龙塔,20220929,全国,全国,235,68,167
龙塔,20220930,全国,全国,244,78,166
龙塔,20221001,全国,全国,201,0,201
龙塔,20221002,全国,全国,240,59,181
龙塔,20221003,全国,全国,248,64,184
龙塔,20221004,全国,全国,246,64,182
龙塔,20221005,全国,全国,229,59,170
龙塔,20221006,全国,全国,255,68,187
龙塔,20221007,全国,全国,245,74,171
龙塔,20221008,全国,全国,240,72,168
龙塔,20221009,全国,全国,251,78,173
龙塔,20221010,全国,全国,295,99,196
龙塔,20221011,全国,全国,415,85,330
龙塔,20221012,全国,全国,350,93,257
龙塔,20221013,全国,全国,242,76,166
龙塔,20221014,全国,全国,257,83,174
龙塔,20221015,全国,全国,237,74,163
龙塔,20221016,全国,全国,235,78,157
龙塔,20221017,全国,全国,250,85,165
龙塔,20221018,全国,全国,247,93,154
龙塔,20221019,全国,全国,239,85,154
龙塔,20221020,全国,全国,240,89,151
龙塔,20221021,全国,全国,227,68,159
龙塔,20221022,全国,全国,283,66,217
龙塔,20221023,全国,全国,231,0,231
龙塔,20221024,全国,全国,235,74,161
龙塔,20221025,全国,全国,264,74,190
龙塔,20221026,全国,全国,270,80,190
龙塔,20221027,全国,全国,224,64,160
龙塔,20221028,全国,全国,246,78,168
龙塔,20221029,全国,全国,212,0,212
龙塔,20221030,全国,全国,167,0,167
龙塔,20221031,全国,全国,230,64,166
龙塔,20221101,全国,全国,220,72,148
龙塔,20221102,全国,全国,288,76,212
龙塔,20221103,全国,全国,223,61,162
龙塔,20221104,全国,全国,235,80,155
龙塔,20221105,全国,全国,248,61,187
龙塔,20221106,全国,全国,212,61,151
龙塔,20221107,全国,全国,231,76,155
龙塔,20221108,全国,全国,202,64,138
龙塔,20221109,全国,全国,231,70,161
龙塔,20221110,全国,全国,237,72,165
龙塔,20221111,全国,全国,237,72,165
龙塔,20221112,全国,全国,220,59,161
龙塔,20221113,全国,全国,230,68,162
龙塔,20221114,全国,全国,220,72,148
龙塔,20221115,全国,全国,209,68,141
龙塔,20221116,全国,全国,189,61,128
龙塔,20221117,全国,全国,244,70,174
龙塔,20221118,全国,全国,223,72,151
龙塔,20221119,全国,全国,212,61,151
龙塔,20221120,全国,全国,214,63,151
龙塔,20221121,全国,全国,235,74,161
龙塔,20221122,全国,全国,223,68,155
龙塔,20221123,全国,全国,203,68,135
龙塔,20221124,全国,全国,241,68,173
龙塔,20221125,全国,全国,192,66,126
龙塔,20221126,全国,全国,199,61,138
龙塔,20221127,全国,全国,198,64,134
龙塔,20221128,全国,全国,214,63,151
龙塔,20221129,全国,全国,193,70,123
龙塔,20221130,全国,全国,211,68,143
龙塔,20221201,全国,全国,216,64,152
龙塔,20221202,全国,全国,226,74,152
龙塔,20221203,全国,全国,200,66,134
龙塔,20221204,全国,全国,214,63,151
龙塔,20221205,全国,全国,199,64,135
龙塔,20221206,全国,全国,204,61,143
龙塔,20221207,全国,全国,204,66,138
龙塔,20221208,全国,全国,221,74,147
龙塔,20221209,全国,全国,196,66,130
龙塔,20221210,全国,全国,186,61,125
龙塔,20221211,全国,全国,187,59,128
龙塔,20221212,全国,全国,200,61,139
龙塔,20221213,全国,全国,178,63,115
龙塔,20221214,全国,全国,189,64,125
龙塔,20221215,全国,全国,198,63,135
龙塔,20221216,全国,全国,195,72,123
龙塔,20221217,全国,全国,202,64,138
龙塔,20221218,全国,全国,169,63,106
龙塔,20221219,全国,全国,188,63,125
龙塔,20221220,全国,全国,177,64,113
龙塔,20221221,全国,全国,169,59,110
龙塔,20221222,全国,全国,106,0,106
龙塔,20221223,全国,全国,134,0,134
龙塔,20221224,全国,全国,170,66,104
龙塔,20221225,全国,全国,182,63,119
龙塔,20221226,全国,全国,191,66,125
龙塔,20221227,全国,全国,196,61,135
龙塔,20221228,全国,全国,185,63,122
龙塔,20221229,全国,全国,167,59,108
龙塔,20221230,全国,全国,206,61,145
龙塔,20221231,全国,全国,213,59,154
龙塔,20230101,全国,全国,205,64,141
龙塔,20230102,全国,全国,208,59,149
龙塔,20230103,全国,全国,201,63,138
龙塔,20230104,全国,全国,211,66,145
龙塔,20230105,全国,全国,215,64,151
龙塔,20230106,全国,全国,222,74,148
龙塔,20230107,全国,全国,221,66,155
龙塔,20230108,全国,全国,242,63,179
龙塔,20230109,全国,全国,205,74,131
龙塔,20230110,全国,全国,227,80,147
龙塔,20230111,全国,全国,213,74,139
龙塔,20230112,全国,全国,236,63,173
龙塔,20230113,全国,全国,237,74,163
龙塔,20230114,全国,全国,226,61,165
龙塔,20230115,全国,全国,212,64,148
龙塔,20230116,全国,全国,212,68,144
龙塔,20230117,全国,全国,227,66,161
龙塔,20230118,全国,全国,246,80,166
龙塔,20230119,全国,全国,224,63,161
龙塔,20230120,全国,全国,198,66,132
龙塔,20230121,全国,全国,174,59,115
龙塔,20230122,全国,全国,207,59,148
龙塔,20230123,全国,全国,250,64,186
龙塔,20230124,全国,全国,180,0,180
龙塔,20230125,全国,全国,278,61,217
龙塔,20230126,全国,全国,309,61,248
龙塔,20230127,全国,全国,272,80,192
龙塔,20230128,全国,全国,264,64,200
龙塔,20230129,全国,全国,290,97,193
龙塔,20230130,全国,全国,278,74,204
龙塔,20230131,全国,全国,290,97,193
龙塔,20230201,全国,全国,271,68,203
龙塔,20230202,全国,全国,267,83,184
龙塔,20230203,全国,全国,285,89,196
龙塔,20230204,全国,全国,251,59,192
龙塔,20230205,全国,全国,244,66,178
龙塔,20230206,全国,全国,237,74,163
龙塔,20230207,全国,全国,246,76,170
龙塔,20230208,全国,全国,276,80,196
龙塔,20230209,全国,全国,289,61,228
龙塔,20230210,全国,全国,245,74,171
龙塔,20230211,全国,全国,254,64,190
龙塔,20230212,全国,全国,297,66,231
龙塔,20230213,全国,全国,273,68,205
龙塔,20230214,全国,全国,248,70,178
龙塔,20230215,全国,全国,228,68,160
龙塔,20230216,全国,全国,237,66,171
龙塔,20230217,全国,全国,244,76,168
龙塔,20230218,全国,全国,263,59,204
龙塔,20230219,全国,全国,265,61,204
龙塔,20230220,全国,全国,237,64,173
龙塔,20230221,全国,全国,240,66,174
龙塔,20230222,全国,全国,232,66,166
龙塔,20230223,全国,全国,221,70,151
龙塔,20230224,全国,全国,238,68,170
龙塔,20230225,全国,全国,277,66,211
龙塔,20230226,全国,全国,271,74,197
龙塔,20230227,全国,全国,252,76,176
龙塔,20230228,全国,全国,219,70,149
龙塔,20230301,全国,全国,229,74,155
龙塔,20230302,全国,全国,231,74,157
龙塔,20230303,全国,全国,241,76,165
龙塔,20230304,全国,全国,284,59,225
龙塔,20230305,全国,全国,257,68,189
龙塔,20230306,全国,全国,237,82,155
龙塔,20230307,全国,全国,236,72,164
龙塔,20230308,全国,全国,247,70,177
龙塔,20230309,全国,全国,227,72,155
龙塔,20230310,全国,全国,244,63,181
龙塔,20230311,全国,全国,264,61,203
龙塔,20230312,全国,全国,284,66,218
龙塔,20230313,全国,全国,244,74,170
龙塔,20230314,全国,全国,227,64,163
龙塔,20230315,全国,全国,239,76,163
龙塔,20230316,全国,全国,242,68,174
龙塔,20230317,全国,全国,249,64,185
龙塔,20230318,全国,全国,283,64,219
龙塔,20230319,全国,全国,281,70,211
龙塔,20230320,全国,全国,227,64,163
龙塔,20230321,全国,全国,243,70,173
龙塔,20230322,全国,全国,230,70,160
龙塔,20230323,全国,全国,242,74,168
龙塔,20230324,全国,全国,242,68,174
龙塔,20230325,全国,全国,264,61,203
龙塔,20230326,全国,全国,259,59,200
龙塔,20230327,全国,全国,242,74,168
龙塔,20230328,全国,全国,252,70,182
龙塔,20230329,全国,全国,248,74,174
龙塔,20230330,全国,全国,281,76,205
龙塔,20230331,全国,全国,257,59,198
龙塔,20230401,全国,全国,288,59,229
龙塔,20230402,全国,全国,283,64,219
龙塔,20230403,全国,全国,261,78,183
龙塔,20230404,全国,全国,286,82,204
龙塔,20230405,全国,全国,304,72,232
龙塔,20230406,全国,全国,235,64,171
龙塔,20230407,全国,全国,269,70,199
龙塔,20230408,全国,全国,285,63,222
龙塔,20230409,全国,全国,292,68,224
龙塔,20230410,全国,全国,233,72,161
龙塔,20230411,全国,全国,252,76,176
龙塔,20230412,全国,全国,272,82,190
龙塔,20230413,全国,全国,279,89,190
龙塔,20230414,全国,全国,273,78,195
龙塔,20230415,全国,全国,324,63,261
龙塔,20230416,全国,全国,300,61,239
龙塔,20230417,全国,全国,264,72,192
龙塔,20230418,全国,全国,237,61,176
龙塔,20230419,全国,全国,284,72,212
龙塔,20230420,全国,全国,292,72,220
龙塔,20230421,全国,全国,294,72,222
龙塔,20230422,全国,全国,299,64,235
龙塔,20230423,全国,全国,295,68,227
龙塔,20230424,全国,全国,285,76,209
龙塔,20230425,全国,全国,280,72,208
龙塔,20230426,全国,全国,305,85,220
龙塔,20230427,全国,全国,310,68,242
龙塔,20230428,全国,全国,391,74,317
龙塔,20230429,全国,全国,583,72,511
龙塔,20230430,全国,全国,640,72,568
龙塔,20230501,全国,全国,647,68,579
龙塔,20230502,全国,全国,537,64,473
龙塔,20230503,全国,全国,471,74,397
龙塔,20230504,全国,全国,322,72,250
龙塔,20230505,全国,全国,297,66,231
龙塔,20230506,全国,全国,286,68,218
龙塔,20230507,全国,全国,317,61,256
龙塔,20230508,全国,全国,279,78,201
龙塔,20230509,全国,全国,272,74,198
龙塔,20230510,全国,全国,292,78,214
龙塔,20230511,全国,全国,284,80,204
龙塔,20230512,全国,全国,259,66,193
龙塔,20230513,全国,全国,273,61,212
龙塔,20230514,全国,全国,287,59,228
龙塔,20230515,全国,全国,271,74,197
龙塔,20230516,全国,全国,244,61,183
龙塔,20230517,全国,全国,270,66,204
龙塔,20230518,全国,全国,283,82,201
龙塔,20230519,全国,全国,269,66,203
龙塔,20230520,全国,全国,275,61,214
龙塔,20230521,全国,全国,320,66,254
龙塔,20230522,全国,全国,258,61,197
龙塔,20230523,全国,全国,235,61,174
龙塔,20230524,全国,全国,248,66,182
龙塔,20230525,全国,全国,248,66,182
龙塔,20230526,全国,全国,238,61,177
龙塔,20230527,全国,全国,278,66,212
龙塔,20230528,全国,全国,271,63,208
龙塔,20230529,全国,全国,254,64,190
龙塔,20230530,全国,全国,261,64,197
龙塔,20230531,全国,全国,279,74,205
龙塔,20230601,全国,全国,265,80,185
龙塔,20230602,全国,全国,261,76,185
龙塔,20230603,全国,全国,290,59,231
龙塔,20230604,全国,全国,288,64,224
龙塔,20230605,全国,全国,244,66,178
龙塔,20230606,全国,全国,257,72,185
龙塔,20230607,全国,全国,313,82,231
龙塔,20230608,全国,全国,304,72,232
龙塔,20230609,全国,全国,294,80,214
龙塔,20230610,全国,全国,286,61,225
龙塔,20230611,全国,全国,342,68,274
龙塔,20230612,全国,全国,289,85,204
龙塔,20230613,全国,全国,267,72,195
龙塔,20230614,全国,全国,271,78,193
龙塔,20230615,全国,全国,269,80,189
龙塔,20230616,全国,全国,254,68,186
龙塔,20230617,全国,全国,285,61,224
龙塔,20230618,全国,全国,267,0,267
龙塔,20230619,全国,全国,265,76,189
龙塔,20230620,全国,全国,259,66,193
龙塔,20230621,全国,全国,243,59,184
龙塔,20230622,全国,全国,312,64,248
龙塔,20230623,全国,全国,309,59,250
龙塔,20230624,全国,全国,208,0,208
龙塔,20230625,全国,全国,287,76,211
龙塔,20230626,全国,全国,270,64,206
龙塔,20230627,全国,全国,276,76,200
龙塔,20230628,全国,全国,294,85,209
龙塔,20230629,全国,全国,267,64,203
龙塔,20230630,全国,全国,252,70,182
龙塔,20230701,全国,全国,255,63,192
龙塔,20230702,全国,全国,298,63,235
龙塔,20230703,全国,全国,278,72,206
龙塔,20230704,全国,全国,256,66,190
龙塔,20230705,全国,全国,284,76,208
龙塔,20230706,全国,全国,270,78,192
龙塔,20230707,全国,全国,295,68,227
龙塔,20230708,全国,全国,344,66,278
龙塔,20230709,全国,全国,334,72,262
龙塔,20230710,全国,全国,293,78,215
龙塔,20230711,全国,全国,314,68,246
龙塔,20230712,全国,全国,333,70,263
龙塔,20230713,全国,全国,298,76,222
龙塔,20230714,全国,全国,289,70,219
龙塔,20230715,全国,全国,328,61,267
龙塔,20230716,全国,全国,316,63,253
龙塔,20230717,全国,全国,331,76,255
龙塔,20230718,全国,全国,322,76,246
龙塔,20230719,全国,全国,319,74,245
龙塔,20230720,全国,全国,319,78,241
龙塔,20230721,全国,全国,346,78,268
龙塔,20230722,全国,全国,338,68,270
龙塔,20230723,全国,全国,341,68,273
龙塔,20230724,全国,全国,367,87,280
龙塔,20230725,全国,全国,313,78,235
龙塔,20230726,全国,全国,358,70,288
龙塔,20230727,全国,全国,332,64,268
龙塔,20230728,全国,全国,376,78,298
龙塔,20230729,全国,全国,361,72,289
龙塔,20230730,全国,全国,389,66,323
龙塔,20230731,全国,全国,355,70,285
龙塔,20230801,全国,全国,354,83,271
龙塔,20230802,全国,全国,325,78,247
龙塔,20230803,全国,全国,331,74,257
龙塔,20230804,全国,全国,311,70,241
龙塔,20230805,全国,全国,347,63,284
龙塔,20230806,全国,全国,341,63,278
龙塔,20230807,全国,全国,404,101,303
龙塔,20230808,全国,全国,282,64,218
龙塔,20230809,全国,全国,323,76,247
龙塔,20230810,全国,全国,344,70,274
龙塔,20230811,全国,全国,311,72,239
龙塔,20230812,全国,全国,313,66,247
龙塔,20230813,全国,全国,295,70,225
龙塔,20230814,全国,全国,305,74,231
龙塔,20230815,全国,全国,309,68,241
龙塔,20230816,全国,全国,335,68,267
龙塔,20230817,全国,全国,307,68,239
龙塔,20230818,全国,全国,306,70,236
龙塔,20230819,全国,全国,354,72,282
龙塔,20230820,全国,全国,317,61,256
龙塔,20230821,全国,全国,312,74,238
龙塔,20230822,全国,全国,316,82,234
龙塔,20230823,全国,全国,282,70,212
龙塔,20230824,全国,全国,307,68,239
龙塔,20230825,全国,全国,325,80,245
龙塔,20230826,全国,全国,319,72,247
龙塔,20230827,全国,全国,290,63,227
龙塔,20230828,全国,全国,317,70,247
龙塔,20230829,全国,全国,282,76,206
龙塔,20230830,全国,全国,293,78,215
龙塔,20230831,全国,全国,258,63,195
龙塔,20230901,全国,全国,249,59,190
龙塔,20230902,全国,全国,256,63,193
龙塔,20230903,全国,全国,215,0,215
龙塔,20230904,全国,全国,229,68,161
龙塔,20230905,全国,全国,223,63,160
龙塔,20230906,全国,全国,244,64,180
龙塔,20230907,全国,全国,240,70,170
龙塔,20230908,全国,全国,261,66,195
龙塔,20230909,全国,全国,293,59,234
龙塔,20230910,全国,全国,337,64,273
龙塔,20230911,全国,全国,251,80,171
龙塔,20230912,全国,全国,271,78,193
龙塔,20230913,全国,全国,258,72,186
龙塔,20230914,全国,全国,250,63,187
龙塔,20230915,全国,全国,258,63,195
龙塔,20230916,全国,全国,280,66,214
龙塔,20230917,全国,全国,267,59,208
龙塔,20230918,全国,全国,243,70,173
龙塔,20230919,全国,全国,236,74,162
龙塔,20230920,全国,全国,248,72,176
龙塔,20230921,全国,全国,220,66,154
龙塔,20230922,全国,全国,242,72,170
龙塔,20230923,全国,全国,201,0,201
龙塔,20230924,全国,全国,250,63,187
龙塔,20230925,全国,全国,200,70,130
龙塔,20230926,全国,全国,226,66,160
龙塔,20230927,全国,全国,249,66,183
龙塔,20230928,全国,全国,241,61,180
龙塔,20230929,全国,全国,264,59,205
龙塔,20230930,全国,全国,322,63,259
龙塔,20231001,全国,全国,310,0,310
龙塔,20231002,全国,全国,390,0,390
龙塔,20231003,全国,全国,423,61,362
龙塔,20231004,全国,全国,417,68,349
龙塔,20231005,全国,全国,333,72,261
龙塔,20231006,全国,全国,306,64,242
龙塔,20231007,全国,全国,196,0,196
龙塔,20231008,全国,全国,233,63,170
龙塔,20231009,全国,全国,257,70,187
龙塔,20231010,全国,全国,261,72,189
龙塔,20231011,全国,全国,293,72,221
龙塔,20231012,全国,全国,304,83,221
龙塔,20231013,全国,全国,256,70,186
龙塔,20231014,全国,全国,282,74,208
龙塔,20231015,全国,全国,256,66,190
龙塔,20231016,全国,全国,282,85,197
龙塔,20231017,全国,全国,246,72,174
龙塔,20231018,全国,全国,236,72,164
龙塔,20231019,全国,全国,239,78,161
龙塔,20231020,全国,全国,230,68,162
龙塔,20231021,全国,全国,259,70,189
龙塔,20231022,全国,全国,245,68,177
龙塔,20231023,全国,全国,227,70,157
龙塔,20231024,全国,全国,203,72,131
龙塔,20231025,全国,全国,196,64,132
龙塔,20231026,全国,全国,219,80,139
龙塔,20231027,全国,全国,224,72,152
龙塔,20231028,全国,全国,248,59,189
龙塔,20231029,全国,全国,263,70,193
龙塔,20231030,全国,全国,234,80,154
龙塔,20231031,全国,全国,220,66,154
龙塔,20231101,全国,全国,235,83,152
龙塔,20231102,全国,全国,238,78,160
龙塔,20231103,全国,全国,223,74,149
龙塔,20231104,全国,全国,247,68,179
龙塔,20231105,全国,全国,223,68,155
龙塔,20231106,全国,全国,222,78,144
龙塔,20231107,全国,全国,246,87,159
龙塔,20231108,全国,全国,221,74,147
龙塔,20231109,全国,全国,221,66,155
龙塔,20231110,全国,全国,196,70,126
龙塔,20231111,全国,全国,219,64,155
龙塔,20231112,全国,全国,223,68,155
龙塔,20231113,全国,全国,213,74,139
龙塔,20231114,全国,全国,227,76,151
龙塔,20231115,全国,全国,244,89,155
龙塔,20231116,全国,全国,218,83,135
龙塔,20231117,全国,全国,232,70,162
龙塔,20231118,全国,全国,170,0,170
龙塔,20231119,全国,全国,174,0,174
龙塔,20231120,全国,全国,215,70,145
龙塔,20231121,全国,全国,248,99,149
龙塔,20231122,全国,全国,201,80,121
龙塔,20231123,全国,全国,223,80,143
龙塔,20231124,全国,全国,249,76,173
龙塔,20231125,全国,全国,259,85,174
龙塔,20231126,全国,全国,254,80,174
龙塔,20231127,全国,全国,224,76,148
龙塔,20231128,全国,全国,252,82,170
龙塔,20231129,全国,全国,250,95,155
龙塔,20231130,全国,全国,242,95,147
龙塔,20231201,全国,全国,220,66,154
龙塔,20231202,全国,全国,236,66,170
龙塔,20231203,全国,全国,259,64,195
龙塔,20231204,全国,全国,243,82,161
龙塔,20231205,全国,全国,239,87,152
龙塔,20231206,全国,全国,223,68,155
龙塔,20231207,全国,全国,231,70,161
龙塔,20231208,全国,全国,249,82,167
龙塔,20231209,全国,全国,230,70,160
龙塔,20231210,全国,全国,238,72,166
龙塔,20231211,全国,全国,194,72,122
龙塔,20231212,全国,全国,209,78,131
龙塔,20231213,全国,全国,213,70,143
龙塔,20231214,全国,全国,239,68,171
龙塔,20231215,全国,全国,225,70,155
龙塔,20231216,全国,全国,224,63,161
龙塔,20231217,全国,全国,233,63,170
龙塔,20231218,全国,全国,227,64,163
龙塔,20231219,全国,全国,255,85,170
龙塔,20231220,全国,全国,221,64,157
龙塔,20231221,全国,全国,219,72,147
龙塔,20231222,全国,全国,240,66,174
龙塔,20231223,全国,全国,254,61,193
龙塔,20231224,全国,全国,270,70,200
龙塔,20231225,全国,全国,232,78,154
龙塔,20231226,全国,全国,247,76,171
龙塔,20231227,全国,全国,251,74,177
龙塔,20231228,全国,全国,251,66,185
龙塔,20231229,全国,全国,275,80,195
龙塔,20231230,全国,全国,281,70,211
龙塔,20231231,全国,全国,270,59,211
龙塔,20240101,全国,全国,270,61,209
龙塔,20240102,全国,全国,215,70,145
龙塔,20240103,全国,全国,301,93,208
龙塔,20240104,全国,全国,257,76,181
龙塔,20240105,全国,全国,314,102,212
龙塔,20240106,全国,全国,280,72,208
龙塔,20240107,全国,全国,263,59,204
龙塔,20240108,全国,全国,286,87,199
龙塔,20240109,全国,全国,306,89,217
龙塔,20240110,全国,全国,289,87,202
龙塔,20240111,全国,全国,250,72,178
龙塔,20240112,全国,全国,246,70,176
龙塔,20240113,全国,全国,268,76,192
龙塔,20240114,全国,全国,252,68,184
龙塔,20240115,全国,全国,270,85,185
龙塔,20240116,全国,全国,256,83,173
龙塔,20240117,全国,全国,282,87,195
龙塔,20240118,全国,全国,266,82,184
龙塔,20240119,全国,全国,272,80,192
龙塔,20240120,全国,全国,266,63,203
龙塔,20240121,全国,全国,264,66,198
龙塔,20240122,全国,全国,249,68,181
龙塔,20240123,全国,全国,226,63,163
龙塔,20240124,全国,全国,238,76,162
龙塔,20240125,全国,全国,246,78,168
龙塔,20240126,全国,全国,261,82,179
龙塔,20240127,全国,全国,262,85,177
龙塔,20240128,全国,全国,300,68,232
龙塔,20240129,全国,全国,282,70,212
龙塔,20240130,全国,全国,303,76,227
龙塔,20240131,全国,全国,269,74,195
龙塔,20240201,全国,全国,255,70,185
龙塔,20240202,全国,全国,250,72,178
龙塔,20240203,全国,全国,258,63,195
龙塔,20240204,全国,全国,255,66,189
龙塔,20240205,全国,全国,298,63,235
龙塔,20240206,全国,全国,278,72,206
龙塔,20240207,全国,全国,244,68,176
龙塔,20240208,全国,全国,235,61,174
龙塔,20240209,全国,全国,305,63,242
龙塔,20240210,全国,全国,288,64,224
龙塔,20240211,全国,全国,371,63,308
龙塔,20240212,全国,全国,355,61,294
龙塔,20240213,全国,全国,460,70,390
龙塔,20240214,全国,全国,429,64,365
龙塔,20240215,全国,全国,415,61,354
龙塔,20240216,全国,全国,343,59,284
龙塔,20240217,全国,全国,389,63,326
龙塔,20240218,全国,全国,336,70,266
龙塔,20240219,全国,全国,306,78,228
龙塔,20240220,全国,全国,307,72,235
龙塔,20240221,全国,全国,298,74,224
龙塔,20240222,全国,全国,333,85,248
龙塔,20240223,全国,全国,289,74,215
龙塔,20240224,全国,全国,295,64,231
龙塔,20240225,全国,全国,279,59,220
龙塔,20240226,全国,全国,288,64,224
龙塔,20240227,全国,全国,284,83,201
龙塔,20240228,全国,全国,237,61,176
龙塔,20240229,全国,全国,235,64,171
龙塔,20240301,全国,全国,239,76,163
龙塔,20240302,全国,全国,224,64,160
龙塔,20240303,全国,全国,244,64,180
龙塔,20240304,全国,全国,244,74,170
龙塔,20240305,全国,全国,235,72,163
龙塔,20240306,全国,全国,228,68,160
龙塔,20240307,全国,全国,244,70,174
龙塔,20240308,全国,全国,261,66,195
龙塔,20240309,全国,全国,301,70,231
龙塔,20240310,全国,全国,267,59,208
龙塔,20240311,全国,全国,278,89,189
龙塔,20240312,全国,全国,242,87,155
龙塔,20240313,全国,全国,221,64,157
龙塔,20240314,全国,全国,219,72,147
龙塔,20240315,全国,全国,231,76,155
龙塔,20240316,全国,全国,222,68,154
龙塔,20240317,全国,全国,232,64,168
龙塔,20240318,全国,全国,209,64,145
龙塔,20240319,全国,全国,238,74,164
龙塔,20240320,全国,全国,207,72,135
龙塔,20240321,全国,全国,226,72,154
龙塔,20240322,全国,全国,202,68,134
龙塔,20240323,全国,全国,229,63,166
龙塔,20240324,全国,全国,242,68,174
龙塔,20240325,全国,全国,216,72,144
龙塔,20240326,全国,全国,224,63,161
龙塔,20240327,全国,全国,225,68,157
龙塔,20240328,全国,全国,237,78,159
龙塔,20240329,全国,全国,223,68,155
龙塔,20240330,全国,全国,250,61,189
龙塔,20240331,全国,全国,231,70,161
龙塔,20240401,全国,全国,221,72,149
龙塔,20240402,全国,全国,240,76,164
龙塔,20240403,全国,全国,231,83,148
龙塔,20240404,全国,全国,319,63,256
龙塔,20240405,全国,全国,340,63,277
龙塔,20240406,全国,全国,268,68,200
龙塔,20240407,全国,全国,218,74,144
龙塔,20240408,全国,全国,203,68,135
龙塔,20240409,全国,全国,220,63,157
龙塔,20240410,全国,全国,203,68,135
龙塔,20240411,全国,全国,199,74,125
龙塔,20240412,全国,全国,198,70,128
龙塔,20240413,全国,全国,247,63,184
龙塔,20240414,全国,全国,236,74,162
龙塔,20240415,全国,全国,199,61,138
龙塔,20240416,全国,全国,233,74,159
龙塔,20240417,全国,全国,218,63,155
龙塔,20240418,全国,全国,215,66,149
龙塔,20240419,全国,全国,225,76,149
龙塔,20240420,全国,全国,230,59,171
龙塔,20240421,全国,全国,241,61,180
龙塔,20240422,全国,全国,206,68,138
龙塔,20240423,全国,全国,245,82,163
龙塔,20240424,全国,全国,246,76,170
龙塔,20240425,全国,全国,242,66,176
龙塔,20240426,全国,全国,231,72,159
龙塔,20240427,全国,全国,259,66,193
龙塔,20240428,全国,全国,238,80,158
龙塔,20240429,全国,全国,187,61,126
龙塔,20240430,全国,全国,260,68,192
龙塔,20240501,全国,全国,329,61,268
龙塔,20240502,全国,全国,364,59,305
龙塔,20240503,全国,全国,250,0,250
龙塔,20240504,全国,全国,338,64,274
龙塔,20240505,全国,全国,287,59,228
龙塔,20240506,全国,全国,221,70,151
龙塔,20240507,全国,全国,228,66,162
龙塔,20240508,全国,全国,169,61,108
龙塔,20240509,全国,全国,232,74,158
龙塔,20240510,全国,全国,217,66,151
哈尔滨文化公园,20220101,全国,全国,63,0,63
哈尔滨文化公园,20220102,全国,全国,78,0,78
哈尔滨文化公园,20220103,全国,全国,84,0,84
哈尔滨文化公园,20220104,全国,全国,61,0,61
哈尔滨文化公园,20220105,全国,全国,63,0,63
哈尔滨文化公园,20220106,全国,全国,76,0,76
哈尔滨文化公园,20220107,全国,全国,59,59,0
哈尔滨文化公园,20220108,全国,全国,67,0,67
哈尔滨文化公园,20220109,全国,全国,129,59,70
哈尔滨文化公园,20220110,全国,全国,61,0,61
哈尔滨文化公园,20220111,全国,全国,66,0,66
哈尔滨文化公园,20220112,全国,全国,74,0,74
哈尔滨文化公园,20220113,全国,全国,125,59,66
哈尔滨文化公园,20220114,全国,全国,70,0,70
哈尔滨文化公园,20220115,全国,全国,70,0,70
哈尔滨文化公园,20220116,全国,全国,69,0,69
哈尔滨文化公园,20220117,全国,全国,61,0,61
哈尔滨文化公园,20220118,全国,全国,134,63,71
哈尔滨文化公园,20220119,全国,全国,124,59,65
哈尔滨文化公园,20220120,全国,全国,0,0,0
哈尔滨文化公园,20220121,全国,全国,63,0,63
哈尔滨文化公园,20220122,全国,全国,65,0,65
哈尔滨文化公园,20220123,全国,全国,69,0,69
哈尔滨文化公园,20220124,全国,全国,69,0,69
哈尔滨文化公园,20220125,全国,全国,0,0,0
哈尔滨文化公园,20220126,全国,全国,59,59,0
哈尔滨文化公园,20220127,全国,全国,130,61,69
哈尔滨文化公园,20220128,全国,全国,126,61,65
哈尔滨文化公园,20220129,全国,全国,63,0,63
哈尔滨文化公园,20220130,全国,全国,0,0,0
哈尔滨文化公园,20220131,全国,全国,0,0,0
哈尔滨文化公园,20220201,全国,全国,71,0,71
哈尔滨文化公园,20220202,全国,全国,69,0,69
哈尔滨文化公园,20220203,全国,全国,70,0,70
哈尔滨文化公园,20220204,全国,全国,66,0,66
哈尔滨文化公园,20220205,全国,全国,67,0,67
哈尔滨文化公园,20220206,全国,全国,70,0,70
哈尔滨文化公园,20220207,全国,全国,0,0,0
哈尔滨文化公园,20220208,全国,全国,126,61,65
哈尔滨文化公园,20220209,全国,全国,126,59,67
哈尔滨文化公园,20220210,全国,全国,71,0,71
哈尔滨文化公园,20220211,全国,全国,67,0,67
哈尔滨文化公园,20220212,全国,全国,67,0,67
哈尔滨文化公园,20220213,全国,全国,66,0,66
哈尔滨文化公园,20220214,全国,全国,0,0,0
哈尔滨文化公园,20220215,全国,全国,66,0,66
哈尔滨文化公园,20220216,全国,全国,63,0,63
哈尔滨文化公园,20220217,全国,全国,67,0,67
哈尔滨文化公园,20220218,全国,全国,135,59,76
哈尔滨文化公园,20220219,全国,全国,71,0,71
哈尔滨文化公园,20220220,全国,全国,71,0,71
哈尔滨文化公园,20220221,全国,全国,126,59,67
哈尔滨文化公园,20220222,全国,全国,127,61,66
哈尔滨文化公园,20220223,全国,全国,67,0,67
哈尔滨文化公园,20220224,全国,全国,135,61,74
哈尔滨文化公园,20220225,全国,全国,71,0,71
哈尔滨文化公园,20220226,全国,全国,66,0,66
哈尔滨文化公园,20220227,全国,全国,71,0,71
哈尔滨文化公园,20220228,全国,全国,126,59,67
哈尔滨文化公园,20220301,全国,全国,78,0,78
哈尔滨文化公园,20220302,全国,全国,61,0,61
哈尔滨文化公园,20220303,全国,全国,144,68,76
哈尔滨文化公园,20220304,全国,全国,129,63,66
哈尔滨文化公园,20220305,全国,全国,63,0,63
哈尔滨文化公园,20220306,全国,全国,79,0,79
哈尔滨文化公园,20220307,全国,全国,71,0,71
哈尔滨文化公园,20220308,全国,全国,79,0,79
哈尔滨文化公园,20220309,全国,全国,74,0,74
哈尔滨文化公园,20220310,全国,全国,78,0,78
哈尔滨文化公园,20220311,全国,全国,70,0,70
哈尔滨文化公园,20220312,全国,全国,71,0,71
哈尔滨文化公园,20220313,全国,全国,139,61,78
哈尔滨文化公园,20220314,全国,全国,128,59,69
哈尔滨文化公园,20220315,全国,全国,133,63,70
哈尔滨文化公园,20220316,全国,全国,142,64,78
哈尔滨文化公园,20220317,全国,全国,65,0,65
哈尔滨文化公园,20220318,全国,全国,69,0,69
哈尔滨文化公园,20220319,全国,全国,71,0,71
哈尔滨文化公园,20220320,全国,全国,69,0,69
哈尔滨文化公园,20220321,全国,全国,130,61,69
哈尔滨文化公园,20220322,全国,全国,130,59,71
哈尔滨文化公园,20220323,全国,全国,65,0,65
哈尔滨文化公园,20220324,全国,全国,61,61,0
哈尔滨文化公园,20220325,全国,全国,126,59,67
哈尔滨文化公园,20220326,全国,全国,74,0,74
哈尔滨文化公园,20220327,全国,全国,79,0,79
哈尔滨文化公园,20220328,全国,全国,78,0,78
哈尔滨文化公园,20220329,全国,全国,120,59,61
哈尔滨文化公园,20220330,全国,全国,143,61,82
哈尔滨文化公园,20220331,全国,全国,74,0,74
哈尔滨文化公园,20220401,全国,全国,130,59,71
哈尔滨文化公园,20220402,全国,全国,78,0,78
哈尔滨文化公园,20220403,全国,全国,139,59,80
哈尔滨文化公园,20220404,全国,全国,71,0,71
哈尔滨文化公园,20220405,全国,全国,132,61,71
哈尔滨文化公园,20220406,全国,全国,67,0,67
哈尔滨文化公园,20220407,全国,全国,74,0,74
哈尔滨文化公园,20220408,全国,全国,76,0,76
哈尔滨文化公园,20220409,全国,全国,71,0,71
哈尔滨文化公园,20220410,全国,全国,76,0,76
哈尔滨文化公园,20220411,全国,全国,145,59,86
哈尔滨文化公园,20220412,全国,全国,136,66,70
哈尔滨文化公园,20220413,全国,全国,71,0,71
哈尔滨文化公园,20220414,全国,全国,73,0,73
哈尔滨文化公园,20220415,全国,全国,66,0,66
哈尔滨文化公园,20220416,全国,全国,73,0,73
哈尔滨文化公园,20220417,全国,全国,132,59,73
哈尔滨文化公园,20220418,全国,全国,67,0,67
哈尔滨文化公园,20220419,全国,全国,65,0,65
哈尔滨文化公园,20220420,全国,全国,78,0,78
哈尔滨文化公园,20220421,全国,全国,120,59,61
哈尔滨文化公园,20220422,全国,全国,74,0,74
哈尔滨文化公园,20220423,全国,全国,63,0,63
哈尔滨文化公园,20220424,全国,全国,122,59,63
哈尔滨文化公园,20220425,全国,全国,79,0,79
哈尔滨文化公园,20220426,全国,全国,80,0,80
哈尔滨文化公园,20220427,全国,全国,124,59,65
哈尔滨文化公园,20220428,全国,全国,80,0,80
哈尔滨文化公园,20220429,全国,全国,78,0,78
哈尔滨文化公园,20220430,全国,全国,143,59,84
哈尔滨文化公园,20220501,全国,全国,140,64,76
哈尔滨文化公园,20220502,全国,全国,80,0,80
哈尔滨文化公园,20220503,全国,全国,132,59,73
哈尔滨文化公园,20220504,全国,全国,78,0,78
哈尔滨文化公园,20220505,全国,全国,93,0,93
哈尔滨文化公园,20220506,全国,全国,137,61,76
哈尔滨文化公园,20220507,全国,全国,78,0,78
哈尔滨文化公园,20220508,全国,全国,99,0,99
哈尔滨文化公园,20220509,全国,全国,95,0,95
哈尔滨文化公园,20220510,全国,全国,146,59,87
哈尔滨文化公园,20220511,全国,全国,165,63,102
哈尔滨文化公园,20220512,全国,全国,79,0,79
哈尔滨文化公园,20220513,全国,全国,142,63,79
哈尔滨文化公园,20220514,全国,全国,158,59,99
哈尔滨文化公园,20220515,全国,全国,109,0,109
哈尔滨文化公园,20220516,全国,全国,141,59,82
哈尔滨文化公园,20220517,全国,全国,79,0,79
哈尔滨文化公园,20220518,全国,全国,86,0,86
哈尔滨文化公园,20220519,全国,全国,95,0,95
哈尔滨文化公园,20220520,全国,全国,92,0,92
哈尔滨文化公园,20220521,全国,全国,168,63,105
哈尔滨文化公园,20220522,全国,全国,118,0,118
哈尔滨文化公园,20220523,全国,全国,153,64,89
哈尔滨文化公园,20220524,全国,全国,154,61,93
哈尔滨文化公园,20220525,全国,全国,139,59,80
哈尔滨文化公园,20220526,全国,全国,145,61,84
哈尔滨文化公园,20220527,全国,全国,93,0,93
哈尔滨文化公园,20220528,全国,全国,182,59,123
哈尔滨文化公园,20220529,全国,全国,151,59,92
哈尔滨文化公园,20220530,全国,全国,150,66,84
哈尔滨文化公园,20220531,全国,全国,118,0,118
哈尔滨文化公园,20220601,全国,全国,239,63,176
哈尔滨文化公园,20220602,全国,全国,128,0,128
哈尔滨文化公园,20220603,全国,全国,195,0,195
哈尔滨文化公园,20220604,全国,全国,135,0,135
哈尔滨文化公园,20220605,全国,全国,109,0,109
哈尔滨文化公园,20220606,全国,全国,156,61,95
哈尔滨文化公园,20220607,全国,全国,169,63,106
哈尔滨文化公园,20220608,全国,全国,113,0,113
哈尔滨文化公园,20220609,全国,全国,193,68,125
哈尔滨文化公园,20220610,全国,全国,156,64,92
哈尔滨文化公园,20220611,全国,全国,173,61,112
哈尔滨文化公园,20220612,全国,全国,176,61,115
哈尔滨文化公园,20220613,全国,全国,163,61,102
哈尔滨文化公园,20220614,全国,全国,154,61,93
哈尔滨文化公园,20220615,全国,全国,138,59,79
哈尔滨文化公园,20220616,全国,全国,71,0,71
哈尔滨文化公园,20220617,全国,全国,172,66,106
哈尔滨文化公园,20220618,全国,全国,123,0,123
哈尔滨文化公园,20220619,全国,全国,102,0,102
哈尔滨文化公园,20220620,全国,全国,156,63,93
哈尔滨文化公园,20220621,全国,全国,106,0,106
哈尔滨文化公园,20220622,全国,全国,147,64,83
哈尔滨文化公园,20220623,全国,全国,86,0,86
哈尔滨文化公园,20220624,全国,全国,86,0,86
哈尔滨文化公园,20220625,全国,全国,163,61,102
哈尔滨文化公园,20220626,全国,全国,168,59,109
哈尔滨文化公园,20220627,全国,全国,155,59,96
哈尔滨文化公园,20220628,全国,全国,99,0,99
哈尔滨文化公园,20220629,全国,全国,176,61,115
哈尔滨文化公园,20220630,全国,全国,183,66,117
哈尔滨文化公园,20220701,全国,全国,169,63,106
哈尔滨文化公园,20220702,全国,全国,121,0,121
哈尔滨文化公园,20220703,全国,全国,192,61,131
哈尔滨文化公园,20220704,全国,全国,157,61,96
哈尔滨文化公园,20220705,全国,全国,177,59,118
哈尔滨文化公园,20220706,全国,全国,185,59,126
哈尔滨文化公园,20220707,全国,全国,186,63,123
哈尔滨文化公园,20220708,全国,全国,138,0,138
哈尔滨文化公园,20220709,全国,全国,203,59,144
哈尔滨文化公园,20220710,全国,全国,195,61,134
哈尔滨文化公园,20220711,全国,全国,211,59,152
哈尔滨文化公园,20220712,全国,全国,209,61,148
哈尔滨文化公园,20220713,全国,全国,198,63,135
哈尔滨文化公园,20220714,全国,全国,195,63,132
哈尔滨文化公园,20220715,全国,全国,138,0,138
哈尔滨文化公园,20220716,全国,全国,215,61,154
哈尔滨文化公园,20220717,全国,全国,171,0,171
哈尔滨文化公园,20220718,全国,全国,195,59,136
哈尔滨文化公园,20220719,全国,全国,217,59,158
哈尔滨文化公园,20220720,全国,全国,202,63,139
哈尔滨文化公园,20220721,全国,全国,203,64,139
哈尔滨文化公园,20220722,全国,全国,210,63,147
哈尔滨文化公园,20220723,全国,全国,230,63,167
哈尔滨文化公园,20220724,全国,全国,196,61,135
哈尔滨文化公园,20220725,全国,全国,189,63,126
哈尔滨文化公园,20220726,全国,全国,215,66,149
哈尔滨文化公园,20220727,全国,全国,155,0,155
哈尔滨文化公园,20220728,全国,全国,218,66,152
哈尔滨文化公园,20220729,全国,全国,187,64,123
哈尔滨文化公园,20220730,全国,全国,160,0,160
哈尔滨文化公园,20220731,全国,全国,174,0,174
哈尔滨文化公园,20220801,全国,全国,215,64,151
哈尔滨文化公园,20220802,全国,全国,216,61,155
哈尔滨文化公园,20220803,全国,全国,157,0,157
哈尔滨文化公园,20220804,全国,全国,209,61,148
哈尔滨文化公园,20220805,全国,全国,224,59,165
哈尔滨文化公园,20220806,全国,全国,245,64,181
哈尔滨文化公园,20220807,全国,全国,207,59,148
哈尔滨文化公园,20220808,全国,全国,211,59,152
哈尔滨文化公园,20220809,全国,全国,128,0,128
哈尔滨文化公园,20220810,全国,全国,157,61,96
哈尔滨文化公园,20220811,全国,全国,184,61,123
哈尔滨文化公园,20220812,全国,全国,131,0,131
哈尔滨文化公园,20220813,全国,全国,182,61,121
哈尔滨文化公园,20220814,全国,全国,145,0,145
哈尔滨文化公园,20220815,全国,全国,126,0,126
哈尔滨文化公园,20220816,全国,全国,119,0,119
哈尔滨文化公园,20220817,全国,全国,198,64,134
哈尔滨文化公园,20220818,全国,全国,180,59,121
哈尔滨文化公园,20220819,全国,全国,105,0,105
哈尔滨文化公园,20220820,全国,全国,135,0,135
哈尔滨文化公园,20220821,全国,全国,125,0,125
哈尔滨文化公园,20220822,全国,全国,150,59,91
哈尔滨文化公园,20220823,全国,全国,97,0,97
哈尔滨文化公园,20220824,全国,全国,102,0,102
哈尔滨文化公园,20220825,全国,全国,148,59,89
哈尔滨文化公园,20220826,全国,全国,92,0,92
哈尔滨文化公园,20220827,全国,全国,173,63,110
哈尔滨文化公园,20220828,全国,全国,87,0,87
哈尔滨文化公园,20220829,全国,全国,71,0,71
哈尔滨文化公园,20220830,全国,全国,73,0,73
哈尔滨文化公园,20220831,全国,全国,82,0,82
哈尔滨文化公园,20220901,全国,全国,124,59,65
哈尔滨文化公园,20220902,全国,全国,71,0,71
哈尔滨文化公园,20220903,全国,全国,133,59,74
哈尔滨文化公园,20220904,全国,全国,78,0,78
哈尔滨文化公园,20220905,全国,全国,67,0,67
哈尔滨文化公园,20220906,全国,全国,67,0,67
哈尔滨文化公园,20220907,全国,全国,132,61,71
哈尔滨文化公园,20220908,全国,全国,133,59,74
哈尔滨文化公园,20220909,全国,全国,143,59,84
哈尔滨文化公园,20220910,全国,全国,100,0,100
哈尔滨文化公园,20220911,全国,全国,100,0,100
哈尔滨文化公园,20220912,全国,全国,115,0,115
哈尔滨文化公园,20220913,全国,全国,137,61,76
哈尔滨文化公园,20220914,全国,全国,92,0,92
哈尔滨文化公园,20220915,全国,全国,80,0,80
哈尔滨文化公园,20220916,全国,全国,146,59,87
哈尔滨文化公园,20220917,全国,全国,80,0,80
哈尔滨文化公园,20220918,全国,全国,84,0,84
哈尔滨文化公园,20220919,全国,全国,69,0,69
哈尔滨文化公园,20220920,全国,全国,70,0,70
哈尔滨文化公园,20220921,全国,全国,126,59,67
哈尔滨文化公园,20220922,全国,全国,124,61,63
哈尔滨文化公园,20220923,全国,全国,61,0,61
哈尔滨文化公园,20220924,全国,全国,70,0,70
哈尔滨文化公园,20220925,全国,全国,95,0,95
哈尔滨文化公园,20220926,全国,全国,128,63,65
哈尔滨文化公园,20220927,全国,全国,131,61,70
哈尔滨文化公园,20220928,全国,全国,124,59,65
哈尔滨文化公园,20220929,全国,全国,71,0,71
哈尔滨文化公园,20220930,全国,全国,86,0,86
哈尔滨文化公园,20221001,全国,全国,109,0,109
哈尔滨文化公园,20221002,全国,全国,109,0,109
哈尔滨文化公园,20221003,全国,全国,76,0,76
哈尔滨文化公园,20221004,全国,全国,89,0,89
哈尔滨文化公园,20221005,全国,全国,76,0,76
哈尔滨文化公园,20221006,全国,全国,78,0,78
哈尔滨文化公园,20221007,全国,全国,78,0,78
哈尔滨文化公园,20221008,全国,全国,73,0,73
哈尔滨文化公园,20221009,全国,全国,63,0,63
哈尔滨文化公园,20221010,全国,全国,63,0,63
哈尔滨文化公园,20221011,全国,全国,69,0,69
哈尔滨文化公园,20221012,全国,全国,86,0,86
哈尔滨文化公园,20221013,全国,全国,67,0,67
哈尔滨文化公园,20221014,全国,全国,134,63,71
哈尔滨文化公园,20221015,全国,全国,73,0,73
哈尔滨文化公园,20221016,全国,全国,76,0,76
哈尔滨文化公园,20221017,全国,全国,73,0,73
哈尔滨文化公园,20221018,全国,全国,76,0,76
哈尔滨文化公园,20221019,全国,全国,78,0,78
哈尔滨文化公园,20221020,全国,全国,142,59,83
哈尔滨文化公园,20221021,全国,全国,82,0,82
哈尔滨文化公园,20221022,全国,全国,105,0,105
哈尔滨文化公园,20221023,全国,全国,100,0,100
哈尔滨文化公园,20221024,全国,全国,79,0,79
哈尔滨文化公园,20221025,全国,全国,70,0,70
哈尔滨文化公园,20221026,全国,全国,67,0,67
哈尔滨文化公园,20221027,全国,全国,87,0,87
哈尔滨文化公园,20221028,全国,全国,70,0,70
哈尔滨文化公园,20221029,全国,全国,74,0,74
哈尔滨文化公园,20221030,全国,全国,80,0,80
哈尔滨文化公园,20221031,全国,全国,133,59,74
哈尔滨文化公园,20221101,全国,全国,70,0,70
哈尔滨文化公园,20221102,全国,全国,66,0,66
哈尔滨文化公园,20221103,全国,全国,61,0,61
哈尔滨文化公园,20221104,全国,全国,61,0,61
哈尔滨文化公园,20221105,全国,全国,61,0,61
哈尔滨文化公园,20221106,全国,全国,73,0,73
哈尔滨文化公园,20221107,全国,全国,66,0,66
哈尔滨文化公园,20221108,全国,全国,71,0,71
哈尔滨文化公园,20221109,全国,全国,79,0,79
哈尔滨文化公园,20221110,全国,全国,73,0,73
哈尔滨文化公园,20221111,全国,全国,70,0,70
哈尔滨文化公园,20221112,全国,全国,124,59,65
哈尔滨文化公园,20221113,全国,全国,70,0,70
哈尔滨文化公园,20221114,全国,全国,61,0,61
哈尔滨文化公园,20221115,全国,全国,139,68,71
哈尔滨文化公园,20221116,全国,全国,66,0,66
哈尔滨文化公园,20221117,全国,全国,70,0,70
哈尔滨文化公园,20221118,全国,全国,0,0,0
哈尔滨文化公园,20221119,全国,全国,69,0,69
哈尔滨文化公园,20221120,全国,全国,122,59,63
哈尔滨文化公园,20221121,全国,全国,122,59,63
哈尔滨文化公园,20221122,全国,全国,65,0,65
哈尔滨文化公园,20221123,全国,全国,129,66,63
哈尔滨文化公园,20221124,全国,全国,65,0,65
哈尔滨文化公园,20221125,全国,全国,130,64,66
哈尔滨文化公园,20221126,全国,全国,0,0,0
哈尔滨文化公园,20221127,全国,全国,130,59,71
哈尔滨文化公园,20221128,全国,全国,0,0,0
哈尔滨文化公园,20221129,全国,全国,67,0,67
哈尔滨文化公园,20221130,全国,全国,64,64,0
哈尔滨文化公园,20221201,全国,全国,59,59,0
哈尔滨文化公园,20221202,全国,全国,65,0,65
哈尔滨文化公园,20221203,全国,全国,70,0,70
哈尔滨文化公园,20221204,全国,全国,70,0,70
哈尔滨文化公园,20221205,全国,全国,0,0,0
哈尔滨文化公园,20221206,全国,全国,0,0,0
哈尔滨文化公园,20221207,全国,全国,66,0,66
哈尔滨文化公园,20221208,全国,全国,65,0,65
哈尔滨文化公园,20221209,全国,全国,65,0,65
哈尔滨文化公园,20221210,全国,全国,67,0,67
哈尔滨文化公园,20221211,全国,全国,63,0,63
哈尔滨文化公园,20221212,全国,全国,66,0,66
哈尔滨文化公园,20221213,全国,全国,0,0,0
哈尔滨文化公园,20221214,全国,全国,126,59,67
哈尔滨文化公园,20221215,全国,全国,66,0,66
哈尔滨文化公园,20221216,全国,全国,70,0,70
哈尔滨文化公园,20221217,全国,全国,73,0,73
哈尔滨文化公园,20221218,全国,全国,63,0,63
哈尔滨文化公园,20221219,全国,全国,127,61,66
哈尔滨文化公园,20221220,全国,全国,63,0,63
哈尔滨文化公园,20221221,全国,全国,0,0,0
哈尔滨文化公园,20221222,全国,全国,61,0,61
哈尔滨文化公园,20221223,全国,全国,65,0,65
哈尔滨文化公园,20221224,全国,全国,0,0,0
哈尔滨文化公园,20221225,全国,全国,63,0,63
哈尔滨文化公园,20221226,全国,全国,0,0,0
哈尔滨文化公园,20221227,全国,全国,122,61,61
哈尔滨文化公园,20221228,全国,全国,128,63,65
哈尔滨文化公园,20221229,全国,全国,65,0,65
哈尔滨文化公园,20221230,全国,全国,83,0,83
哈尔滨文化公园,20221231,全国,全国,69,0,69
哈尔滨文化公园,20230101,全国,全国,61,0,61
哈尔滨文化公园,20230102,全国,全国,80,0,80
哈尔滨文化公园,20230103,全国,全国,69,0,69
哈尔滨文化公园,20230104,全国,全国,135,59,76
哈尔滨文化公园,20230105,全国,全国,132,59,73
哈尔滨文化公园,20230106,全国,全国,66,0,66
哈尔滨文化公园,20230107,全国,全国,84,0,84
哈尔滨文化公园,20230108,全国,全国,70,0,70
哈尔滨文化公园,20230109,全国,全国,132,59,73
哈尔滨文化公园,20230110,全国,全国,137,59,78
哈尔滨文化公园,20230111,全国,全国,130,59,71
哈尔滨文化公园,20230112,全国,全国,130,63,67
哈尔滨文化公园,20230113,全国,全国,137,61,76
哈尔滨文化公园,20230114,全国,全国,79,0,79
哈尔滨文化公园,20230115,全国,全国,92,0,92
哈尔滨文化公园,20230116,全国,全国,74,0,74
哈尔滨文化公园,20230117,全国,全国,79,0,79
哈尔滨文化公园,20230118,全国,全国,65,0,65
哈尔滨文化公园,20230119,全国,全国,74,0,74
哈尔滨文化公园,20230120,全国,全国,66,0,66
哈尔滨文化公园,20230121,全国,全国,69,0,69
哈尔滨文化公园,20230122,全国,全国,137,61,76
哈尔滨文化公园,20230123,全国,全国,87,0,87
哈尔滨文化公园,20230124,全国,全国,71,0,71
哈尔滨文化公园,20230125,全国,全国,73,0,73
哈尔滨文化公园,20230126,全国,全国,79,0,79
哈尔滨文化公园,20230127,全国,全国,84,0,84
哈尔滨文化公园,20230128,全国,全国,74,0,74
哈尔滨文化公园,20230129,全国,全国,73,0,73
哈尔滨文化公园,20230130,全国,全国,74,0,74
哈尔滨文化公园,20230131,全国,全国,137,61,76
哈尔滨文化公园,20230201,全国,全国,76,0,76
哈尔滨文化公园,20230202,全国,全国,76,0,76
哈尔滨文化公园,20230203,全国,全国,86,0,86
哈尔滨文化公园,20230204,全国,全国,83,0,83
哈尔滨文化公园,20230205,全国,全国,95,0,95
哈尔滨文化公园,20230206,全国,全国,74,0,74
哈尔滨文化公园,20230207,全国,全国,141,61,80
哈尔滨文化公园,20230208,全国,全国,86,0,86
哈尔滨文化公园,20230209,全国,全国,78,0,78
哈尔滨文化公园,20230210,全国,全国,100,0,100
哈尔滨文化公园,20230211,全国,全国,87,0,87
哈尔滨文化公园,20230212,全国,全国,80,0,80
哈尔滨文化公园,20230213,全国,全国,80,0,80
哈尔滨文化公园,20230214,全国,全国,76,0,76
哈尔滨文化公园,20230215,全国,全国,79,0,79
哈尔滨文化公园,20230216,全国,全国,78,0,78
哈尔滨文化公园,20230217,全国,全国,79,0,79
哈尔滨文化公园,20230218,全国,全国,92,0,92
哈尔滨文化公园,20230219,全国,全国,143,59,84
哈尔滨文化公园,20230220,全国,全国,74,0,74
哈尔滨文化公园,20230221,全国,全国,84,0,84
哈尔滨文化公园,20230222,全国,全国,80,0,80
哈尔滨文化公园,20230223,全国,全国,143,64,79
哈尔滨文化公园,20230224,全国,全国,140,61,79
哈尔滨文化公园,20230225,全国,全国,119,0,119
哈尔滨文化公园,20230226,全国,全国,92,0,92
哈尔滨文化公园,20230227,全国,全国,145,59,86
哈尔滨文化公园,20230228,全国,全国,69,0,69
哈尔滨文化公园,20230301,全国,全国,133,59,74
哈尔滨文化公园,20230302,全国,全国,141,61,80
哈尔滨文化公园,20230303,全国,全国,142,63,79
哈尔滨文化公园,20230304,全国,全国,109,0,109
哈尔滨文化公园,20230305,全国,全国,117,0,117
哈尔滨文化公园,20230306,全国,全国,83,0,83
哈尔滨文化公园,20230307,全国,全国,141,59,82
哈尔滨文化公园,20230308,全国,全国,118,0,118
哈尔滨文化公园,20230309,全国,全国,136,63,73
哈尔滨文化公园,20230310,全国,全国,89,0,89
哈尔滨文化公园,20230311,全国,全国,95,0,95
哈尔滨文化公园,20230312,全国,全国,105,0,105
哈尔滨文化公园,20230313,全国,全国,82,0,82
哈尔滨文化公园,20230314,全国,全国,99,0,99
哈尔滨文化公园,20230315,全国,全国,79,0,79
哈尔滨文化公园,20230316,全国,全国,87,0,87
哈尔滨文化公园,20230317,全国,全国,95,0,95
哈尔滨文化公园,20230318,全国,全国,110,0,110
哈尔滨文化公园,20230319,全国,全国,106,0,106
哈尔滨文化公园,20230320,全国,全国,161,61,100
哈尔滨文化公园,20230321,全国,全国,92,0,92
哈尔滨文化公园,20230322,全国,全国,86,0,86
哈尔滨文化公园,20230323,全国,全国,152,63,89
哈尔滨文化公园,20230324,全国,全国,86,0,86
哈尔滨文化公园,20230325,全国,全国,108,0,108
哈尔滨文化公园,20230326,全国,全国,99,0,99
哈尔滨文化公园,20230327,全国,全国,165,59,106
哈尔滨文化公园,20230328,全国,全国,91,0,91
哈尔滨文化公园,20230329,全国,全国,139,59,80
哈尔滨文化公园,20230330,全国,全国,153,61,92
哈尔滨文化公园,20230331,全国,全国,169,61,108
哈尔滨文化公园,20230401,全国,全国,224,61,163
哈尔滨文化公园,20230402,全国,全国,190,59,131
哈尔滨文化公园,20230403,全国,全国,156,61,95
哈尔滨文化公园,20230404,全国,全国,109,0,109
哈尔滨文化公园,20230405,全国,全国,193,61,132
哈尔滨文化公园,20230406,全国,全国,153,61,92
哈尔滨文化公园,20230407,全国,全国,108,0,108
哈尔滨文化公园,20230408,全国,全国,171,61,110
哈尔滨文化公园,20230409,全国,全国,138,0,138
哈尔滨文化公园,20230410,全国,全国,145,59,86
哈尔滨文化公园,20230411,全国,全国,96,0,96
哈尔滨文化公园,20230412,全国,全国,157,64,93
哈尔滨文化公园,20230413,全国,全国,147,61,86
哈尔滨文化公园,20230414,全国,全国,110,0,110
哈尔滨文化公园,20230415,全国,全国,195,59,136
哈尔滨文化公园,20230416,全国,全国,136,0,136
哈尔滨文化公园,20230417,全国,全国,162,63,99
哈尔滨文化公园,20230418,全国,全国,100,0,100
哈尔滨文化公园,20230419,全国,全国,146,59,87
哈尔滨文化公园,20230420,全国,全国,165,70,95
哈尔滨文化公园,20230421,全国,全国,167,63,104
哈尔滨文化公园,20230422,全国,全国,105,0,105
哈尔滨文化公园,20230423,全国,全国,152,59,93
哈尔滨文化公园,20230424,全国,全国,108,0,108
哈尔滨文化公园,20230425,全国,全国,163,61,102
哈尔滨文化公园,20230426,全国,全国,180,61,119
哈尔滨文化公园,20230427,全国,全国,135,0,135
哈尔滨文化公园,20230428,全国,全国,222,59,163
哈尔滨文化公园,20230429,全国,全国,177,0,177
哈尔滨文化公园,20230430,全国,全国,259,59,200
哈尔滨文化公园,20230501,全国,全国,334,59,275
哈尔滨文化公园,20230502,全国,全国,209,0,209
哈尔滨文化公园,20230503,全国,全国,191,59,132
哈尔滨文化公园,20230504,全国,全国,179,61,118
哈尔滨文化公园,20230505,全国,全国,118,0,118
哈尔滨文化公园,20230506,全国,全国,110,0,110
哈尔滨文化公园,20230507,全国,全国,169,59,110
哈尔滨文化公园,20230508,全国,全国,93,0,93
哈尔滨文化公园,20230509,全国,全国,100,0,100
哈尔滨文化公园,20230510,全国,全国,95,0,95
哈尔滨文化公园,20230511,全国,全国,99,0,99
哈尔滨文化公园,20230512,全国,全国,170,61,109
哈尔滨文化公园,20230513,全国,全国,161,59,102
哈尔滨文化公园,20230514,全国,全国,115,0,115
哈尔滨文化公园,20230515,全国,全国,117,0,117
哈尔滨文化公园,20230516,全国,全国,128,0,128
哈尔滨文化公园,20230517,全国,全国,173,61,112
哈尔滨文化公园,20230518,全国,全国,180,59,121
哈尔滨文化公园,20230519,全国,全国,157,61,96
哈尔滨文化公园,20230520,全国,全国,178,59,119
哈尔滨文化公园,20230521,全国,全国,99,0,99
哈尔滨文化公园,20230522,全国,全国,100,0,100
哈尔滨文化公园,20230523,全国,全国,112,0,112
哈尔滨文化公园,20230524,全国,全国,108,0,108
哈尔滨文化公园,20230525,全国,全国,165,63,102
哈尔滨文化公园,20230526,全国,全国,180,59,121
哈尔滨文化公园,20230527,全国,全国,200,59,141
哈尔滨文化公园,20230528,全国,全国,134,0,134
哈尔滨文化公园,20230529,全国,全国,165,63,102
哈尔滨文化公园,20230530,全国,全国,121,0,121
哈尔滨文化公园,20230531,全国,全国,110,0,110
哈尔滨文化公园,20230601,全国,全国,144,0,144
哈尔滨文化公园,20230602,全国,全国,119,0,119
哈尔滨文化公园,20230603,全国,全国,108,0,108
哈尔滨文化公园,20230604,全国,全国,131,0,131
哈尔滨文化公园,20230605,全国,全国,178,59,119
哈尔滨文化公园,20230606,全国,全国,165,59,106
哈尔滨文化公园,20230607,全国,全国,165,66,99
哈尔滨文化公园,20230608,全国,全国,173,64,109
哈尔滨文化公园,20230609,全国,全国,83,0,83
哈尔滨文化公园,20230610,全国,全国,99,0,99
哈尔滨文化公园,20230611,全国,全国,105,0,105
哈尔滨文化公园,20230612,全国,全国,105,0,105
哈尔滨文化公园,20230613,全国,全国,165,59,106
哈尔滨文化公园,20230614,全国,全国,167,59,108
哈尔滨文化公园,20230615,全国,全国,151,59,92
哈尔滨文化公园,20230616,全国,全国,158,63,95
哈尔滨文化公园,20230617,全国,全国,165,59,106
哈尔滨文化公园,20230618,全国,全国,108,0,108
哈尔滨文化公园,20230619,全国,全国,100,0,100
哈尔滨文化公园,20230620,全国,全国,91,0,91
哈尔滨文化公园,20230621,全国,全国,160,63,97
哈尔滨文化公园,20230622,全国,全国,132,0,132
哈尔滨文化公园,20230623,全国,全国,208,59,149
哈尔滨文化公园,20230624,全国,全国,95,0,95
哈尔滨文化公园,20230625,全国,全国,147,63,84
哈尔滨文化公园,20230626,全国,全国,172,63,109
哈尔滨文化公园,20230627,全国,全国,102,0,102
哈尔滨文化公园,20230628,全国,全国,142,59,83
哈尔滨文化公园,20230629,全国,全国,99,0,99
哈尔滨文化公园,20230630,全国,全国,99,0,99
哈尔滨文化公园,20230701,全国,全国,119,0,119
哈尔滨文化公园,20230702,全国,全国,123,0,123
哈尔滨文化公园,20230703,全国,全国,100,0,100
哈尔滨文化公园,20230704,全国,全国,99,0,99
哈尔滨文化公园,20230705,全国,全国,104,0,104
哈尔滨文化公园,20230706,全国,全国,184,61,123
哈尔滨文化公园,20230707,全国,全国,106,0,106
哈尔滨文化公园,20230708,全国,全国,130,0,130
哈尔滨文化公园,20230709,全国,全国,172,59,113
哈尔滨文化公园,20230710,全国,全国,172,59,113
哈尔滨文化公园,20230711,全国,全国,121,0,121
哈尔滨文化公园,20230712,全国,全国,179,64,115
哈尔滨文化公园,20230713,全国,全国,182,59,123
哈尔滨文化公园,20230714,全国,全国,104,0,104
哈尔滨文化公园,20230715,全国,全国,148,59,89
哈尔滨文化公园,20230716,全国,全国,91,0,91
哈尔滨文化公园,20230717,全国,全国,187,64,123
哈尔滨文化公园,20230718,全国,全国,184,61,123
哈尔滨文化公园,20230719,全国,全国,206,61,145
哈尔滨文化公园,20230720,全国,全国,168,59,109
哈尔滨文化公园,20230721,全国,全国,144,0,144
哈尔滨文化公园,20230722,全国,全国,117,0,117
哈尔滨文化公园,20230723,全国,全国,168,63,105
哈尔滨文化公园,20230724,全国,全国,110,0,110
哈尔滨文化公园,20230725,全国,全国,121,0,121
哈尔滨文化公园,20230726,全国,全国,123,0,123
哈尔滨文化公园,20230727,全国,全国,186,61,125
哈尔滨文化公园,20230728,全国,全国,193,59,134
哈尔滨文化公园,20230729,全国,全国,119,0,119
哈尔滨文化公园,20230730,全国,全国,193,59,134
哈尔滨文化公园,20230731,全国,全国,152,0,152
哈尔滨文化公园,20230801,全国,全国,131,0,131
哈尔滨文化公园,20230802,全国,全国,148,64,84
哈尔滨文化公园,20230803,全国,全国,117,0,117
哈尔滨文化公园,20230804,全国,全国,130,0,130
哈尔滨文化公园,20230805,全国,全国,181,64,117
哈尔滨文化公园,20230806,全国,全国,149,0,149
哈尔滨文化公园,20230807,全国,全国,106,0,106
哈尔滨文化公园,20230808,全国,全国,206,59,147
哈尔滨文化公园,20230809,全国,全国,117,0,117
哈尔滨文化公园,20230810,全国,全国,182,59,123
哈尔滨文化公园,20230811,全国,全国,185,64,121
哈尔滨文化公园,20230812,全国,全国,110,0,110
哈尔滨文化公园,20230813,全国,全国,130,0,130
哈尔滨文化公园,20230814,全国,全国,135,0,135
哈尔滨文化公园,20230815,全国,全国,212,61,151
哈尔滨文化公园,20230816,全国,全国,119,0,119
哈尔滨文化公园,20230817,全国,全国,119,0,119
哈尔滨文化公园,20230818,全国,全国,130,0,130
哈尔滨文化公园,20230819,全国,全国,128,0,128
哈尔滨文化公园,20230820,全国,全国,143,0,143
哈尔滨文化公园,20230821,全国,全国,175,63,112
哈尔滨文化公园,20230822,全国,全国,164,59,105
哈尔滨文化公园,20230823,全国,全国,147,0,147
哈尔滨文化公园,20230824,全国,全国,128,0,128
哈尔滨文化公园,20230825,全国,全国,160,63,97
哈尔滨文化公园,20230826,全国,全国,119,0,119
哈尔滨文化公园,20230827,全国,全国,167,59,108
哈尔滨文化公园,20230828,全国,全国,153,61,92
哈尔滨文化公园,20230829,全国,全国,140,61,79
哈尔滨文化公园,20230830,全国,全国,93,0,93
哈尔滨文化公园,20230831,全国,全国,89,0,89
哈尔滨文化公园,20230901,全国,全国,105,0,105
哈尔滨文化公园,20230902,全国,全国,113,0,113
哈尔滨文化公园,20230903,全国,全国,115,0,115
哈尔滨文化公园,20230904,全国,全国,86,0,86
哈尔滨文化公园,20230905,全国,全国,84,0,84
哈尔滨文化公园,20230906,全国,全国,96,0,96
哈尔滨文化公园,20230907,全国,全国,95,0,95
哈尔滨文化公园,20230908,全国,全国,110,0,110
哈尔滨文化公园,20230909,全国,全国,115,0,115
哈尔滨文化公园,20230910,全国,全国,171,59,112
哈尔滨文化公园,20230911,全国,全国,118,0,118
哈尔滨文化公园,20230912,全国,全国,158,61,97
哈尔滨文化公园,20230913,全国,全国,100,0,100
哈尔滨文化公园,20230914,全国,全国,165,61,104
哈尔滨文化公园,20230915,全国,全国,159,59,100
哈尔滨文化公园,20230916,全国,全国,162,63,99
哈尔滨文化公园,20230917,全国,全国,112,0,112
哈尔滨文化公园,20230918,全国,全国,80,0,80
哈尔滨文化公园,20230919,全国,全国,110,0,110
哈尔滨文化公园,20230920,全国,全国,93,0,93
哈尔滨文化公园,20230921,全国,全国,87,0,87
哈尔滨文化公园,20230922,全国,全国,92,0,92
哈尔滨文化公园,20230923,全国,全国,87,0,87
哈尔滨文化公园,20230924,全国,全国,89,0,89
哈尔滨文化公园,20230925,全国,全国,86,0,86
哈尔滨文化公园,20230926,全国,全国,99,0,99
哈尔滨文化公园,20230927,全国,全国,80,0,80
哈尔滨文化公园,20230928,全国,全国,163,61,102
哈尔滨文化公园,20230929,全国,全国,109,0,109
哈尔滨文化公园,20230930,全国,全国,104,0,104
哈尔滨文化公园,20231001,全国,全国,148,0,148
哈尔滨文化公园,20231002,全国,全国,118,0,118
哈尔滨文化公园,20231003,全国,全国,169,59,110
哈尔滨文化公园,20231004,全国,全国,108,0,108
哈尔滨文化公园,20231005,全国,全国,109,0,109
哈尔滨文化公园,20231006,全国,全国,89,0,89
哈尔滨文化公园,20231007,全国,全国,129,59,70
哈尔滨文化公园,20231008,全国,全国,147,63,84
哈尔滨文化公园,20231009,全国,全国,146,59,87
哈尔滨文化公园,20231010,全国,全国,74,0,74
哈尔滨文化公园,20231011,全国,全国,132,59,73
哈尔滨文化公园,20231012,全国,全国,84,0,84
哈尔滨文化公园,20231013,全国,全国,80,0,80
哈尔滨文化公园,20231014,全国,全国,93,0,93
哈尔滨文化公园,20231015,全国,全国,143,59,84
哈尔滨文化公园,20231016,全国,全国,80,0,80
哈尔滨文化公园,20231017,全国,全国,137,59,78
哈尔滨文化公园,20231018,全国,全国,67,0,67
哈尔滨文化公园,20231019,全国,全国,79,0,79
哈尔滨文化公园,20231020,全国,全国,67,0,67
哈尔滨文化公园,20231021,全国,全国,69,0,69
哈尔滨文化公园,20231022,全国,全国,70,0,70
哈尔滨文化公园,20231023,全国,全国,69,0,69
哈尔滨文化公园,20231024,全国,全国,67,0,67
哈尔滨文化公园,20231025,全国,全国,71,0,71
哈尔滨文化公园,20231026,全国,全国,63,0,63
哈尔滨文化公园,20231027,全国,全国,126,59,67
哈尔滨文化公园,20231028,全国,全国,78,0,78
哈尔滨文化公园,20231029,全国,全国,74,0,74
哈尔滨文化公园,20231030,全国,全国,70,0,70
哈尔滨文化公园,20231031,全国,全国,127,61,66
哈尔滨文化公园,20231101,全国,全国,122,59,63
哈尔滨文化公园,20231102,全国,全国,0,0,0
哈尔滨文化公园,20231103,全国,全国,0,0,0
哈尔滨文化公园,20231104,全国,全国,65,0,65
哈尔滨文化公园,20231105,全国,全国,66,0,66
哈尔滨文化公园,20231106,全国,全国,0,0,0
哈尔滨文化公园,20231107,全国,全国,61,0,61
哈尔滨文化公园,20231108,全国,全国,61,0,61
哈尔滨文化公园,20231109,全国,全国,0,0,0
哈尔滨文化公园,20231110,全国,全国,63,0,63
哈尔滨文化公园,20231111,全国,全国,0,0,0
哈尔滨文化公园,20231112,全国,全国,66,0,66
哈尔滨文化公园,20231113,全国,全国,61,0,61
哈尔滨文化公园,20231114,全国,全国,130,63,67
哈尔滨文化公园,20231115,全国,全国,0,0,0
哈尔滨文化公园,20231116,全国,全国,61,61,0
哈尔滨文化公园,20231117,全国,全国,59,59,0
哈尔滨文化公园,20231118,全国,全国,0,0,0
哈尔滨文化公园,20231119,全国,全国,65,0,65
哈尔滨文化公园,20231120,全国,全国,0,0,0
哈尔滨文化公园,20231121,全国,全国,63,63,0
哈尔滨文化公园,20231122,全国,全国,122,59,63
哈尔滨文化公园,20231123,全国,全国,59,59,0
哈尔滨文化公园,20231124,全国,全国,125,59,66
哈尔滨文化公园,20231125,全国,全国,70,0,70
哈尔滨文化公园,20231126,全国,全国,122,59,63
哈尔滨文化公园,20231127,全国,全国,61,0,61
哈尔滨文化公园,20231128,全国,全国,0,0,0
哈尔滨文化公园,20231129,全国,全国,67,0,67
哈尔滨文化公园,20231130,全国,全国,69,0,69
哈尔滨文化公园,20231201,全国,全国,122,59,63
哈尔滨文化公园,20231202,全国,全国,66,0,66
哈尔滨文化公园,20231203,全国,全国,132,59,73
哈尔滨文化公园,20231204,全国,全国,0,0,0
哈尔滨文化公园,20231205,全国,全国,73,0,73
哈尔滨文化公园,20231206,全国,全国,124,59,65
哈尔滨文化公园,20231207,全国,全国,63,0,63
哈尔滨文化公园,20231208,全国,全国,63,0,63
哈尔滨文化公园,20231209,全国,全国,124,59,65
哈尔滨文化公园,20231210,全国,全国,0,0,0
哈尔滨文化公园,20231211,全国,全国,0,0,0
哈尔滨文化公园,20231212,全国,全国,59,59,0
哈尔滨文化公园,20231213,全国,全国,61,61,0
哈尔滨文化公园,20231214,全国,全国,0,0,0
哈尔滨文化公园,20231215,全国,全国,0,0,0
哈尔滨文化公园,20231216,全国,全国,63,0,63
哈尔滨文化公园,20231217,全国,全国,65,0,65
哈尔滨文化公园,20231218,全国,全国,134,61,73
哈尔滨文化公园,20231219,全国,全国,128,59,69
哈尔滨文化公园,20231220,全国,全国,122,61,61
哈尔滨文化公园,20231221,全国,全国,59,59,0
哈尔滨文化公园,20231222,全国,全国,122,59,63
哈尔滨文化公园,20231223,全国,全国,70,0,70
哈尔滨文化公园,20231224,全国,全国,66,0,66
哈尔滨文化公园,20231225,全国,全国,0,0,0
哈尔滨文化公园,20231226,全国,全国,130,59,71
哈尔滨文化公园,20231227,全国,全国,61,0,61
哈尔滨文化公园,20231228,全国,全国,130,59,71
哈尔滨文化公园,20231229,全国,全国,135,66,69
哈尔滨文化公园,20231230,全国,全国,66,0,66
哈尔滨文化公园,20231231,全国,全国,71,0,71
哈尔滨文化公园,20240101,全国,全国,66,0,66
哈尔滨文化公园,20240102,全国,全国,59,59,0
哈尔滨文化公园,20240103,全国,全国,67,0,67
哈尔滨文化公园,20240104,全国,全国,78,0,78
哈尔滨文化公园,20240105,全国,全国,78,0,78
哈尔滨文化公园,20240106,全国,全国,69,0,69
哈尔滨文化公园,20240107,全国,全国,125,59,66
哈尔滨文化公园,20240108,全国,全国,74,0,74
哈尔滨文化公园,20240109,全国,全国,67,0,67
哈尔滨文化公园,20240110,全国,全国,61,0,61
哈尔滨文化公园,20240111,全国,全国,135,66,69
哈尔滨文化公园,20240112,全国,全国,71,0,71
哈尔滨文化公园,20240113,全国,全国,135,61,74
哈尔滨文化公园,20240114,全国,全国,61,0,61
哈尔滨文化公园,20240115,全国,全国,0,0,0
哈尔滨文化公园,20240116,全国,全国,61,0,61
哈尔滨文化公园,20240117,全国,全国,73,0,73
哈尔滨文化公园,20240118,全国,全国,61,0,61
哈尔滨文化公园,20240119,全国,全国,76,0,76
哈尔滨文化公园,20240120,全国,全国,80,0,80
哈尔滨文化公园,20240121,全国,全国,66,0,66
哈尔滨文化公园,20240122,全国,全国,61,0,61
哈尔滨文化公园,20240123,全国,全国,73,0,73
哈尔滨文化公园,20240124,全国,全国,73,0,73
哈尔滨文化公园,20240125,全国,全国,127,61,66
哈尔滨文化公园,20240126,全国,全国,63,0,63
哈尔滨文化公园,20240127,全国,全国,67,0,67
哈尔滨文化公园,20240128,全国,全国,127,61,66
哈尔滨文化公园,20240129,全国,全国,131,61,70
哈尔滨文化公园,20240130,全国,全国,70,0,70
哈尔滨文化公园,20240131,全国,全国,63,0,63
哈尔滨文化公园,20240201,全国,全国,0,0,0
哈尔滨文化公园,20240202,全国,全国,71,0,71
哈尔滨文化公园,20240203,全国,全国,67,0,67
哈尔滨文化公园,20240204,全国,全国,76,0,76
哈尔滨文化公园,20240205,全国,全国,69,0,69
哈尔滨文化公园,20240206,全国,全国,66,0,66
哈尔滨文化公园,20240207,全国,全国,73,0,73
哈尔滨文化公园,20240208,全国,全国,61,0,61
哈尔滨文化公园,20240209,全国,全国,0,0,0
哈尔滨文化公园,20240210,全国,全国,66,0,66
哈尔滨文化公园,20240211,全国,全国,71,0,71
哈尔滨文化公园,20240212,全国,全国,69,0,69
哈尔滨文化公园,20240213,全国,全国,71,0,71
哈尔滨文化公园,20240214,全国,全国,80,0,80
哈尔滨文化公园,20240215,全国,全国,76,0,76
哈尔滨文化公园,20240216,全国,全国,73,0,73
哈尔滨文化公园,20240217,全国,全国,73,0,73
哈尔滨文化公园,20240218,全国,全国,65,0,65
哈尔滨文化公园,20240219,全国,全国,136,63,73
哈尔滨文化公园,20240220,全国,全国,66,0,66
哈尔滨文化公园,20240221,全国,全国,66,0,66
哈尔滨文化公园,20240222,全国,全国,125,59,66
哈尔滨文化公园,20240223,全国,全国,126,61,65
哈尔滨文化公园,20240224,全国,全国,78,0,78
哈尔滨文化公园,20240225,全国,全国,65,0,65
哈尔滨文化公园,20240226,全国,全国,125,59,66
哈尔滨文化公园,20240227,全国,全国,0,0,0
哈尔滨文化公园,20240228,全国,全国,65,0,65
哈尔滨文化公园,20240229,全国,全国,63,0,63
哈尔滨文化公园,20240301,全国,全国,134,63,71
哈尔滨文化公园,20240302,全国,全国,0,0,0
哈尔滨文化公园,20240303,全国,全国,61,0,61
哈尔滨文化公园,20240304,全国,全国,65,0,65
哈尔滨文化公园,20240305,全国,全国,65,0,65
哈尔滨文化公园,20240306,全国,全国,0,0,0
哈尔滨文化公园,20240307,全国,全国,63,0,63
哈尔滨文化公园,20240308,全国,全国,69,0,69
哈尔滨文化公园,20240309,全国,全国,126,59,67
哈尔滨文化公园,20240310,全国,全国,74,0,74
哈尔滨文化公园,20240311,全国,全国,79,0,79
哈尔滨文化公园,20240312,全国,全国,128,59,69
哈尔滨文化公园,20240313,全国,全国,76,0,76
哈尔滨文化公园,20240314,全国,全国,130,59,71
哈尔滨文化公园,20240315,全国,全国,74,0,74
哈尔滨文化公园,20240316,全国,全国,76,0,76
哈尔滨文化公园,20240317,全国,全国,79,0,79
哈尔滨文化公园,20240318,全国,全国,79,0,79
哈尔滨文化公园,20240319,全国,全国,59,59,0
哈尔滨文化公园,20240320,全国,全国,133,66,67
哈尔滨文化公园,20240321,全国,全国,83,0,83
哈尔滨文化公园,20240322,全国,全国,74,0,74
哈尔滨文化公园,20240323,全国,全国,133,59,74
哈尔滨文化公园,20240324,全国,全国,76,0,76
哈尔滨文化公园,20240325,全国,全国,140,74,66
哈尔滨文化公园,20240326,全国,全国,0,0,0
哈尔滨文化公园,20240327,全国,全国,73,0,73
哈尔滨文化公园,20240328,全国,全国,78,0,78
哈尔滨文化公园,20240329,全国,全国,65,0,65
哈尔滨文化公园,20240330,全国,全国,133,63,70
哈尔滨文化公园,20240331,全国,全国,136,63,73
哈尔滨文化公园,20240401,全国,全国,146,63,83
哈尔滨文化公园,20240402,全国,全国,130,61,69
哈尔滨文化公园,20240403,全国,全国,126,59,67
哈尔滨文化公园,20240404,全国,全国,109,0,109
哈尔滨文化公园,20240405,全国,全国,110,0,110
哈尔滨文化公园,20240406,全国,全国,89,0,89
哈尔滨文化公园,20240407,全国,全国,137,61,76
哈尔滨文化公园,20240408,全国,全国,120,59,61
哈尔滨文化公园,20240409,全国,全国,63,0,63
哈尔滨文化公园,20240410,全国,全国,67,0,67
哈尔滨文化公园,20240411,全国,全国,69,0,69
哈尔滨文化公园,20240412,全国,全国,80,0,80
哈尔滨文化公园,20240413,全国,全国,134,61,73
哈尔滨文化公园,20240414,全国,全国,137,57,80
哈尔滨文化公园,20240415,全国,全国,73,0,73
哈尔滨文化公园,20240416,全国,全国,128,59,69
哈尔滨文化公园,20240417,全国,全国,130,57,73
哈尔滨文化公园,20240418,全国,全国,133,57,76
哈尔滨文化公园,20240419,全国,全国,135,61,74
哈尔滨文化公园,20240420,全国,全国,139,57,82
哈尔滨文化公园,20240421,全国,全国,163,57,106
哈尔滨文化公园,20240422,全国,全国,133,59,74
哈尔滨文化公园,20240423,全国,全国,78,0,78
哈尔滨文化公园,20240424,全国,全国,126,59,67
哈尔滨文化公园,20240425,全国,全国,70,0,70
哈尔滨文化公园,20240426,全国,全国,144,61,83
哈尔滨文化公园,20240427,全国,全国,84,0,84
哈尔滨文化公园,20240428,全国,全国,145,59,86
哈尔滨文化公园,20240429,全国,全国,135,61,74
哈尔滨文化公园,20240430,全国,全国,182,57,125
哈尔滨文化公园,20240501,全国,全国,187,64,123
哈尔滨文化公园,20240502,全国,全国,193,59,134
哈尔滨文化公园,20240503,全国,全国,118,0,118
哈尔滨文化公园,20240504,全国,全国,154,63,91
哈尔滨文化公园,20240505,全国,全国,80,0,80
哈尔滨文化公园,20240506,全国,全国,130,59,71
哈尔滨文化公园,20240507,全国,全国,132,63,69
哈尔滨文化公园,20240508,全国,全国,122,57,65
哈尔滨文化公园,20240509,全国,全国,130,59,71
哈尔滨文化公园,20240510,全国,全国,120,57,63
哈尔滨极地馆,20220101,全国,全国,200,59,141
哈尔滨极地馆,20220102,全国,全国,115,0,115
哈尔滨极地馆,20220103,全国,全国,181,68,113
哈尔滨极地馆,20220104,全国,全国,155,59,96
哈尔滨极地馆,20220105,全国,全国,178,66,112
哈尔滨极地馆,20220106,全国,全国,167,59,108
哈尔滨极地馆,20220107,全国,全国,192,61,131
哈尔滨极地馆,20220108,全国,全国,125,0,125
哈尔滨极地馆,20220109,全国,全国,123,0,123
哈尔滨极地馆,20220110,全国,全国,178,70,108
哈尔滨极地馆,20220111,全国,全国,109,0,109
哈尔滨极地馆,20220112,全国,全国,171,66,105
哈尔滨极地馆,20220113,全国,全国,162,63,99
哈尔滨极地馆,20220114,全国,全国,177,64,113
哈尔滨极地馆,20220115,全国,全国,227,66,161
哈尔滨极地馆,20220116,全国,全国,130,0,130
哈尔滨极地馆,20220117,全国,全国,184,59,125
哈尔滨极地馆,20220118,全国,全国,177,64,113
哈尔滨极地馆,20220119,全国,全国,157,64,93
哈尔滨极地馆,20220120,全国,全国,164,59,105
哈尔滨极地馆,20220121,全国,全国,160,64,96
哈尔滨极地馆,20220122,全国,全国,180,61,119
哈尔滨极地馆,20220123,全国,全国,158,63,95
哈尔滨极地馆,20220124,全国,全国,173,61,112
哈尔滨极地馆,20220125,全国,全国,155,59,96
哈尔滨极地馆,20220126,全国,全国,152,61,91
哈尔滨极地馆,20220127,全国,全国,176,66,110
哈尔滨极地馆,20220128,全国,全国,165,63,102
哈尔滨极地馆,20220129,全国,全国,168,64,104
哈尔滨极地馆,20220130,全国,全国,138,59,79
哈尔滨极地馆,20220131,全国,全国,95,0,95
哈尔滨极地馆,20220201,全国,全国,151,0,151
哈尔滨极地馆,20220202,全国,全国,180,0,180
哈尔滨极地馆,20220203,全国,全国,202,0,202
哈尔滨极地馆,20220204,全国,全国,255,59,196
哈尔滨极地馆,20220205,全国,全国,247,66,181
哈尔滨极地馆,20220206,全国,全国,179,0,179
哈尔滨极地馆,20220207,全国,全国,221,66,155
哈尔滨极地馆,20220208,全国,全国,221,66,155
哈尔滨极地馆,20220209,全国,全国,218,63,155
哈尔滨极地馆,20220210,全国,全国,211,66,145
哈尔滨极地馆,20220211,全国,全国,223,64,159
哈尔滨极地馆,20220212,全国,全国,254,68,186
哈尔滨极地馆,20220213,全国,全国,240,59,181
哈尔滨极地馆,20220214,全国,全国,234,70,164
哈尔滨极地馆,20220215,全国,全国,209,61,148
哈尔滨极地馆,20220216,全国,全国,191,72,119
哈尔滨极地馆,20220217,全国,全国,208,64,144
哈尔滨极地馆,20220218,全国,全国,157,0,157
哈尔滨极地馆,20220219,全国,全国,247,61,186
哈尔滨极地馆,20220220,全国,全国,211,63,148
哈尔滨极地馆,20220221,全国,全国,194,63,131
哈尔滨极地馆,20220222,全国,全国,185,66,119
哈尔滨极地馆,20220223,全国,全国,173,61,112
哈尔滨极地馆,20220224,全国,全国,145,0,145
哈尔滨极地馆,20220225,全国,全国,198,64,134
哈尔滨极地馆,20220226,全国,全国,197,61,136
哈尔滨极地馆,20220227,全国,全国,204,61,143
哈尔滨极地馆,20220228,全国,全国,185,72,113
哈尔滨极地馆,20220301,全国,全国,169,64,105
哈尔滨极地馆,20220302,全国,全国,159,66,93
哈尔滨极地馆,20220303,全国,全国,170,70,100
哈尔滨极地馆,20220304,全国,全国,172,63,109
哈尔滨极地馆,20220305,全国,全国,181,59,122
哈尔滨极地馆,20220306,全国,全国,122,0,122
哈尔滨极地馆,20220307,全国,全国,173,63,110
哈尔滨极地馆,20220308,全国,全国,156,59,97
哈尔滨极地馆,20220309,全国,全国,158,63,95
哈尔滨极地馆,20220310,全国,全国,168,64,104
哈尔滨极地馆,20220311,全国,全国,191,70,121
哈尔滨极地馆,20220312,全国,全国,171,59,112
哈尔滨极地馆,20220313,全国,全国,95,0,95
哈尔滨极地馆,20220314,全国,全国,135,59,76
哈尔滨极地馆,20220315,全国,全国,147,61,86
哈尔滨极地馆,20220316,全国,全国,140,64,76
哈尔滨极地馆,20220317,全国,全国,154,63,91
哈尔滨极地馆,20220318,全国,全国,143,64,79
哈尔滨极地馆,20220319,全国,全国,78,0,78
哈尔滨极地馆,20220320,全国,全国,167,63,104
哈尔滨极地馆,20220321,全国,全国,139,63,76
哈尔滨极地馆,20220322,全国,全国,151,72,79
哈尔滨极地馆,20220323,全国,全国,139,61,78
哈尔滨极地馆,20220324,全国,全国,145,63,82
哈尔滨极地馆,20220325,全国,全国,146,68,78
哈尔滨极地馆,20220326,全国,全国,134,61,73
哈尔滨极地馆,20220327,全国,全国,74,0,74
哈尔滨极地馆,20220328,全国,全国,141,61,80
哈尔滨极地馆,20220329,全国,全国,126,63,63
哈尔滨极地馆,20220330,全国,全国,139,63,76
哈尔滨极地馆,20220331,全国,全国,146,66,80
哈尔滨极地馆,20220401,全国,全国,79,0,79
哈尔滨极地馆,20220402,全国,全国,135,59,76
哈尔滨极地馆,20220403,全国,全国,69,0,69
哈尔滨极地馆,20220404,全国,全国,86,0,86
哈尔滨极地馆,20220405,全国,全国,91,0,91
哈尔滨极地馆,20220406,全国,全国,126,63,63
哈尔滨极地馆,20220407,全国,全国,152,66,86
哈尔滨极地馆,20220408,全国,全国,138,59,79
哈尔滨极地馆,20220409,全国,全国,82,0,82
哈尔滨极地馆,20220410,全国,全国,163,63,100
哈尔滨极地馆,20220411,全国,全国,161,66,95
哈尔滨极地馆,20220412,全国,全国,176,72,104
哈尔滨极地馆,20220413,全国,全国,146,64,82
哈尔滨极地馆,20220414,全国,全国,155,59,96
哈尔滨极地馆,20220415,全国,全国,141,61,80
哈尔滨极地馆,20220416,全国,全国,130,59,71
哈尔滨极地馆,20220417,全国,全国,152,59,93
哈尔滨极地馆,20220418,全国,全国,129,59,70
哈尔滨极地馆,20220419,全国,全国,74,0,74
哈尔滨极地馆,20220420,全国,全国,87,0,87
哈尔滨极地馆,20220421,全国,全国,148,59,89
哈尔滨极地馆,20220422,全国,全国,164,72,92
哈尔滨极地馆,20220423,全国,全国,152,59,93
哈尔滨极地馆,20220424,全国,全国,96,0,96
哈尔滨极地馆,20220425,全国,全国,146,63,83
哈尔滨极地馆,20220426,全国,全国,142,64,78
哈尔滨极地馆,20220427,全国,全国,156,59,97
哈尔滨极地馆,20220428,全国,全国,146,59,87
哈尔滨极地馆,20220429,全国,全国,146,59,87
哈尔滨极地馆,20220430,全国,全国,100,0,100
哈尔滨极地馆,20220501,全国,全国,150,61,89
哈尔滨极地馆,20220502,全国,全国,153,64,89
哈尔滨极地馆,20220503,全国,全国,141,59,82
哈尔滨极地馆,20220504,全国,全国,158,63,95
哈尔滨极地馆,20220505,全国,全国,161,68,93
哈尔滨极地馆,20220506,全国,全国,167,68,99
哈尔滨极地馆,20220507,全国,全国,171,66,105
哈尔滨极地馆,20220508,全国,全国,118,0,118
哈尔滨极地馆,20220509,全国,全国,168,68,100
哈尔滨极地馆,20220510,全国,全国,80,0,80
哈尔滨极地馆,20220511,全国,全国,152,63,89
哈尔滨极地馆,20220512,全国,全国,163,68,95
哈尔滨极地馆,20220513,全国,全国,160,63,97
哈尔滨极地馆,20220514,全国,全国,174,64,110
哈尔滨极地馆,20220515,全国,全国,168,59,109
哈尔滨极地馆,20220516,全国,全国,159,66,93
哈尔滨极地馆,20220517,全国,全国,148,61,87
哈尔滨极地馆,20220518,全国,全国,180,72,108
哈尔滨极地馆,20220519,全国,全国,181,66,115
哈尔滨极地馆,20220520,全国,全国,181,72,109
哈尔滨极地馆,20220521,全国,全国,193,59,134
哈尔滨极地馆,20220522,全国,全国,245,59,186
哈尔滨极地馆,20220523,全国,全国,202,61,141
哈尔滨极地馆,20220524,全国,全国,199,61,138
哈尔滨极地馆,20220525,全国,全国,222,74,148
哈尔滨极地馆,20220526,全国,全国,201,70,131
哈尔滨极地馆,20220527,全国,全国,214,63,151
哈尔滨极地馆,20220528,全国,全国,210,63,147
哈尔滨极地馆,20220529,全国,全国,216,59,157
哈尔滨极地馆,20220530,全国,全国,208,61,147
哈尔滨极地馆,20220531,全国,全国,231,61,170
哈尔滨极地馆,20220601,全国,全国,284,85,199
哈尔滨极地馆,20220602,全国,全国,289,74,215
哈尔滨极地馆,20220603,全国,全国,220,0,220
哈尔滨极地馆,20220604,全国,全国,269,80,189
哈尔滨极地馆,20220605,全国,全国,227,61,166
哈尔滨极地馆,20220606,全国,全国,211,72,139
哈尔滨极地馆,20220607,全国,全国,202,63,139
哈尔滨极地馆,20220608,全国,全国,205,64,141
哈尔滨极地馆,20220609,全国,全国,222,63,159
哈尔滨极地馆,20220610,全国,全国,243,64,179
哈尔滨极地馆,20220611,全国,全国,250,72,178
哈尔滨极地馆,20220612,全国,全国,178,0,178
哈尔滨极地馆,20220613,全国,全国,210,59,151
哈尔滨极地馆,20220614,全国,全国,221,66,155
哈尔滨极地馆,20220615,全国,全国,191,63,128
哈尔滨极地馆,20220616,全国,全国,221,76,145
哈尔滨极地馆,20220617,全国,全国,254,70,184
哈尔滨极地馆,20220618,全国,全国,248,63,185
哈尔滨极地馆,20220619,全国,全国,231,64,167
哈尔滨极地馆,20220620,全国,全国,198,63,135
哈尔滨极地馆,20220621,全国,全国,223,64,159
哈尔滨极地馆,20220622,全国,全国,216,61,155
哈尔滨极地馆,20220623,全国,全国,247,70,177
哈尔滨极地馆,20220624,全国,全国,255,76,179
哈尔滨极地馆,20220625,全国,全国,247,63,184
哈尔滨极地馆,20220626,全国,全国,256,64,192
哈尔滨极地馆,20220627,全国,全国,260,74,186
哈尔滨极地馆,20220628,全国,全国,279,70,209
哈尔滨极地馆,20220629,全国,全国,270,68,202
哈尔滨极地馆,20220630,全国,全国,294,70,224
哈尔滨极地馆,20220701,全国,全国,309,74,235
哈尔滨极地馆,20220702,全国,全国,320,63,257
哈尔滨极地馆,20220703,全国,全国,287,63,224
哈尔滨极地馆,20220704,全国,全国,279,68,211
哈尔滨极地馆,20220705,全国,全国,298,74,224
哈尔滨极地馆,20220706,全国,全国,333,72,261
哈尔滨极地馆,20220707,全国,全国,331,72,259
哈尔滨极地馆,20220708,全国,全国,332,80,252
哈尔滨极地馆,20220709,全国,全国,378,66,312
哈尔滨极地馆,20220710,全国,全国,385,61,324
哈尔滨极地馆,20220711,全国,全国,342,64,278
哈尔滨极地馆,20220712,全国,全国,379,85,294
哈尔滨极地馆,20220713,全国,全国,402,93,309
哈尔滨极地馆,20220714,全国,全国,433,82,351
哈尔滨极地馆,20220715,全国,全国,364,72,292
哈尔滨极地馆,20220716,全国,全国,350,76,274
哈尔滨极地馆,20220717,全国,全国,366,59,307
哈尔滨极地馆,20220718,全国,全国,342,72,270
哈尔滨极地馆,20220719,全国,全国,327,80,247
哈尔滨极地馆,20220720,全国,全国,380,91,289
哈尔滨极地馆,20220721,全国,全国,376,78,298
哈尔滨极地馆,20220722,全国,全国,428,83,345
哈尔滨极地馆,20220723,全国,全国,409,78,331
哈尔滨极地馆,20220724,全国,全国,366,59,307
哈尔滨极地馆,20220725,全国,全国,396,87,309
哈尔滨极地馆,20220726,全国,全国,429,87,342
哈尔滨极地馆,20220727,全国,全国,447,78,369
哈尔滨极地馆,20220728,全国,全国,441,83,358
哈尔滨极地馆,20220729,全国,全国,477,93,384
哈尔滨极地馆,20220730,全国,全国,459,68,391
哈尔滨极地馆,20220731,全国,全国,474,66,408
哈尔滨极地馆,20220801,全国,全国,472,70,402
哈尔滨极地馆,20220802,全国,全国,548,82,466
哈尔滨极地馆,20220803,全国,全国,507,87,420
哈尔滨极地馆,20220804,全国,全国,519,82,437
哈尔滨极地馆,20220805,全国,全国,519,99,420
哈尔滨极地馆,20220806,全国,全国,546,78,468
哈尔滨极地馆,20220807,全国,全国,510,64,446
哈尔滨极地馆,20220808,全国,全国,476,78,398
哈尔滨极地馆,20220809,全国,全国,292,64,228
哈尔滨极地馆,20220810,全国,全国,275,80,195
哈尔滨极地馆,20220811,全国,全国,272,64,208
哈尔滨极地馆,20220812,全国,全国,331,76,255
哈尔滨极地馆,20220813,全国,全国,285,63,222
哈尔滨极地馆,20220814,全国,全国,246,0,246
哈尔滨极地馆,20220815,全国,全国,307,66,241
哈尔滨极地馆,20220816,全国,全国,312,70,242
哈尔滨极地馆,20220817,全国,全国,320,74,246
哈尔滨极地馆,20220818,全国,全国,283,72,211
哈尔滨极地馆,20220819,全国,全国,291,80,211
哈尔滨极地馆,20220820,全国,全国,275,76,199
哈尔滨极地馆,20220821,全国,全国,208,59,149
哈尔滨极地馆,20220822,全国,全国,232,70,162
哈尔滨极地馆,20220823,全国,全国,208,64,144
哈尔滨极地馆,20220824,全国,全国,212,61,151
哈尔滨极地馆,20220825,全国,全国,208,63,145
哈尔滨极地馆,20220826,全国,全国,242,72,170
哈尔滨极地馆,20220827,全国,全国,240,74,166
哈尔滨极地馆,20220828,全国,全国,130,0,130
哈尔滨极地馆,20220829,全国,全国,158,59,99
哈尔滨极地馆,20220830,全国,全国,156,63,93
哈尔滨极地馆,20220831,全国,全国,165,63,102
哈尔滨极地馆,20220901,全国,全国,76,0,76
哈尔滨极地馆,20220902,全国,全国,155,64,91
哈尔滨极地馆,20220903,全国,全国,142,59,83
哈尔滨极地馆,20220904,全国,全国,163,63,100
哈尔滨极地馆,20220905,全国,全国,138,64,74
哈尔滨极地馆,20220906,全国,全国,146,63,83
哈尔滨极地馆,20220907,全国,全国,160,61,99
哈尔滨极地馆,20220908,全国,全国,158,63,95
哈尔滨极地馆,20220909,全国,全国,159,63,96
哈尔滨极地馆,20220910,全国,全国,117,0,117
哈尔滨极地馆,20220911,全国,全国,221,66,155
哈尔滨极地馆,20220912,全国,全国,204,61,143
哈尔滨极地馆,20220913,全国,全国,184,72,112
哈尔滨极地馆,20220914,全国,全国,187,66,121
哈尔滨极地馆,20220915,全国,全国,182,59,123
哈尔滨极地馆,20220916,全国,全国,215,68,147
哈尔滨极地馆,20220917,全国,全国,220,61,159
哈尔滨极地馆,20220918,全国,全国,123,0,123
哈尔滨极地馆,20220919,全国,全国,154,63,91
哈尔滨极地馆,20220920,全国,全国,177,64,113
哈尔滨极地馆,20220921,全国,全国,156,63,93
哈尔滨极地馆,20220922,全国,全国,169,64,105
哈尔滨极地馆,20220923,全国,全国,156,64,92
哈尔滨极地馆,20220924,全国,全国,102,0,102
哈尔滨极地馆,20220925,全国,全国,166,64,102
哈尔滨极地馆,20220926,全国,全国,145,61,84
哈尔滨极地馆,20220927,全国,全国,150,61,89
哈尔滨极地馆,20220928,全国,全国,165,70,95
哈尔滨极地馆,20220929,全国,全国,179,66,113
哈尔滨极地馆,20220930,全国,全国,184,66,118
哈尔滨极地馆,20221001,全国,全国,119,0,119
哈尔滨极地馆,20221002,全国,全国,202,63,139
哈尔滨极地馆,20221003,全国,全国,174,59,115
哈尔滨极地馆,20221004,全国,全国,169,63,106
哈尔滨极地馆,20221005,全国,全国,168,63,105
哈尔滨极地馆,20221006,全国,全国,168,63,105
哈尔滨极地馆,20221007,全国,全国,142,59,83
哈尔滨极地馆,20221008,全国,全国,169,64,105
哈尔滨极地馆,20221009,全国,全国,146,70,76
哈尔滨极地馆,20221010,全国,全国,148,61,87
哈尔滨极地馆,20221011,全国,全国,169,72,97
哈尔滨极地馆,20221012,全国,全国,170,74,96
哈尔滨极地馆,20221013,全国,全国,161,70,91
哈尔滨极地馆,20221014,全国,全国,173,63,110
哈尔滨极地馆,20221015,全国,全国,100,0,100
哈尔滨极地馆,20221016,全国,全国,117,0,117
哈尔滨极地馆,20221017,全国,全国,191,72,119
哈尔滨极地馆,20221018,全国,全国,151,59,92
哈尔滨极地馆,20221019,全国,全国,155,64,91
哈尔滨极地馆,20221020,全国,全国,178,68,110
哈尔滨极地馆,20221021,全国,全国,157,61,96
哈尔滨极地馆,20221022,全国,全国,108,0,108
哈尔滨极地馆,20221023,全国,全国,168,66,102
哈尔滨极地馆,20221024,全国,全国,157,68,89
哈尔滨极地馆,20221025,全国,全国,158,63,95
哈尔滨极地馆,20221026,全国,全国,183,74,109
哈尔滨极地馆,20221027,全国,全国,178,68,110
哈尔滨极地馆,20221028,全国,全国,160,64,96
哈尔滨极地馆,20221029,全国,全国,159,59,100
哈尔滨极地馆,20221030,全国,全国,89,0,89
哈尔滨极地馆,20221031,全国,全国,92,0,92
哈尔滨极地馆,20221101,全国,全国,180,61,119
哈尔滨极地馆,20221102,全国,全国,146,59,87
哈尔滨极地馆,20221103,全国,全国,141,59,82
哈尔滨极地馆,20221104,全国,全国,158,63,95
哈尔滨极地馆,20221105,全国,全国,82,0,82
哈尔滨极地馆,20221106,全国,全国,142,59,83
哈尔滨极地馆,20221107,全国,全国,149,66,83
哈尔滨极地馆,20221108,全国,全国,133,59,74
哈尔滨极地馆,20221109,全国,全国,143,64,79
哈尔滨极地馆,20221110,全国,全国,146,68,78
哈尔滨极地馆,20221111,全国,全国,87,0,87
哈尔滨极地馆,20221112,全国,全国,160,64,96
哈尔滨极地馆,20221113,全国,全国,96,0,96
哈尔滨极地馆,20221114,全国,全国,128,59,69
哈尔滨极地馆,20221115,全国,全国,143,61,82
哈尔滨极地馆,20221116,全国,全国,153,61,92
哈尔滨极地馆,20221117,全国,全国,155,63,92
哈尔滨极地馆,20221118,全国,全国,161,61,100
哈尔滨极地馆,20221119,全国,全国,182,78,104
哈尔滨极地馆,20221120,全国,全国,146,66,80
哈尔滨极地馆,20221121,全国,全国,158,63,95
哈尔滨极地馆,20221122,全国,全国,145,63,82
哈尔滨极地馆,20221123,全国,全国,143,61,82
哈尔滨极地馆,20221124,全国,全国,181,76,105
哈尔滨极地馆,20221125,全国,全国,138,68,70
哈尔滨极地馆,20221126,全国,全国,132,61,71
哈尔滨极地馆,20221127,全国,全国,80,0,80
哈尔滨极地馆,20221128,全国,全国,137,63,74
哈尔滨极地馆,20221129,全国,全国,139,59,80
哈尔滨极地馆,20221130,全国,全国,142,66,76
哈尔滨极地馆,20221201,全国,全国,84,0,84
哈尔滨极地馆,20221202,全国,全国,84,0,84
哈尔滨极地馆,20221203,全国,全国,82,0,82
哈尔滨极地馆,20221204,全国,全国,147,64,83
哈尔滨极地馆,20221205,全国,全国,143,63,80
哈尔滨极地馆,20221206,全国,全国,163,64,99
哈尔滨极地馆,20221207,全国,全国,95,0,95
哈尔滨极地馆,20221208,全国,全国,166,74,92
哈尔滨极地馆,20221209,全国,全国,161,61,100
哈尔滨极地馆,20221210,全国,全国,154,63,91
哈尔滨极地馆,20221211,全国,全国,152,66,86
哈尔滨极地馆,20221212,全国,全国,177,68,109
哈尔滨极地馆,20221213,全国,全国,92,0,92
哈尔滨极地馆,20221214,全国,全国,165,68,97
哈尔滨极地馆,20221215,全国,全国,143,59,84
哈尔滨极地馆,20221216,全国,全国,171,59,112
哈尔滨极地馆,20221217,全国,全国,175,66,109
哈尔滨极地馆,20221218,全国,全国,91,0,91
哈尔滨极地馆,20221219,全国,全国,146,59,87
哈尔滨极地馆,20221220,全国,全国,150,68,82
哈尔滨极地馆,20221221,全国,全国,157,64,93
哈尔滨极地馆,20221222,全国,全国,141,61,80
哈尔滨极地馆,20221223,全国,全国,159,63,96
哈尔滨极地馆,20221224,全国,全国,160,61,99
哈尔滨极地馆,20221225,全国,全国,161,61,100
哈尔滨极地馆,20221226,全国,全国,163,66,97
哈尔滨极地馆,20221227,全国,全国,148,66,82
哈尔滨极地馆,20221228,全国,全国,166,64,102
哈尔滨极地馆,20221229,全国,全国,176,66,110
哈尔滨极地馆,20221230,全国,全国,175,66,109
哈尔滨极地馆,20221231,全国,全国,199,61,138
哈尔滨极地馆,20230101,全国,全国,199,63,136
哈尔滨极地馆,20230102,全国,全国,218,63,155
哈尔滨极地馆,20230103,全国,全国,218,63,155
哈尔滨极地馆,20230104,全国,全国,210,78,132
哈尔滨极地馆,20230105,全国,全国,233,66,167
哈尔滨极地馆,20230106,全国,全国,356,101,255
哈尔滨极地馆,20230107,全国,全国,300,76,224
哈尔滨极地馆,20230108,全国,全国,301,70,231
哈尔滨极地馆,20230109,全国,全国,287,89,198
哈尔滨极地馆,20230110,全国,全国,305,76,229
哈尔滨极地馆,20230111,全国,全国,311,68,243
哈尔滨极地馆,20230112,全国,全国,335,99,236
哈尔滨极地馆,20230113,全国,全国,294,70,224
哈尔滨极地馆,20230114,全国,全国,325,66,259
哈尔滨极地馆,20230115,全国,全国,319,59,260
哈尔滨极地馆,20230116,全国,全国,349,87,262
哈尔滨极地馆,20230117,全国,全国,321,82,239
哈尔滨极地馆,20230118,全国,全国,295,80,215
哈尔滨极地馆,20230119,全国,全国,278,76,202
哈尔滨极地馆,20230120,全国,全国,260,64,196
哈尔滨极地馆,20230121,全国,全国,236,66,170
哈尔滨极地馆,20230122,全国,全国,395,64,331
哈尔滨极地馆,20230123,全国,全国,402,64,338
哈尔滨极地馆,20230124,全国,全国,438,61,377
哈尔滨极地馆,20230125,全国,全国,397,70,327
哈尔滨极地馆,20230126,全国,全国,451,63,388
哈尔滨极地馆,20230127,全国,全国,366,70,296
哈尔滨极地馆,20230128,全国,全国,416,70,346
哈尔滨极地馆,20230129,全国,全国,371,91,280
哈尔滨极地馆,20230130,全国,全国,342,74,268
哈尔滨极地馆,20230131,全国,全国,325,80,245
哈尔滨极地馆,20230201,全国,全国,360,87,273
哈尔滨极地馆,20230202,全国,全国,321,72,249
哈尔滨极地馆,20230203,全国,全国,372,76,296
哈尔滨极地馆,20230204,全国,全国,340,74,266
哈尔滨极地馆,20230205,全国,全国,260,59,201
哈尔滨极地馆,20230206,全国,全国,324,85,239
哈尔滨极地馆,20230207,全国,全国,317,83,234
哈尔滨极地馆,20230208,全国,全国,288,70,218
哈尔滨极地馆,20230209,全国,全国,365,80,285
哈尔滨极地馆,20230210,全国,全国,365,66,299
哈尔滨极地馆,20230211,全国,全国,319,70,249
哈尔滨极地馆,20230212,全国,全国,329,59,270
哈尔滨极地馆,20230213,全国,全国,309,70,239
哈尔滨极地馆,20230214,全国,全国,264,63,201
哈尔滨极地馆,20230215,全国,全国,282,63,219
哈尔滨极地馆,20230216,全国,全国,310,72,238
哈尔滨极地馆,20230217,全国,全国,335,85,250
哈尔滨极地馆,20230218,全国,全国,274,66,208
哈尔滨极地馆,20230219,全国,全国,201,0,201
哈尔滨极地馆,20230220,全国,全国,263,78,185
哈尔滨极地馆,20230221,全国,全国,230,66,164
哈尔滨极地馆,20230222,全国,全国,228,66,162
哈尔滨极地馆,20230223,全国,全国,237,70,167
哈尔滨极地馆,20230224,全国,全国,252,66,186
哈尔滨极地馆,20230225,全国,全国,241,68,173
哈尔滨极地馆,20230226,全国,全国,238,64,174
哈尔滨极地馆,20230227,全国,全国,205,66,139
哈尔滨极地馆,20230228,全国,全国,220,63,157
哈尔滨极地馆,20230301,全国,全国,233,70,163
哈尔滨极地馆,20230302,全国,全国,202,66,136
哈尔滨极地馆,20230303,全国,全国,243,76,167
哈尔滨极地馆,20230304,全国,全国,282,63,219
哈尔滨极地馆,20230305,全国,全国,232,59,173
哈尔滨极地馆,20230306,全国,全国,230,68,162
哈尔滨极地馆,20230307,全国,全国,221,74,147
哈尔滨极地馆,20230308,全国,全国,200,66,134
哈尔滨极地馆,20230309,全国,全国,206,61,145
哈尔滨极地馆,20230310,全国,全国,223,63,160
哈尔滨极地馆,20230311,全国,全国,158,0,158
哈尔滨极地馆,20230312,全国,全国,231,61,170
哈尔滨极地馆,20230313,全国,全国,234,68,166
哈尔滨极地馆,20230314,全国,全国,155,0,155
哈尔滨极地馆,20230315,全国,全国,242,72,170
哈尔滨极地馆,20230316,全国,全国,227,64,163
哈尔滨极地馆,20230317,全国,全国,256,66,190
哈尔滨极地馆,20230318,全国,全国,270,64,206
哈尔滨极地馆,20230319,全国,全国,249,72,177
哈尔滨极地馆,20230320,全国,全国,239,68,171
哈尔滨极地馆,20230321,全国,全国,236,66,170
哈尔滨极地馆,20230322,全国,全国,231,64,167
哈尔滨极地馆,20230323,全国,全国,246,78,168
哈尔滨极地馆,20230324,全国,全国,270,68,202
哈尔滨极地馆,20230325,全国,全国,276,64,212
哈尔滨极地馆,20230326,全国,全国,237,63,174
哈尔滨极地馆,20230327,全国,全国,251,72,179
哈尔滨极地馆,20230328,全国,全国,232,72,160
哈尔滨极地馆,20230329,全国,全国,250,74,176
哈尔滨极地馆,20230330,全国,全国,238,68,170
哈尔滨极地馆,20230331,全国,全国,273,78,195
哈尔滨极地馆,20230401,全国,全国,192,0,192
哈尔滨极地馆,20230402,全国,全国,236,66,170
哈尔滨极地馆,20230403,全国,全国,227,64,163
哈尔滨极地馆,20230404,全国,全国,276,76,200
哈尔滨极地馆,20230405,全国,全国,198,0,198
哈尔滨极地馆,20230406,全国,全国,239,66,173
哈尔滨极地馆,20230407,全国,全国,246,68,178
哈尔滨极地馆,20230408,全国,全国,277,63,214
哈尔滨极地馆,20230409,全国,全国,272,74,198
哈尔滨极地馆,20230410,全国,全国,243,70,173
哈尔滨极地馆,20230411,全国,全国,240,76,164
哈尔滨极地馆,20230412,全国,全国,243,85,158
哈尔滨极地馆,20230413,全国,全国,291,83,208
哈尔滨极地馆,20230414,全国,全国,286,72,214
哈尔滨极地馆,20230415,全国,全国,276,64,212
哈尔滨极地馆,20230416,全国,全国,297,70,227
哈尔滨极地馆,20230417,全国,全国,277,87,190
哈尔滨极地馆,20230418,全国,全国,299,82,217
哈尔滨极地馆,20230419,全国,全国,285,76,209
哈尔滨极地馆,20230420,全国,全国,347,108,239
哈尔滨极地馆,20230421,全国,全国,351,85,266
哈尔滨极地馆,20230422,全国,全国,339,68,271
哈尔滨极地馆,20230423,全国,全国,378,101,277
哈尔滨极地馆,20230424,全国,全国,337,82,255
哈尔滨极地馆,20230425,全国,全国,362,101,261
哈尔滨极地馆,20230426,全国,全国,399,91,308
哈尔滨极地馆,20230427,全国,全国,502,121,381
哈尔滨极地馆,20230428,全国,全国,614,93,521
哈尔滨极地馆,20230429,全国,全国,806,80,726
哈尔滨极地馆,20230430,全国,全国,900,82,818
哈尔滨极地馆,20230501,全国,全国,640,70,570
哈尔滨极地馆,20230502,全国,全国,484,64,420
哈尔滨极地馆,20230503,全国,全国,338,64,274
哈尔滨极地馆,20230504,全国,全国,223,68,155
哈尔滨极地馆,20230505,全国,全国,267,72,195
哈尔滨极地馆,20230506,全国,全国,245,85,160
哈尔滨极地馆,20230507,全国,全国,243,59,184
哈尔滨极地馆,20230508,全国,全国,224,66,158
哈尔滨极地馆,20230509,全国,全国,216,64,152
哈尔滨极地馆,20230510,全国,全国,227,66,161
哈尔滨极地馆,20230511,全国,全国,229,68,161
哈尔滨极地馆,20230512,全国,全国,271,82,189
哈尔滨极地馆,20230513,全国,全国,238,64,174
哈尔滨极地馆,20230514,全国,全国,211,64,147
哈尔滨极地馆,20230515,全国,全国,229,64,165
哈尔滨极地馆,20230516,全国,全国,211,64,147
哈尔滨极地馆,20230517,全国,全国,241,74,167
哈尔滨极地馆,20230518,全国,全国,246,80,166
哈尔滨极地馆,20230519,全国,全国,223,64,159
哈尔滨极地馆,20230520,全国,全国,231,63,168
哈尔滨极地馆,20230521,全国,全国,228,63,165
哈尔滨极地馆,20230522,全国,全国,225,70,155
哈尔滨极地馆,20230523,全国,全国,213,59,154
哈尔滨极地馆,20230524,全国,全国,215,74,141
哈尔滨极地馆,20230525,全国,全国,241,61,180
哈尔滨极地馆,20230526,全国,全国,220,59,161
哈尔滨极地馆,20230527,全国,全国,221,63,158
哈尔滨极地馆,20230528,全国,全国,214,63,151
哈尔滨极地馆,20230529,全国,全国,230,66,164
哈尔滨极地馆,20230530,全国,全国,244,70,174
哈尔滨极地馆,20230531,全国,全国,253,76,177
哈尔滨极地馆,20230601,全国,全国,271,68,203
哈尔滨极地馆,20230602,全国,全国,244,66,178
哈尔滨极地馆,20230603,全国,全国,183,0,183
哈尔滨极地馆,20230604,全国,全国,159,0,159
哈尔滨极地馆,20230605,全国,全国,263,76,187
哈尔滨极地馆,20230606,全国,全国,243,70,173
哈尔滨极地馆,20230607,全国,全国,238,68,170
哈尔滨极地馆,20230608,全国,全国,233,68,165
哈尔滨极地馆,20230609,全国,全国,219,64,155
哈尔滨极地馆,20230610,全国,全国,243,59,184
哈尔滨极地馆,20230611,全国,全国,255,66,189
哈尔滨极地馆,20230612,全国,全国,236,78,158
哈尔滨极地馆,20230613,全国,全国,252,74,178
哈尔滨极地馆,20230614,全国,全国,259,70,189
哈尔滨极地馆,20230615,全国,全国,231,72,159
哈尔滨极地馆,20230616,全国,全国,250,80,170
哈尔滨极地馆,20230617,全国,全国,256,64,192
哈尔滨极地馆,20230618,全国,全国,263,64,199
哈尔滨极地馆,20230619,全国,全国,278,80,198
哈尔滨极地馆,20230620,全国,全国,307,78,229
哈尔滨极地馆,20230621,全国,全国,310,76,234
哈尔滨极地馆,20230622,全国,全国,325,70,255
哈尔滨极地馆,20230623,全国,全国,297,66,231
哈尔滨极地馆,20230624,全国,全国,271,63,208
哈尔滨极地馆,20230625,全国,全国,298,80,218
哈尔滨极地馆,20230626,全国,全国,263,76,187
哈尔滨极地馆,20230627,全国,全国,275,82,193
哈尔滨极地馆,20230628,全国,全国,289,70,219
哈尔滨极地馆,20230629,全国,全国,292,74,218
哈尔滨极地馆,20230630,全国,全国,301,82,219
哈尔滨极地馆,20230701,全国,全国,290,72,218
哈尔滨极地馆,20230702,全国,全国,267,59,208
哈尔滨极地馆,20230703,全国,全国,294,80,214
哈尔滨极地馆,20230704,全国,全国,286,80,206
哈尔滨极地馆,20230705,全国,全国,355,89,266
哈尔滨极地馆,20230706,全国,全国,300,72,228
哈尔滨极地馆,20230707,全国,全国,327,74,253
哈尔滨极地馆,20230708,全国,全国,340,72,268
哈尔滨极地馆,20230709,全国,全国,319,64,255
哈尔滨极地馆,20230710,全国,全国,354,95,259
哈尔滨极地馆,20230711,全国,全国,372,85,287
哈尔滨极地馆,20230712,全国,全国,335,83,252
哈尔滨极地馆,20230713,全国,全国,362,70,292
哈尔滨极地馆,20230714,全国,全国,370,70,300
哈尔滨极地馆,20230715,全国,全国,394,66,328
哈尔滨极地馆,20230716,全国,全国,351,66,285
哈尔滨极地馆,20230717,全国,全国,383,80,303
哈尔滨极地馆,20230718,全国,全国,427,108,319
哈尔滨极地馆,20230719,全国,全国,373,74,299
哈尔滨极地馆,20230720,全国,全国,373,85,288
哈尔滨极地馆,20230721,全国,全国,401,78,323
哈尔滨极地馆,20230722,全国,全国,412,66,346
哈尔滨极地馆,20230723,全国,全国,417,66,351
哈尔滨极地馆,20230724,全国,全国,447,82,365
哈尔滨极地馆,20230725,全国,全国,449,80,369
哈尔滨极地馆,20230726,全国,全国,472,82,390
哈尔滨极地馆,20230727,全国,全国,436,80,356
哈尔滨极地馆,20230728,全国,全国,445,76,369
哈尔滨极地馆,20230729,全国,全国,488,66,422
哈尔滨极地馆,20230730,全国,全国,513,66,447
哈尔滨极地馆,20230731,全国,全国,515,89,426
哈尔滨极地馆,20230801,全国,全国,507,85,422
哈尔滨极地馆,20230802,全国,全国,439,74,365
哈尔滨极地馆,20230803,全国,全国,435,97,338
哈尔滨极地馆,20230804,全国,全国,389,74,315
哈尔滨极地馆,20230805,全国,全国,387,63,324
哈尔滨极地馆,20230806,全国,全国,378,66,312
哈尔滨极地馆,20230807,全国,全国,412,74,338
哈尔滨极地馆,20230808,全国,全国,355,82,273
哈尔滨极地馆,20230809,全国,全国,364,72,292
哈尔滨极地馆,20230810,全国,全国,326,72,254
哈尔滨极地馆,20230811,全国,全国,351,78,273
哈尔滨极地馆,20230812,全国,全国,354,66,288
哈尔滨极地馆,20230813,全国,全国,353,59,294
哈尔滨极地馆,20230814,全国,全国,380,78,302
哈尔滨极地馆,20230815,全国,全国,402,76,326
哈尔滨极地馆,20230816,全国,全国,386,74,312
哈尔滨极地馆,20230817,全国,全国,386,72,314
哈尔滨极地馆,20230818,全国,全国,401,85,316
哈尔滨极地馆,20230819,全国,全国,362,68,294
哈尔滨极地馆,20230820,全国,全国,330,59,271
哈尔滨极地馆,20230821,全国,全国,331,74,257
哈尔滨极地馆,20230822,全国,全国,290,70,220
哈尔滨极地馆,20230823,全国,全国,287,63,224
哈尔滨极地馆,20230824,全国,全国,300,66,234
哈尔滨极地馆,20230825,全国,全国,279,64,215
哈尔滨极地馆,20230826,全国,全国,293,59,234
哈尔滨极地馆,20230827,全国,全国,197,0,197
哈尔滨极地馆,20230828,全国,全国,243,59,184
哈尔滨极地馆,20230829,全国,全国,295,78,217
哈尔滨极地馆,20230830,全国,全国,237,63,174
哈尔滨极地馆,20230831,全国,全国,214,59,155
哈尔滨极地馆,20230901,全国,全国,232,72,160
哈尔滨极地馆,20230902,全国,全国,258,61,197
哈尔滨极地馆,20230903,全国,全国,224,61,163
哈尔滨极地馆,20230904,全国,全国,222,68,154
哈尔滨极地馆,20230905,全国,全国,199,64,135
哈尔滨极地馆,20230906,全国,全国,213,66,147
哈尔滨极地馆,20230907,全国,全国,219,70,149
哈尔滨极地馆,20230908,全国,全国,223,61,162
哈尔滨极地馆,20230909,全国,全国,243,59,184
哈尔滨极地馆,20230910,全国,全国,236,70,166
哈尔滨极地馆,20230911,全国,全国,207,66,141
哈尔滨极地馆,20230912,全国,全国,238,68,170
哈尔滨极地馆,20230913,全国,全国,219,64,155
哈尔滨极地馆,20230914,全国,全国,241,82,159
哈尔滨极地馆,20230915,全国,全国,249,76,173
哈尔滨极地馆,20230916,全国,全国,226,63,163
哈尔滨极地馆,20230917,全国,全国,243,59,184
哈尔滨极地馆,20230918,全国,全国,227,66,161
哈尔滨极地馆,20230919,全国,全国,216,82,134
哈尔滨极地馆,20230920,全国,全国,238,70,168
哈尔滨极地馆,20230921,全国,全国,184,78,106
哈尔滨极地馆,20230922,全国,全国,198,68,130
哈尔滨极地馆,20230923,全国,全国,217,59,158
哈尔滨极地馆,20230924,全国,全国,227,63,164
哈尔滨极地馆,20230925,全国,全国,229,72,157
哈尔滨极地馆,20230926,全国,全国,240,72,168
哈尔滨极地馆,20230927,全国,全国,265,68,197
哈尔滨极地馆,20230928,全国,全国,272,74,198
哈尔滨极地馆,20230929,全国,全国,371,61,310
哈尔滨极地馆,20230930,全国,全国,438,59,379
哈尔滨极地馆,20231001,全国,全国,397,63,334
哈尔滨极地馆,20231002,全国,全国,331,0,331
哈尔滨极地馆,20231003,全国,全国,359,59,300
哈尔滨极地馆,20231004,全国,全国,331,72,259
哈尔滨极地馆,20231005,全国,全国,206,0,206
哈尔滨极地馆,20231006,全国,全国,254,61,193
哈尔滨极地馆,20231007,全国,全国,189,68,121
哈尔滨极地馆,20231008,全国,全国,176,66,110
哈尔滨极地馆,20231009,全国,全国,185,66,119
哈尔滨极地馆,20231010,全国,全国,199,78,121
哈尔滨极地馆,20231011,全国,全国,179,64,115
哈尔滨极地馆,20231012,全国,全国,193,68,125
哈尔滨极地馆,20231013,全国,全国,185,72,113
哈尔滨极地馆,20231014,全国,全国,197,63,134
哈尔滨极地馆,20231015,全国,全国,207,63,144
哈尔滨极地馆,20231016,全国,全国,171,63,108
哈尔滨极地馆,20231017,全国,全国,199,93,106
哈尔滨极地馆,20231018,全国,全国,173,68,105
哈尔滨极地馆,20231019,全国,全国,201,80,121
哈尔滨极地馆,20231020,全国,全国,176,70,106
哈尔滨极地馆,20231021,全国,全国,181,63,118
哈尔滨极地馆,20231022,全国,全国,164,64,100
哈尔滨极地馆,20231023,全国,全国,183,78,105
哈尔滨极地馆,20231024,全国,全国,180,72,108
哈尔滨极地馆,20231025,全国,全国,181,66,115
哈尔滨极地馆,20231026,全国,全国,170,68,102
哈尔滨极地馆,20231027,全国,全国,184,82,102
哈尔滨极地馆,20231028,全国,全国,161,66,95
哈尔滨极地馆,20231029,全国,全国,164,64,100
哈尔滨极地馆,20231030,全国,全国,161,72,89
哈尔滨极地馆,20231031,全国,全国,162,70,92
哈尔滨极地馆,20231101,全国,全国,182,74,108
哈尔滨极地馆,20231102,全国,全国,157,68,89
哈尔滨极地馆,20231103,全国,全国,195,76,119
哈尔滨极地馆,20231104,全国,全国,178,70,108
哈尔滨极地馆,20231105,全国,全国,143,61,82
哈尔滨极地馆,20231106,全国,全国,187,91,96
哈尔滨极地馆,20231107,全国,全国,169,64,105
哈尔滨极地馆,20231108,全国,全国,168,82,86
哈尔滨极地馆,20231109,全国,全国,175,83,92
哈尔滨极地馆,20231110,全国,全国,180,78,102
哈尔滨极地馆,20231111,全国,全国,182,76,106
哈尔滨极地馆,20231112,全国,全国,161,68,93
哈尔滨极地馆,20231113,全国,全国,199,80,119
哈尔滨极地馆,20231114,全国,全国,190,78,112
哈尔滨极地馆,20231115,全国,全国,183,87,96
哈尔滨极地馆,20231116,全国,全国,172,68,104
哈尔滨极地馆,20231117,全国,全国,175,76,99
哈尔滨极地馆,20231118,全国,全国,167,63,104
哈尔滨极地馆,20231119,全国,全国,187,66,121
哈尔滨极地馆,20231120,全国,全国,165,68,97
哈尔滨极地馆,20231121,全国,全国,198,89,109
哈尔滨极地馆,20231122,全国,全国,185,76,109
哈尔滨极地馆,20231123,全国,全国,219,97,122
哈尔滨极地馆,20231124,全国,全国,216,68,148
哈尔滨极地馆,20231125,全国,全国,196,70,126
哈尔滨极地馆,20231126,全国,全国,218,74,144
哈尔滨极地馆,20231127,全国,全国,191,74,117
哈尔滨极地馆,20231128,全国,全国,205,87,118
哈尔滨极地馆,20231129,全国,全国,182,80,102
哈尔滨极地馆,20231130,全国,全国,205,83,122
哈尔滨极地馆,20231201,全国,全国,191,74,117
哈尔滨极地馆,20231202,全国,全国,195,63,132
哈尔滨极地馆,20231203,全国,全国,191,70,121
哈尔滨极地馆,20231204,全国,全国,193,80,113
哈尔滨极地馆,20231205,全国,全国,225,78,147
哈尔滨极地馆,20231206,全国,全国,195,82,113
哈尔滨极地馆,20231207,全国,全国,213,95,118
哈尔滨极地馆,20231208,全国,全国,185,85,100
哈尔滨极地馆,20231209,全国,全国,194,68,126
哈尔滨极地馆,20231210,全国,全国,187,64,123
哈尔滨极地馆,20231211,全国,全国,201,91,110
哈尔滨极地馆,20231212,全国,全国,167,80,87
哈尔滨极地馆,20231213,全国,全国,191,82,109
哈尔滨极地馆,20231214,全国,全国,190,72,118
哈尔滨极地馆,20231215,全国,全国,226,78,148
哈尔滨极地馆,20231216,全国,全国,208,72,136
哈尔滨极地馆,20231217,全国,全国,237,80,157
哈尔滨极地馆,20231218,全国,全国,280,118,162
哈尔滨极地馆,20231219,全国,全国,212,78,134
哈尔滨极地馆,20231220,全国,全国,214,78,136
哈尔滨极地馆,20231221,全国,全国,231,83,148
哈尔滨极地馆,20231222,全国,全国,215,72,143
哈尔滨极地馆,20231223,全国,全国,200,66,134
哈尔滨极地馆,20231224,全国,全国,191,63,128
哈尔滨极地馆,20231225,全国,全国,221,89,132
哈尔滨极地馆,20231226,全国,全国,248,78,170
哈尔滨极地馆,20231227,全国,全国,217,72,145
哈尔滨极地馆,20231228,全国,全国,231,83,148
哈尔滨极地馆,20231229,全国,全国,227,91,136
哈尔滨极地馆,20231230,全国,全国,238,64,174
哈尔滨极地馆,20231231,全国,全国,219,64,155
哈尔滨极地馆,20240101,全国,全国,214,70,144
哈尔滨极地馆,20240102,全国,全国,229,99,130
哈尔滨极地馆,20240103,全国,全国,309,116,193
哈尔滨极地馆,20240104,全国,全国,312,129,183
哈尔滨极地馆,20240105,全国,全国,287,101,186
哈尔滨极地馆,20240106,全国,全国,336,97,239
哈尔滨极地馆,20240107,全国,全国,291,83,208
哈尔滨极地馆,20240108,全国,全国,306,127,179
哈尔滨极地馆,20240109,全国,全国,275,101,174
哈尔滨极地馆,20240110,全国,全国,274,120,154
哈尔滨极地馆,20240111,全国,全国,251,97,154
哈尔滨极地馆,20240112,全国,全国,271,95,176
哈尔滨极地馆,20240113,全国,全国,231,70,161
哈尔滨极地馆,20240114,全国,全国,257,70,187
哈尔滨极地馆,20240115,全国,全国,242,85,157
哈尔滨极地馆,20240116,全国,全国,232,83,149
哈尔滨极地馆,20240117,全国,全国,267,97,170
哈尔滨极地馆,20240118,全国,全国,238,70,168
哈尔滨极地馆,20240119,全国,全国,240,89,151
哈尔滨极地馆,20240120,全国,全国,244,85,159
哈尔滨极地馆,20240121,全国,全国,250,70,180
哈尔滨极地馆,20240122,全国,全国,244,95,149
哈尔滨极地馆,20240123,全国,全国,258,91,167
哈尔滨极地馆,20240124,全国,全国,231,76,155
哈尔滨极地馆,20240125,全国,全国,259,85,174
哈尔滨极地馆,20240126,全国,全国,240,85,155
哈尔滨极地馆,20240127,全国,全国,229,74,155
哈尔滨极地馆,20240128,全国,全国,232,68,164
哈尔滨极地馆,20240129,全国,全国,232,70,162
哈尔滨极地馆,20240130,全国,全国,260,87,173
哈尔滨极地馆,20240131,全国,全国,237,72,165
哈尔滨极地馆,20240201,全国,全国,232,78,154
哈尔滨极地馆,20240202,全国,全国,206,70,136
哈尔滨极地馆,20240203,全国,全国,240,66,174
哈尔滨极地馆,20240204,全国,全国,250,82,168
哈尔滨极地馆,20240205,全国,全国,236,74,162
哈尔滨极地馆,20240206,全国,全国,215,63,152
哈尔滨极地馆,20240207,全国,全国,202,80,122
哈尔滨极地馆,20240208,全国,全国,198,64,134
哈尔滨极地馆,20240209,全国,全国,189,70,119
哈尔滨极地馆,20240210,全国,全国,164,0,164
哈尔滨极地馆,20240211,全国,全国,263,63,200
哈尔滨极地馆,20240212,全国,全国,265,61,204
哈尔滨极地馆,20240213,全国,全国,307,76,231
哈尔滨极地馆,20240214,全国,全国,308,61,247
哈尔滨极地馆,20240215,全国,全国,290,59,231
哈尔滨极地馆,20240216,全国,全国,266,64,202
哈尔滨极地馆,20240217,全国,全国,269,61,208
哈尔滨极地馆,20240218,全国,全国,241,70,171
哈尔滨极地馆,20240219,全国,全国,211,59,152
哈尔滨极地馆,20240220,全国,全国,229,68,161
哈尔滨极地馆,20240221,全国,全国,207,68,139
哈尔滨极地馆,20240222,全国,全国,191,66,125
哈尔滨极地馆,20240223,全国,全国,176,61,115
哈尔滨极地馆,20240224,全国,全国,178,61,117
哈尔滨极地馆,20240225,全国,全国,181,59,122
哈尔滨极地馆,20240226,全国,全国,171,63,108
哈尔滨极地馆,20240227,全国,全国,186,76,110
哈尔滨极地馆,20240228,全国,全国,197,63,134
哈尔滨极地馆,20240229,全国,全国,167,59,108
哈尔滨极地馆,20240301,全国,全国,184,76,108
哈尔滨极地馆,20240302,全国,全国,118,0,118
哈尔滨极地馆,20240303,全国,全国,102,0,102
哈尔滨极地馆,20240304,全国,全国,159,64,95
哈尔滨极地馆,20240305,全国,全国,158,66,92
哈尔滨极地馆,20240306,全国,全国,145,63,82
哈尔滨极地馆,20240307,全国,全国,162,63,99
哈尔滨极地馆,20240308,全国,全国,157,66,91
哈尔滨极地馆,20240309,全国,全国,169,64,105
哈尔滨极地馆,20240310,全国,全国,93,0,93
哈尔滨极地馆,20240311,全国,全国,172,68,104
哈尔滨极地馆,20240312,全国,全国,165,61,104
哈尔滨极地馆,20240313,全国,全国,160,63,97
哈尔滨极地馆,20240314,全国,全国,179,70,109
哈尔滨极地馆,20240315,全国,全国,207,66,141
哈尔滨极地馆,20240316,全国,全国,178,61,117
哈尔滨极地馆,20240317,全国,全国,115,0,115
哈尔滨极地馆,20240318,全国,全国,172,70,102
哈尔滨极地馆,20240319,全国,全国,96,0,96
哈尔滨极地馆,20240320,全国,全国,100,0,100
哈尔滨极地馆,20240321,全国,全国,176,61,115
哈尔滨极地馆,20240322,全国,全国,195,78,117
哈尔滨极地馆,20240323,全国,全国,169,61,108
哈尔滨极地馆,20240324,全国,全国,183,64,119
哈尔滨极地馆,20240325,全国,全国,151,64,87
哈尔滨极地馆,20240326,全国,全国,169,63,106
哈尔滨极地馆,20240327,全国,全国,172,66,106
哈尔滨极地馆,20240328,全国,全国,167,68,99
哈尔滨极地馆,20240329,全国,全国,172,68,104
哈尔滨极地馆,20240330,全国,全国,176,61,115
哈尔滨极地馆,20240331,全国,全国,208,63,145
哈尔滨极地馆,20240401,全国,全国,187,68,119
哈尔滨极地馆,20240402,全国,全国,191,70,121
哈尔滨极地馆,20240403,全国,全国,277,82,195
哈尔滨极地馆,20240404,全国,全国,282,68,214
哈尔滨极地馆,20240405,全国,全国,250,61,189
哈尔滨极地馆,20240406,全国,全国,179,61,118
哈尔滨极地馆,20240407,全国,全国,179,64,115
哈尔滨极地馆,20240408,全国,全国,159,72,87
哈尔滨极地馆,20240409,全国,全国,189,63,126
哈尔滨极地馆,20240410,全国,全国,172,63,109
哈尔滨极地馆,20240411,全国,全国,178,70,108
哈尔滨极地馆,20240412,全国,全国,184,78,106
哈尔滨极地馆,20240413,全国,全国,154,57,97
哈尔滨极地馆,20240414,全国,全国,191,59,132
哈尔滨极地馆,20240415,全国,全国,187,66,121
哈尔滨极地馆,20240416,全国,全国,184,76,108
哈尔滨极地馆,20240417,全国,全国,211,64,147
哈尔滨极地馆,20240418,全国,全国,184,74,110
哈尔滨极地馆,20240419,全国,全国,198,70,128
哈尔滨极地馆,20240420,全国,全国,189,59,130
哈尔滨极地馆,20240421,全国,全国,198,64,134
哈尔滨极地馆,20240422,全国,全国,200,70,130
哈尔滨极地馆,20240423,全国,全国,205,74,131
哈尔滨极地馆,20240424,全国,全国,194,72,122
哈尔滨极地馆,20240425,全国,全国,217,68,149
哈尔滨极地馆,20240426,全国,全国,228,80,148
哈尔滨极地馆,20240427,全国,全国,216,64,152
哈尔滨极地馆,20240428,全国,全国,257,91,166
哈尔滨极地馆,20240429,全国,全国,254,72,182
哈尔滨极地馆,20240430,全国,全国,330,78,252
哈尔滨极地馆,20240501,全国,全国,370,63,307
哈尔滨极地馆,20240502,全国,全国,338,61,277
哈尔滨极地馆,20240503,全国,全国,262,64,198
哈尔滨极地馆,20240504,全国,全国,148,0,148
哈尔滨极地馆,20240505,全国,全国,218,64,154
哈尔滨极地馆,20240506,全国,全国,182,70,112
哈尔滨极地馆,20240507,全国,全国,161,64,97
哈尔滨极地馆,20240508,全国,全国,164,64,100
哈尔滨极地馆,20240509,全国,全国,165,63,102
哈尔滨极地馆,20240510,全国,全国,195,70,125
东北虎林园,20220101,全国,全国,145,63,82
东北虎林园,20220102,全国,全国,160,63,97
东北虎林园,20220103,全国,全国,168,63,105
东北虎林园,20220104,全国,全国,175,76,99
东北虎林园,20220105,全国,全国,161,68,93
东北虎林园,20220106,全国,全国,167,74,93
东北虎林园,20220107,全国,全国,152,66,86
东北虎林园,20220108,全国,全国,143,61,82
东北虎林园,20220109,全国,全国,148,61,87
东北虎林园,20220110,全国,全国,154,72,82
东北虎林园,20220111,全国,全国,155,64,91
东北虎林园,20220112,全国,全国,161,70,91
东北虎林园,20220113,全国,全国,170,78,92
东北虎林园,20220114,全国,全国,175,82,93
东北虎林园,20220115,全国,全国,164,68,96
东北虎林园,20220116,全国,全国,186,80,106
东北虎林园,20220117,全国,全国,174,68,106
东北虎林园,20220118,全国,全国,155,72,83
东北虎林园,20220119,全国,全国,170,70,100
东北虎林园,20220120,全国,全国,172,68,104
东北虎林园,20220121,全国,全国,161,74,87
东北虎林园,20220122,全国,全国,172,64,108
东北虎林园,20220123,全国,全国,164,68,96
东北虎林园,20220124,全国,全国,193,85,108
东北虎林园,20220125,全国,全国,158,66,92
东北虎林园,20220126,全国,全国,170,70,100
东北虎林园,20220127,全国,全国,169,70,99
东北虎林园,20220128,全国,全国,161,72,89
东北虎林园,20220129,全国,全国,178,59,119
东北虎林园,20220130,全国,全国,178,68,110
东北虎林园,20220131,全国,全国,240,63,177
东北虎林园,20220201,全国,全国,250,72,178
东北虎林园,20220202,全国,全国,231,68,163
东北虎林园,20220203,全国,全国,233,66,167
东北虎林园,20220204,全国,全国,192,66,126
东北虎林园,20220205,全国,全国,194,68,126
东北虎林园,20220206,全国,全国,134,0,134
东北虎林园,20220207,全国,全国,170,66,104
东北虎林园,20220208,全国,全国,176,72,104
东北虎林园,20220209,全国,全国,187,64,123
东北虎林园,20220210,全国,全国,183,78,105
东北虎林园,20220211,全国,全国,159,63,96
东北虎林园,20220212,全国,全国,175,63,112
东北虎林园,20220213,全国,全国,169,63,106
东北虎林园,20220214,全国,全国,161,61,100
东北虎林园,20220215,全国,全国,157,68,89
东北虎林园,20220216,全国,全国,169,76,93
东北虎林园,20220217,全国,全国,175,80,95
东北虎林园,20220218,全国,全国,219,85,134
东北虎林园,20220219,全国,全国,204,68,136
东北虎林园,20220220,全国,全国,156,61,95
东北虎林园,20220221,全国,全国,182,78,104
东北虎林园,20220222,全国,全国,192,87,105
东北虎林园,20220223,全国,全国,161,66,95
东北虎林园,20220224,全国,全国,171,66,105
东北虎林园,20220225,全国,全国,160,74,86
东北虎林园,20220226,全国,全国,157,68,89
东北虎林园,20220227,全国,全国,147,61,86
东北虎林园,20220228,全国,全国,154,72,82
东北虎林园,20220301,全国,全国,150,68,82
东北虎林园,20220302,全国,全国,153,70,83
东北虎林园,20220303,全国,全国,172,68,104
东北虎林园,20220304,全国,全国,187,64,123
东北虎林园,20220305,全国,全国,154,68,86
东北虎林园,20220306,全国,全国,191,72,119
东北虎林园,20220307,全国,全国,198,66,132
东北虎林园,20220308,全国,全国,206,68,138
东北虎林园,20220309,全国,全国,158,63,95
东北虎林园,20220310,全国,全国,142,64,78
东北虎林园,20220311,全国,全国,173,63,110
东北虎林园,20220312,全国,全国,139,63,76
东北虎林园,20220313,全国,全国,142,64,78
东北虎林园,20220314,全国,全国,142,64,78
东北虎林园,20220315,全国,全国,141,59,82
东北虎林园,20220316,全国,全国,145,59,86
东北虎林园,20220317,全国,全国,133,63,70
东北虎林园,20220318,全国,全国,74,0,74
东北虎林园,20220319,全国,全国,137,63,74
东北虎林园,20220320,全国,全国,82,0,82
东北虎林园,20220321,全国,全国,137,59,78
东北虎林园,20220322,全国,全国,161,70,91
东北虎林园,20220323,全国,全国,145,63,82
东北虎林园,20220324,全国,全国,141,74,67
东北虎林园,20220325,全国,全国,143,70,73
东北虎林园,20220326,全国,全国,71,0,71
东北虎林园,20220327,全国,全国,135,64,71
东北虎林园,20220328,全国,全国,145,63,82
东北虎林园,20220329,全国,全国,135,59,76
东北虎林园,20220330,全国,全国,91,0,91
东北虎林园,20220331,全国,全国,161,61,100
东北虎林园,20220401,全国,全国,142,63,79
东北虎林园,20220402,全国,全国,146,59,87
东北虎林园,20220403,全国,全国,87,0,87
东北虎林园,20220404,全国,全国,132,59,73
东北虎林园,20220405,全国,全国,143,61,82
东北虎林园,20220406,全国,全国,133,66,67
东北虎林园,20220407,全国,全国,134,63,71
东北虎林园,20220408,全国,全国,137,68,69
东北虎林园,20220409,全国,全国,89,0,89
东北虎林园,20220410,全国,全国,143,63,80
东北虎林园,20220411,全国,全国,142,66,76
东北虎林园,20220412,全国,全国,146,72,74
东北虎林园,20220413,全国,全国,141,63,78
东北虎林园,20220414,全国,全国,145,66,79
东北虎林园,20220415,全国,全国,134,63,71
东北虎林园,20220416,全国,全国,79,0,79
东北虎林园,20220417,全国,全国,89,0,89
东北虎林园,20220418,全国,全国,132,59,73
东北虎林园,20220419,全国,全国,156,61,95
东北虎林园,20220420,全国,全国,158,63,95
东北虎林园,20220421,全国,全国,143,61,82
东北虎林园,20220422,全国,全国,159,63,96
东北虎林园,20220423,全国,全国,163,59,104
东北虎林园,20220424,全国,全国,84,0,84
东北虎林园,20220425,全国,全国,131,61,70
东北虎林园,20220426,全国,全国,76,0,76
东北虎林园,20220427,全国,全国,145,63,82
东北虎林园,20220428,全国,全国,145,61,84
东北虎林园,20220429,全国,全国,78,0,78
东北虎林园,20220430,全国,全国,146,59,87
东北虎林园,20220501,全国,全国,143,64,79
东北虎林园,20220502,全国,全国,87,0,87
东北虎林园,20220503,全国,全国,148,59,89
东北虎林园,20220504,全国,全国,150,64,86
东北虎林园,20220505,全国,全国,144,64,80
东北虎林园,20220506,全国,全国,76,0,76
东北虎林园,20220507,全国,全国,137,64,73
东北虎林园,20220508,全国,全国,99,0,99
东北虎林园,20220509,全国,全国,158,72,86
东北虎林园,20220510,全国,全国,144,64,80
东北虎林园,20220511,全国,全国,146,68,78
东北虎林园,20220512,全国,全国,154,70,84
东北虎林园,20220513,全国,全国,173,68,105
东北虎林园,20220514,全国,全国,167,61,106
东北虎林园,20220515,全国,全国,86,0,86
东北虎林园,20220516,全国,全国,146,63,83
东北虎林园,20220517,全国,全国,87,0,87
东北虎林园,20220518,全国,全国,157,64,93
东北虎林园,20220519,全国,全国,143,63,80
东北虎林园,20220520,全国,全国,165,70,95
东北虎林园,20220521,全国,全国,157,64,93
东北虎林园,20220522,全国,全国,158,63,95
东北虎林园,20220523,全国,全国,168,64,104
东北虎林园,20220524,全国,全国,154,63,91
东北虎林园,20220525,全国,全国,151,64,87
东北虎林园,20220526,全国,全国,154,61,93
东北虎林园,20220527,全国,全国,140,64,76
东北虎林园,20220528,全国,全国,92,0,92
东北虎林园,20220529,全国,全国,156,61,95
东北虎林园,20220530,全国,全国,163,61,102
东北虎林园,20220531,全国,全国,181,64,117
东北虎林园,20220601,全国,全国,190,59,131
东北虎林园,20220602,全国,全国,192,66,126
东北虎林园,20220603,全国,全国,186,0,186
东北虎林园,20220604,全国,全国,218,63,155
东北虎林园,20220605,全国,全国,169,64,105
东北虎林园,20220606,全国,全国,180,63,117
东北虎林园,20220607,全国,全国,170,68,102
东北虎林园,20220608,全国,全国,164,68,96
东北虎林园,20220609,全国,全国,167,63,104
东北虎林园,20220610,全国,全国,168,66,102
东北虎林园,20220611,全国,全国,173,61,112
东北虎林园,20220612,全国,全国,168,68,100
东北虎林园,20220613,全国,全国,170,61,109
东北虎林园,20220614,全国,全国,170,64,106
东北虎林园,20220615,全国,全国,162,63,99
东北虎林园,20220616,全国,全国,169,61,108
东北虎林园,20220617,全国,全国,176,63,113
东北虎林园,20220618,全国,全国,244,64,180
东北虎林园,20220619,全国,全国,195,61,134
东北虎林园,20220620,全国,全国,186,63,123
东北虎林园,20220621,全国,全国,170,66,104
东北虎林园,20220622,全国,全国,175,66,109
东北虎林园,20220623,全国,全国,178,68,110
东北虎林园,20220624,全国,全国,187,74,113
东北虎林园,20220625,全国,全国,186,61,125
东北虎林园,20220626,全国,全国,185,59,126
东北虎林园,20220627,全国,全国,185,63,122
东北虎林园,20220628,全国,全国,203,82,121
东北虎林园,20220629,全国,全国,185,70,115
东北虎林园,20220630,全国,全国,199,80,119
东北虎林园,20220701,全国,全国,181,63,118
东北虎林园,20220702,全国,全国,191,66,125
东北虎林园,20220703,全国,全国,190,59,131
东北虎林园,20220704,全国,全国,197,63,134
东北虎林园,20220705,全国,全国,194,64,130
东北虎林园,20220706,全国,全国,205,70,135
东北虎林园,20220707,全国,全国,197,76,121
东北虎林园,20220708,全国,全国,220,76,144
东北虎林园,20220709,全国,全国,240,61,179
东北虎林园,20220710,全国,全国,202,61,141
东北虎林园,20220711,全国,全国,215,74,141
东北虎林园,20220712,全国,全国,212,61,151
东北虎林园,20220713,全国,全国,195,74,121
东北虎林园,20220714,全国,全国,191,70,121
东北虎林园,20220715,全国,全国,221,66,155
东北虎林园,20220716,全国,全国,232,70,162
东北虎林园,20220717,全国,全国,264,68,196
东北虎林园,20220718,全国,全国,210,66,144
东北虎林园,20220719,全国,全国,208,64,144
东北虎林园,20220720,全国,全国,246,66,180
东北虎林园,20220721,全国,全国,208,76,132
东北虎林园,20220722,全国,全国,209,74,135
东北虎林园,20220723,全国,全国,242,63,179
东北虎林园,20220724,全国,全国,216,59,157
东北虎林园,20220725,全国,全国,229,70,159
东北虎林园,20220726,全国,全国,227,70,157
东北虎林园,20220727,全国,全国,244,78,166
东北虎林园,20220728,全国,全国,246,76,170
东北虎林园,20220729,全国,全国,290,78,212
东北虎林园,20220730,全国,全国,322,72,250
东北虎林园,20220731,全国,全国,281,72,209
东北虎林园,20220801,全国,全国,267,74,193
东北虎林园,20220802,全国,全国,236,66,170
东北虎林园,20220803,全国,全国,237,72,165
东北虎林园,20220804,全国,全国,265,66,199
东北虎林园,20220805,全国,全国,301,76,225
东北虎林园,20220806,全国,全国,287,68,219
东北虎林园,20220807,全国,全国,278,59,219
东北虎林园,20220808,全国,全国,282,80,202
东北虎林园,20220809,全国,全国,255,68,187
东北虎林园,20220810,全国,全国,249,64,185
东北虎林园,20220811,全国,全国,249,83,166
东北虎林园,20220812,全国,全国,231,66,165
东北虎林园,20220813,全国,全国,263,64,199
东北虎林园,20220814,全国,全国,254,68,186
东北虎林园,20220815,全国,全国,240,70,170
东北虎林园,20220816,全国,全国,253,80,173
东北虎林园,20220817,全国,全国,273,87,186
东北虎林园,20220818,全国,全国,249,72,177
东北虎林园,20220819,全国,全国,211,68,143
东北虎林园,20220820,全国,全国,284,76,208
东北虎林园,20220821,全国,全国,238,64,174
东北虎林园,20220822,全国,全国,186,63,123
东北虎林园,20220823,全国,全国,211,66,145
东北虎林园,20220824,全国,全国,218,61,157
东北虎林园,20220825,全国,全国,230,70,160
东北虎林园,20220826,全国,全国,234,76,158
东北虎林园,20220827,全国,全国,229,61,168
东北虎林园,20220828,全国,全国,206,61,145
东北虎林园,20220829,全国,全国,179,70,109
东北虎林园,20220830,全国,全国,186,68,118
东北虎林园,20220831,全国,全国,172,72,100
东北虎林园,20220901,全国,全国,156,63,93
东北虎林园,20220902,全国,全国,152,70,82
东北虎林园,20220903,全国,全国,159,63,96
东北虎林园,20220904,全国,全国,146,59,87
东北虎林园,20220905,全国,全国,163,63,100
东北虎林园,20220906,全国,全国,148,61,87
东北虎林园,20220907,全国,全国,153,66,87
东北虎林园,20220908,全国,全国,158,61,97
东北虎林园,20220909,全国,全国,186,61,125
东北虎林园,20220910,全国,全国,192,70,122
东北虎林园,20220911,全国,全国,197,59,138
东北虎林园,20220912,全国,全国,194,64,130
东北虎林园,20220913,全国,全国,182,59,123
东北虎林园,20220914,全国,全国,167,61,106
东北虎林园,20220915,全国,全国,147,61,86
东北虎林园,20220916,全国,全国,168,64,104
东北虎林园,20220917,全国,全国,184,59,125
东北虎林园,20220918,全国,全国,176,64,112
东北虎林园,20220919,全国,全国,143,59,84
东北虎林园,20220920,全国,全国,141,59,82
东北虎林园,20220921,全国,全国,165,66,99
东北虎林园,20220922,全国,全国,162,70,92
东北虎林园,20220923,全国,全国,150,66,84
东北虎林园,20220924,全国,全国,99,0,99
东北虎林园,20220925,全国,全国,100,0,100
东北虎林园,20220926,全国,全国,155,64,91
东北虎林园,20220927,全国,全国,144,61,83
东北虎林园,20220928,全国,全国,143,59,84
东北虎林园,20220929,全国,全国,147,61,86
东北虎林园,20220930,全国,全国,174,68,106
东北虎林园,20221001,全国,全国,182,61,121
东北虎林园,20221002,全国,全国,151,0,151
东北虎林园,20221003,全国,全国,191,72,119
东北虎林园,20221004,全国,全国,138,0,138
东北虎林园,20221005,全国,全国,126,0,126
东北虎林园,20221006,全国,全国,108,0,108
东北虎林园,20221007,全国,全国,106,0,106
东北虎林园,20221008,全国,全国,139,70,69
东北虎林园,20221009,全国,全国,145,72,73
东北虎林园,20221010,全国,全国,150,59,91
东北虎林园,20221011,全国,全国,145,59,86
东北虎林园,20221012,全国,全国,163,72,91
东北虎林园,20221013,全国,全国,162,70,92
东北虎林园,20221014,全国,全国,139,59,80
东北虎林园,20221015,全国,全国,91,0,91
东北虎林园,20221016,全国,全国,87,0,87
东北虎林园,20221017,全国,全国,143,70,73
东北虎林园,20221018,全国,全国,163,66,97
东北虎林园,20221019,全国,全国,160,74,86
东北虎林园,20221020,全国,全国,158,66,92
东北虎林园,20221021,全国,全国,89,0,89
东北虎林园,20221022,全国,全国,159,59,100
东北虎林园,20221023,全国,全国,163,59,104
东北虎林园,20221024,全国,全国,91,0,91
东北虎林园,20221025,全国,全国,167,70,97
东北虎林园,20221026,全国,全国,148,61,87
东北虎林园,20221027,全国,全国,163,76,87
东北虎林园,20221028,全国,全国,150,59,91
东北虎林园,20221029,全国,全国,102,0,102
东北虎林园,20221030,全国,全国,82,0,82
东北虎林园,20221031,全国,全国,129,63,66
东北虎林园,20221101,全国,全国,147,61,86
东北虎林园,20221102,全国,全国,145,66,79
东北虎林园,20221103,全国,全国,131,61,70
东北虎林园,20221104,全国,全国,154,63,91
东北虎林园,20221105,全国,全国,151,59,92
东北虎林园,20221106,全国,全国,141,61,80
东北虎林园,20221107,全国,全国,141,63,78
东北虎林园,20221108,全国,全国,159,64,95
东北虎林园,20221109,全国,全国,161,64,97
东北虎林园,20221110,全国,全国,155,64,91
东北虎林园,20221111,全国,全国,151,72,79
东北虎林园,20221112,全国,全国,92,0,92
东北虎林园,20221113,全国,全国,151,59,92
东北虎林园,20221114,全国,全国,150,64,86
东北虎林园,20221115,全国,全国,132,59,73
东北虎林园,20221116,全国,全国,148,59,89
东北虎林园,20221117,全国,全国,157,64,93
东北虎林园,20221118,全国,全国,152,61,91
东北虎林园,20221119,全国,全国,163,61,102
东北虎林园,20221120,全国,全国,147,63,84
东北虎林园,20221121,全国,全国,150,61,89
东北虎林园,20221122,全国,全国,146,68,78
东北虎林园,20221123,全国,全国,76,0,76
东北虎林园,20221124,全国,全国,152,66,86
东北虎林园,20221125,全国,全国,148,66,82
东北虎林园,20221126,全国,全国,148,68,80
东北虎林园,20221127,全国,全国,145,61,84
东北虎林园,20221128,全国,全国,140,66,74
东北虎林园,20221129,全国,全国,150,63,87
东北虎林园,20221130,全国,全国,141,61,80
东北虎林园,20221201,全国,全国,161,66,95
东北虎林园,20221202,全国,全国,165,63,102
东北虎林园,20221203,全国,全国,80,0,80
东北虎林园,20221204,全国,全国,133,59,74
东北虎林园,20221205,全国,全国,147,61,86
东北虎林园,20221206,全国,全国,156,72,84
东北虎林园,20221207,全国,全国,150,64,86
东北虎林园,20221208,全国,全国,109,0,109
东北虎林园,20221209,全国,全国,158,66,92
东北虎林园,20221210,全国,全国,141,63,78
东北虎林园,20221211,全国,全国,155,63,92
东北虎林园,20221212,全国,全国,78,0,78
东北虎林园,20221213,全国,全国,145,61,84
东北虎林园,20221214,全国,全国,126,61,65
东北虎林园,20221215,全国,全国,150,59,91
东北虎林园,20221216,全国,全国,154,59,95
东北虎林园,20221217,全国,全国,97,0,97
东北虎林园,20221218,全国,全国,159,66,93
东北虎林园,20221219,全国,全国,174,64,110
东北虎林园,20221220,全国,全国,148,68,80
东北虎林园,20221221,全国,全国,149,66,83
东北虎林园,20221222,全国,全国,148,68,80
东北虎林园,20221223,全国,全国,141,61,80
东北虎林园,20221224,全国,全国,149,63,86
东北虎林园,20221225,全国,全国,151,59,92
东北虎林园,20221226,全国,全国,139,63,76
东北虎林园,20221227,全国,全国,149,63,86
东北虎林园,20221228,全国,全国,87,0,87
东北虎林园,20221229,全国,全国,152,66,86
东北虎林园,20221230,全国,全国,154,68,86
东北虎林园,20221231,全国,全国,140,61,79
东北虎林园,20230101,全国,全国,104,0,104
东北虎林园,20230102,全国,全国,157,61,96
东北虎林园,20230103,全国,全国,157,61,96
东北虎林园,20230104,全国,全国,177,80,97
东北虎林园,20230105,全国,全国,167,70,97
东北虎林园,20230106,全国,全国,194,82,112
东北虎林园,20230107,全国,全国,347,78,269
东北虎林园,20230108,全国,全国,297,76,221
东北虎林园,20230109,全国,全国,232,70,162
东北虎林园,20230110,全国,全国,233,78,155
东北虎林园,20230111,全国,全国,225,68,157
东北虎林园,20230112,全国,全国,192,61,131
东北虎林园,20230113,全国,全国,214,78,136
东北虎林园,20230114,全国,全国,227,72,155
东北虎林园,20230115,全国,全国,238,68,170
东北虎林园,20230116,全国,全国,208,72,136
东北虎林园,20230117,全国,全国,181,64,117
东北虎林园,20230118,全国,全国,199,64,135
东北虎林园,20230119,全国,全国,196,64,132
东北虎林园,20230120,全国,全国,189,66,123
东北虎林园,20230121,全国,全国,92,0,92
东北虎林园,20230122,全国,全国,183,61,122
东北虎林园,20230123,全国,全国,245,63,182
东北虎林园,20230124,全国,全国,199,61,138
东北虎林园,20230125,全国,全国,225,63,162
东北虎林园,20230126,全国,全国,248,66,182
东北虎林园,20230127,全国,全国,210,61,149
东北虎林园,20230128,全国,全国,228,70,158
东北虎林园,20230129,全国,全国,174,0,174
东北虎林园,20230130,全国,全国,208,63,145
东北虎林园,20230131,全国,全国,230,70,160
东北虎林园,20230201,全国,全国,224,64,160
东北虎林园,20230202,全国,全国,210,66,144
东北虎林园,20230203,全国,全国,199,63,136
东北虎林园,20230204,全国,全国,203,59,144
东北虎林园,20230205,全国,全国,184,61,123
东北虎林园,20230206,全国,全国,215,83,132
东北虎林园,20230207,全国,全国,169,59,110
东北虎林园,20230208,全国,全国,217,76,141
东北虎林园,20230209,全国,全国,200,68,132
东北虎林园,20230210,全国,全国,185,63,122
东北虎林园,20230211,全国,全国,148,0,148
东北虎林园,20230212,全国,全国,210,59,151
东北虎林园,20230213,全国,全国,171,66,105
东北虎林园,20230214,全国,全国,192,74,118
东北虎林园,20230215,全国,全国,195,74,121
东北虎林园,20230216,全国,全国,211,72,139
东北虎林园,20230217,全国,全国,187,64,123
东北虎林园,20230218,全国,全国,206,70,136
东北虎林园,20230219,全国,全国,189,59,130
东北虎林园,20230220,全国,全国,172,63,109
东北虎林园,20230221,全国,全国,194,76,118
东北虎林园,20230222,全国,全国,176,63,113
东北虎林园,20230223,全国,全国,172,72,100
东北虎林园,20230224,全国,全国,197,66,131
东北虎林园,20230225,全国,全国,174,59,115
东北虎林园,20230226,全国,全国,207,66,141
东北虎林园,20230227,全国,全国,171,76,95
东北虎林园,20230228,全国,全国,189,63,126
东北虎林园,20230301,全国,全国,191,63,128
东北虎林园,20230302,全国,全国,193,68,125
东北虎林园,20230303,全国,全国,201,78,123
东北虎林园,20230304,全国,全国,265,64,201
东北虎林园,20230305,全国,全国,230,64,166
东北虎林园,20230306,全国,全国,223,72,151
东北虎林园,20230307,全国,全国,251,74,177
东北虎林园,20230308,全国,全国,265,70,195
东北虎林园,20230309,全国,全国,215,66,149
东北虎林园,20230310,全国,全国,314,72,242
东北虎林园,20230311,全国,全国,594,82,512
东北虎林园,20230312,全国,全国,500,78,422
东北虎林园,20230313,全国,全国,394,85,309
东北虎林园,20230314,全国,全国,316,68,248
东北虎林园,20230315,全国,全国,332,80,252
东北虎林园,20230316,全国,全国,291,72,219
东北虎林园,20230317,全国,全国,283,72,211
东北虎林园,20230318,全国,全国,324,64,260
东北虎林园,20230319,全国,全国,336,72,264
东北虎林园,20230320,全国,全国,258,68,190
东北虎林园,20230321,全国,全国,270,85,185
东北虎林园,20230322,全国,全国,266,87,179
东北虎林园,20230323,全国,全国,250,72,178
东北虎林园,20230324,全国,全国,269,72,197
东北虎林园,20230325,全国,全国,286,61,225
东北虎林园,20230326,全国,全国,274,66,208
东北虎林园,20230327,全国,全国,273,74,199
东北虎林园,20230328,全国,全国,238,72,166
东北虎林园,20230329,全国,全国,240,63,177
东北虎林园,20230330,全国,全国,269,70,199
东北虎林园,20230331,全国,全国,267,78,189
东北虎林园,20230401,全国,全国,269,61,208
东北虎林园,20230402,全国,全国,310,64,246
东北虎林园,20230403,全国,全国,259,70,189
东北虎林园,20230404,全国,全国,279,64,215
东北虎林园,20230405,全国,全国,298,70,228
东北虎林园,20230406,全国,全国,253,76,177
东北虎林园,20230407,全国,全国,264,80,184
东北虎林园,20230408,全国,全国,251,61,190
东北虎林园,20230409,全国,全国,265,72,193
东北虎林园,20230410,全国,全国,202,72,130
东北虎林园,20230411,全国,全国,230,76,154
东北虎林园,20230412,全国,全国,204,72,132
东北虎林园,20230413,全国,全国,221,66,155
东北虎林园,20230414,全国,全国,242,68,174
东北虎林园,20230415,全国,全国,259,66,193
东北虎林园,20230416,全国,全国,174,0,174
东北虎林园,20230417,全国,全国,246,72,174
东北虎林园,20230418,全国,全国,236,70,166
东北虎林园,20230419,全国,全国,247,82,165
东北虎林园,20230420,全国,全国,247,85,162
东北虎林园,20230421,全国,全国,277,85,192
东北虎林园,20230422,全国,全国,252,74,178
东北虎林园,20230423,全国,全国,222,70,152
东北虎林园,20230424,全国,全国,279,80,199
东北虎林园,20230425,全国,全国,259,78,181
东北虎林园,20230426,全国,全国,283,80,203
东北虎林园,20230427,全国,全国,283,66,217
东北虎林园,20230428,全国,全国,362,82,280
东北虎林园,20230429,全国,全国,459,68,391
东北虎林园,20230430,全国,全国,627,74,553
东北虎林园,20230501,全国,全国,831,66,765
东北虎林园,20230502,全国,全国,550,63,487
东北虎林园,20230503,全国,全国,351,83,268
东北虎林园,20230504,全国,全国,260,80,180
东北虎林园,20230505,全国,全国,222,70,152
东北虎林园,20230506,全国,全国,249,72,177
东北虎林园,20230507,全国,全国,249,59,190
东北虎林园,20230508,全国,全国,191,72,119
东北虎林园,20230509,全国,全国,223,66,157
东北虎林园,20230510,全国,全国,221,70,151
东北虎林园,20230511,全国,全国,215,74,141
东北虎林园,20230512,全国,全国,192,70,122
东北虎林园,20230513,全国,全国,231,61,170
东北虎林园,20230514,全国,全国,240,59,181
东北虎林园,20230515,全国,全国,206,78,128
东北虎林园,20230516,全国,全国,197,74,123
东北虎林园,20230517,全国,全国,211,68,143
东北虎林园,20230518,全国,全国,204,70,134
东北虎林园,20230519,全国,全国,198,64,134
东北虎林园,20230520,全国,全国,204,61,143
东北虎林园,20230521,全国,全国,211,59,152
东北虎林园,20230522,全国,全国,210,66,144
东北虎林园,20230523,全国,全国,213,59,154
东北虎林园,20230524,全国,全国,222,78,144
东北虎林园,20230525,全国,全国,211,80,131
东北虎林园,20230526,全国,全国,187,70,117
东北虎林园,20230527,全国,全国,214,63,151
东北虎林园,20230528,全国,全国,151,0,151
东北虎林园,20230529,全国,全国,217,66,151
东北虎林园,20230530,全国,全国,200,74,126
东北虎林园,20230531,全国,全国,215,72,143
东北虎林园,20230601,全国,全国,202,64,138
东北虎林园,20230602,全国,全国,216,91,125
东北虎林园,20230603,全国,全国,214,63,151
东北虎林园,20230604,全国,全国,218,59,159
东北虎林园,20230605,全国,全国,188,78,110
东北虎林园,20230606,全国,全国,211,66,145
东北虎林园,20230607,全国,全国,207,66,141
东北虎林园,20230608,全国,全国,222,78,144
东北虎林园,20230609,全国,全国,219,70,149
东北虎林园,20230610,全国,全国,238,74,164
东北虎林园,20230611,全国,全国,212,61,151
东北虎林园,20230612,全国,全国,238,72,166
东北虎林园,20230613,全国,全国,251,89,162
东北虎林园,20230614,全国,全国,222,78,144
东北虎林园,20230615,全国,全国,228,70,158
东北虎林园,20230616,全国,全国,204,72,132
东北虎林园,20230617,全国,全国,205,64,141
东北虎林园,20230618,全国,全国,223,61,162
东北虎林园,20230619,全国,全国,200,64,136
东北虎林园,20230620,全国,全国,222,78,144
东北虎林园,20230621,全国,全国,254,80,174
东北虎林园,20230622,全国,全国,280,74,206
东北虎林园,20230623,全国,全国,251,66,185
东北虎林园,20230624,全国,全国,225,61,164
东北虎林园,20230625,全国,全国,228,76,152
东北虎林园,20230626,全国,全国,227,82,145
东北虎林园,20230627,全国,全国,243,76,167
东北虎林园,20230628,全国,全国,223,74,149
东北虎林园,20230629,全国,全国,232,80,152
东北虎林园,20230630,全国,全国,242,66,176
东北虎林园,20230701,全国,全国,236,70,166
东北虎林园,20230702,全国,全国,233,63,170
东北虎林园,20230703,全国,全国,231,70,161
东北虎林园,20230704,全国,全国,258,85,173
东北虎林园,20230705,全国,全国,229,85,144
东北虎林园,20230706,全国,全国,253,83,170
东北虎林园,20230707,全国,全国,267,78,189
东北虎林园,20230708,全国,全国,283,74,209
东北虎林园,20230709,全国,全国,274,66,208
东北虎林园,20230710,全国,全国,288,76,212
东北虎林园,20230711,全国,全国,278,66,212
东北虎林园,20230712,全国,全国,281,76,205
东北虎林园,20230713,全国,全国,289,74,215
东北虎林园,20230714,全国,全国,251,72,179
东北虎林园,20230715,全国,全国,261,76,185
东北虎林园,20230716,全国,全国,296,74,222
东北虎林园,20230717,全国,全国,311,87,224
东北虎林园,20230718,全国,全国,310,82,228
东北虎林园,20230719,全国,全国,300,83,217
东北虎林园,20230720,全国,全国,278,78,200
东北虎林园,20230721,全国,全国,342,97,245
东北虎林园,20230722,全国,全国,343,72,271
东北虎林园,20230723,全国,全国,345,68,277
东北虎林园,20230724,全国,全国,325,91,234
东北虎林园,20230725,全国,全国,358,83,275
东北虎林园,20230726,全国,全国,383,85,298
东北虎林园,20230727,全国,全国,363,83,280
东北虎林园,20230728,全国,全国,337,80,257
东北虎林园,20230729,全国,全国,418,72,346
东北虎林园,20230730,全国,全国,424,72,352
东北虎林园,20230731,全国,全国,382,82,300
东北虎林园,20230801,全国,全国,366,74,292
东北虎林园,20230802,全国,全国,306,97,209
东北虎林园,20230803,全国,全国,352,78,274
东北虎林园,20230804,全国,全国,360,72,288
东北虎林园,20230805,全国,全国,373,70,303
东北虎林园,20230806,全国,全国,400,80,320
东北虎林园,20230807,全国,全国,385,93,292
东北虎林园,20230808,全国,全国,334,82,252
东北虎林园,20230809,全国,全国,331,72,259
东北虎林园,20230810,全国,全国,306,72,234
东北虎林园,20230811,全国,全国,280,66,214
东北虎林园,20230812,全国,全国,315,80,235
东北虎林园,20230813,全国,全国,297,72,225
东北虎林园,20230814,全国,全国,331,76,255
东北虎林园,20230815,全国,全国,308,74,234
东北虎林园,20230816,全国,全国,343,97,246
东北虎林园,20230817,全国,全国,285,76,209
东北虎林园,20230818,全国,全国,299,85,214
东北虎林园,20230819,全国,全国,349,74,275
东北虎林园,20230820,全国,全国,271,70,201
东北虎林园,20230821,全国,全国,289,97,192
东北虎林园,20230822,全国,全国,256,66,190
东北虎林园,20230823,全国,全国,267,74,193
东北虎林园,20230824,全国,全国,273,72,201
东北虎林园,20230825,全国,全国,285,70,215
东北虎林园,20230826,全国,全国,278,70,208
东北虎林园,20230827,全国,全国,284,76,208
东北虎林园,20230828,全国,全国,245,74,171
东北虎林园,20230829,全国,全国,245,80,165
东北虎林园,20230830,全国,全国,250,68,182
东北虎林园,20230831,全国,全国,266,74,192
东北虎林园,20230901,全国,全国,241,64,177
东北虎林园,20230902,全国,全国,227,72,155
东北虎林园,20230903,全国,全国,224,61,163
东北虎林园,20230904,全国,全国,223,82,141
东北虎林园,20230905,全国,全国,215,80,135
东北虎林园,20230906,全国,全国,201,78,123
东北虎林园,20230907,全国,全国,199,74,125
东北虎林园,20230908,全国,全国,232,83,149
东北虎林园,20230909,全国,全国,213,59,154
东北虎林园,20230910,全国,全国,219,70,149
东北虎林园,20230911,全国,全国,207,85,122
东北虎林园,20230912,全国,全国,226,91,135
东北虎林园,20230913,全国,全国,238,83,155
东北虎林园,20230914,全国,全国,225,74,151
东北虎林园,20230915,全国,全国,226,83,143
东北虎林园,20230916,全国,全国,236,66,170
东北虎林园,20230917,全国,全国,247,66,181
东北虎林园,20230918,全国,全国,219,78,141
东北虎林园,20230919,全国,全国,199,91,108
东北虎林园,20230920,全国,全国,214,80,134
东北虎林园,20230921,全国,全国,227,89,138
东北虎林园,20230922,全国,全国,229,80,149
东北虎林园,20230923,全国,全国,203,59,144
东北虎林园,20230924,全国,全国,217,63,154
东北虎林园,20230925,全国,全国,223,82,141
东北虎林园,20230926,全国,全国,202,72,130
东北虎林园,20230927,全国,全国,218,80,138
东北虎林园,20230928,全国,全国,268,89,179
东北虎林园,20230929,全国,全国,284,63,221
东北虎林园,20230930,全国,全国,368,76,292
东北虎林园,20231001,全国,全国,436,63,373
东北虎林园,20231002,全国,全国,423,64,359
东北虎林园,20231003,全国,全国,398,68,330
东北虎林园,20231004,全国,全国,371,68,303
东北虎林园,20231005,全国,全国,293,59,234
东北虎林园,20231006,全国,全国,271,82,189
东北虎林园,20231007,全国,全国,193,74,119
东北虎林园,20231008,全国,全国,211,76,135
东北虎林园,20231009,全国,全国,201,80,121
东北虎林园,20231010,全国,全国,205,83,122
东北虎林园,20231011,全国,全国,200,82,118
东北虎林园,20231012,全国,全国,217,83,134
东北虎林园,20231013,全国,全国,206,72,134
东北虎林园,20231014,全国,全国,214,66,148
东北虎林园,20231015,全国,全国,211,68,143
东北虎林园,20231016,全国,全国,180,70,110
东北虎林园,20231017,全国,全国,191,82,109
东北虎林园,20231018,全国,全国,191,78,113
东北虎林园,20231019,全国,全国,176,74,102
东北虎林园,20231020,全国,全国,189,85,104
东北虎林园,20231021,全国,全国,172,59,113
东北虎林园,20231022,全国,全国,206,70,136
东北虎林园,20231023,全国,全国,191,87,104
东北虎林园,20231024,全国,全国,173,82,91
东北虎林园,20231025,全国,全国,184,72,112
东北虎林园,20231026,全国,全国,171,80,91
东北虎林园,20231027,全国,全国,194,95,99
东北虎林园,20231028,全国,全国,189,61,128
东北虎林园,20231029,全国,全国,181,63,118
东北虎林园,20231030,全国,全国,188,76,112
东北虎林园,20231031,全国,全国,159,63,96
东北虎林园,20231101,全国,全国,178,66,112
东北虎林园,20231102,全国,全国,157,74,83
东北虎林园,20231103,全国,全国,182,87,95
东北虎林园,20231104,全国,全国,185,64,121
东北虎林园,20231105,全国,全国,155,59,96
东北虎林园,20231106,全国,全国,182,78,104
东北虎林园,20231107,全国,全国,187,82,105
东北虎林园,20231108,全国,全国,205,83,122
东北虎林园,20231109,全国,全国,234,93,141
东北虎林园,20231110,全国,全国,237,89,148
东北虎林园,20231111,全国,全国,205,80,125
东北虎林园,20231112,全国,全国,227,78,149
东北虎林园,20231113,全国,全国,205,93,112
东北虎林园,20231114,全国,全国,205,80,125
东北虎林园,20231115,全国,全国,212,91,121
东北虎林园,20231116,全国,全国,209,83,126
东北虎林园,20231117,全国,全国,209,87,122
东北虎林园,20231118,全国,全国,187,64,123
东北虎林园,20231119,全国,全国,229,70,159
东北虎林园,20231120,全国,全国,203,78,125
东北虎林园,20231121,全国,全国,234,99,135
东北虎林园,20231122,全国,全国,197,89,108
东北虎林园,20231123,全国,全国,240,102,138
东北虎林园,20231124,全国,全国,216,99,117
东北虎林园,20231125,全国,全国,205,82,123
东北虎林园,20231126,全国,全国,191,78,113
东北虎林园,20231127,全国,全国,216,85,131
东北虎林园,20231128,全国,全国,276,118,158
东北虎林园,20231129,全国,全国,222,87,135
东北虎林园,20231130,全国,全国,219,72,147
东北虎林园,20231201,全国,全国,217,85,132
东北虎林园,20231202,全国,全国,211,66,145
东北虎林园,20231203,全国,全国,225,74,151
东北虎林园,20231204,全国,全国,220,89,131
东北虎林园,20231205,全国,全国,242,85,157
东北虎林园,20231206,全国,全国,229,93,136
东北虎林园,20231207,全国,全国,254,99,155
东北虎林园,20231208,全国,全国,246,85,161
东北虎林园,20231209,全国,全国,217,68,149
东北虎林园,20231210,全国,全国,225,70,155
东北虎林园,20231211,全国,全国,246,108,138
东北虎林园,20231212,全国,全国,193,85,108
东北虎林园,20231213,全国,全国,225,82,143
东北虎林园,20231214,全国,全国,272,99,173
东北虎林园,20231215,全国,全国,223,87,136
东北虎林园,20231216,全国,全国,231,87,144
东北虎林园,20231217,全国,全国,221,76,145
东北虎林园,20231218,全国,全国,262,108,154
东北虎林园,20231219,全国,全国,261,87,174
东北虎林园,20231220,全国,全国,233,82,151
东北虎林园,20231221,全国,全国,278,95,183
东北虎林园,20231222,全国,全国,221,63,158
东北虎林园,20231223,全国,全国,252,93,159
东北虎林园,20231224,全国,全国,267,89,178
东北虎林园,20231225,全国,全国,288,93,195
东北虎林园,20231226,全国,全国,282,87,195
东北虎林园,20231227,全国,全国,275,78,197
东北虎林园,20231228,全国,全国,291,106,185
东北虎林园,20231229,全国,全国,350,102,248
东北虎林园,20231230,全国,全国,347,83,264
东北虎林园,20231231,全国,全国,304,68,236
东北虎林园,20240101,全国,全国,282,64,218
东北虎林园,20240102,全国,全国,327,108,219
东北虎林园,20240103,全国,全国,406,140,266
东北虎林园,20240104,全国,全国,485,186,299
东北虎林园,20240105,全国,全国,478,165,313
东北虎林园,20240106,全国,全国,435,91,344
东北虎林园,20240107,全国,全国,428,121,307
东北虎林园,20240108,全国,全国,444,148,296
东北虎林园,20240109,全国,全国,375,127,248
东北虎林园,20240110,全国,全国,391,131,260
东北虎林园,20240111,全国,全国,352,125,227
东北虎林园,20240112,全国,全国,387,133,254
东北虎林园,20240113,全国,全国,359,89,270
东北虎林园,20240114,全国,全国,336,97,239
东北虎林园,20240115,全国,全国,348,101,247
东北虎林园,20240116,全国,全国,318,104,214
东北虎林园,20240117,全国,全国,337,101,236
东北虎林园,20240118,全国,全国,325,106,219
东北虎林园,20240119,全国,全国,336,89,247
东北虎林园,20240120,全国,全国,349,82,267
东北虎林园,20240121,全国,全国,349,74,275
东北虎林园,20240122,全国,全国,327,93,234
东北虎林园,20240123,全国,全国,356,101,255
东北虎林园,20240124,全国,全国,340,95,245
东北虎林园,20240125,全国,全国,376,116,260
东北虎林园,20240126,全国,全国,347,93,254
东北虎林园,20240127,全国,全国,364,70,294
东北虎林园,20240128,全国,全国,332,63,269
东北虎林园,20240129,全国,全国,390,102,288
东北虎林园,20240130,全国,全国,364,93,271
东北虎林园,20240131,全国,全国,330,91,239
东北虎林园,20240201,全国,全国,315,72,243
东北虎林园,20240202,全国,全国,330,89,241
东北虎林园,20240203,全国,全国,318,76,242
东北虎林园,20240204,全国,全国,332,93,239
东北虎林园,20240205,全国,全国,313,89,224
东北虎林园,20240206,全国,全国,354,80,274
东北虎林园,20240207,全国,全国,317,85,232
东北虎林园,20240208,全国,全国,284,78,206
东北虎林园,20240209,全国,全国,227,59,168
东北虎林园,20240210,全国,全国,280,59,221
东北虎林园,20240211,全国,全国,393,63,330
东北虎林园,20240212,全国,全国,530,64,466
东北虎林园,20240213,全国,全国,667,61,606
东北虎林园,20240214,全国,全国,692,72,620
东北虎林园,20240215,全国,全国,539,74,465
东北虎林园,20240216,全国,全国,479,74,405
东北虎林园,20240217,全国,全国,479,68,411
东北虎林园,20240218,全国,全国,372,87,285
东北虎林园,20240219,全国,全国,336,70,266
东北虎林园,20240220,全国,全国,321,68,253
东北虎林园,20240221,全国,全国,232,66,166
东北虎林园,20240222,全国,全国,272,85,187
东北虎林园,20240223,全国,全国,255,76,179
东北虎林园,20240224,全国,全国,239,59,180
东北虎林园,20240225,全国,全国,250,72,178
东北虎林园,20240226,全国,全国,238,70,168
东北虎林园,20240227,全国,全国,230,89,141
东北虎林园,20240228,全国,全国,204,76,128
东北虎林园,20240229,全国,全国,198,72,126
东北虎林园,20240301,全国,全国,189,61,128
东北虎林园,20240302,全国,全国,191,63,128
东北虎林园,20240303,全国,全国,217,66,151
东北虎林园,20240304,全国,全国,210,72,138
东北虎林园,20240305,全国,全国,180,78,102
东北虎林园,20240306,全国,全国,198,72,126
东北虎林园,20240307,全国,全国,222,70,152
东北虎林园,20240308,全国,全国,233,82,151
东北虎林园,20240309,全国,全国,205,74,131
东北虎林园,20240310,全国,全国,196,70,126
东北虎林园,20240311,全国,全国,184,76,108
东北虎林园,20240312,全国,全国,183,66,117
东北虎林园,20240313,全国,全国,189,72,117
东北虎林园,20240314,全国,全国,208,83,125
东北虎林园,20240315,全国,全国,162,66,96
东北虎林园,20240316,全国,全国,187,70,117
东北虎林园,20240317,全国,全国,186,61,125
东北虎林园,20240318,全国,全国,171,85,86
东北虎林园,20240319,全国,全国,189,72,117
东北虎林园,20240320,全国,全国,193,74,119
东北虎林园,20240321,全国,全国,168,72,96
东北虎林园,20240322,全国,全国,172,66,106
东北虎林园,20240323,全国,全国,208,64,144
东北虎林园,20240324,全国,全国,141,0,141
东北虎林园,20240325,全国,全国,186,68,118
东北虎林园,20240326,全国,全国,176,74,102
东北虎林园,20240327,全国,全国,182,72,110
东北虎林园,20240328,全国,全国,204,85,119
东北虎林园,20240329,全国,全国,201,80,121
东北虎林园,20240330,全国,全国,176,68,108
东北虎林园,20240331,全国,全国,206,63,143
东北虎林园,20240401,全国,全国,202,72,130
东北虎林园,20240402,全国,全国,206,74,132
东北虎林园,20240403,全国,全国,245,68,177
东北虎林园,20240404,全国,全国,288,66,222
东北虎林园,20240405,全国,全国,322,66,256
东北虎林园,20240406,全国,全国,237,74,163
东北虎林园,20240407,全国,全国,223,78,145
东北虎林园,20240408,全国,全国,202,85,117
东北虎林园,20240409,全国,全国,189,74,115
东北虎林园,20240410,全国,全国,189,74,115
东北虎林园,20240411,全国,全国,192,66,126
东北虎林园,20240412,全国,全国,217,82,135
东北虎林园,20240413,全国,全国,207,64,143
东北虎林园,20240414,全国,全国,231,76,155
东北虎林园,20240415,全国,全国,211,68,143
东北虎林园,20240416,全国,全国,216,72,144
东北虎林园,20240417,全国,全国,215,70,145
东北虎林园,20240418,全国,全国,198,68,130
东北虎林园,20240419,全国,全国,203,68,135
东北虎林园,20240420,全国,全国,214,63,151
东北虎林园,20240421,全国,全国,228,63,165
东北虎林园,20240422,全国,全国,224,70,154
东北虎林园,20240423,全国,全国,212,68,144
东北虎林园,20240424,全国,全国,259,97,162
东北虎林园,20240425,全国,全国,229,72,157
东北虎林园,20240426,全国,全国,213,72,141
东北虎林园,20240427,全国,全国,242,63,179
东北虎林园,20240428,全国,全国,230,68,162
东北虎林园,20240429,全国,全国,250,87,163
东北虎林园,20240430,全国,全国,330,99,231
东北虎林园,20240501,全国,全国,429,63,366
东北虎林园,20240502,全国,全国,490,78,412
东北虎林园,20240503,全国,全国,486,61,425
东北虎林园,20240504,全国,全国,345,64,281
东北虎林园,20240505,全国,全国,276,61,215
东北虎林园,20240506,全国,全国,202,74,128
东北虎林园,20240507,全国,全国,217,85,132
东北虎林园,20240508,全国,全国,192,83,109
东北虎林园,20240509,全国,全国,190,72,118
东北虎林园,20240510,全国,全国,206,85,121
哈尔滨伏尔加庄园,20220101,全国,全国,71,0,71
哈尔滨伏尔加庄园,20220102,全国,全国,84,0,84
哈尔滨伏尔加庄园,20220103,全国,全国,128,61,67
哈尔滨伏尔加庄园,20220104,全国,全国,124,59,65
哈尔滨伏尔加庄园,20220105,全国,全国,59,59,0
哈尔滨伏尔加庄园,20220106,全国,全国,74,0,74
哈尔滨伏尔加庄园,20220107,全国,全国,150,66,84
哈尔滨伏尔加庄园,20220108,全国,全国,82,0,82
哈尔滨伏尔加庄园,20220109,全国,全国,137,59,78
哈尔滨伏尔加庄园,20220110,全国,全国,69,0,69
哈尔滨伏尔加庄园,20220111,全国,全国,126,61,65
哈尔滨伏尔加庄园,20220112,全国,全国,130,61,69
哈尔滨伏尔加庄园,20220113,全国,全国,66,0,66
哈尔滨伏尔加庄园,20220114,全国,全国,124,59,65
哈尔滨伏尔加庄园,20220115,全国,全国,122,59,63
哈尔滨伏尔加庄园,20220116,全国,全国,133,64,69
哈尔滨伏尔加庄园,20220117,全国,全国,132,59,73
哈尔滨伏尔加庄园,20220118,全国,全国,120,59,61
哈尔滨伏尔加庄园,20220119,全国,全国,129,64,65
哈尔滨伏尔加庄园,20220120,全国,全国,128,63,65
哈尔滨伏尔加庄园,20220121,全国,全国,0,0,0
哈尔滨伏尔加庄园,20220122,全国,全国,61,0,61
哈尔滨伏尔加庄园,20220123,全国,全国,65,0,65
哈尔滨伏尔加庄园,20220124,全国,全国,0,0,0
哈尔滨伏尔加庄园,20220125,全国,全国,65,0,65
哈尔滨伏尔加庄园,20220126,全国,全国,122,59,63
哈尔滨伏尔加庄园,20220127,全国,全国,0,0,0
哈尔滨伏尔加庄园,20220128,全国,全国,137,59,78
哈尔滨伏尔加庄园,20220129,全国,全国,128,59,69
哈尔滨伏尔加庄园,20220130,全国,全国,0,0,0
哈尔滨伏尔加庄园,20220131,全国,全国,63,0,63
哈尔滨伏尔加庄园,20220201,全国,全国,76,0,76
哈尔滨伏尔加庄园,20220202,全国,全国,73,0,73
哈尔滨伏尔加庄园,20220203,全国,全国,70,0,70
哈尔滨伏尔加庄园,20220204,全国,全国,135,59,76
哈尔滨伏尔加庄园,20220205,全国,全国,73,0,73
哈尔滨伏尔加庄园,20220206,全国,全国,125,59,66
哈尔滨伏尔加庄园,20220207,全国,全国,126,59,67
哈尔滨伏尔加庄园,20220208,全国,全国,125,59,66
哈尔滨伏尔加庄园,20220209,全国,全国,67,0,67
哈尔滨伏尔加庄园,20220210,全国,全国,71,0,71
哈尔滨伏尔加庄园,20220211,全国,全国,124,59,65
哈尔滨伏尔加庄园,20220212,全国,全国,71,0,71
哈尔滨伏尔加庄园,20220213,全国,全国,70,0,70
哈尔滨伏尔加庄园,20220214,全国,全国,69,0,69
哈尔滨伏尔加庄园,20220215,全国,全国,65,0,65
哈尔滨伏尔加庄园,20220216,全国,全国,73,0,73
哈尔滨伏尔加庄园,20220217,全国,全国,76,0,76
哈尔滨伏尔加庄园,20220218,全国,全国,65,0,65
哈尔滨伏尔加庄园,20220219,全国,全国,84,0,84
哈尔滨伏尔加庄园,20220220,全国,全国,135,59,76
哈尔滨伏尔加庄园,20220221,全国,全国,79,0,79
哈尔滨伏尔加庄园,20220222,全国,全国,65,0,65
哈尔滨伏尔加庄园,20220223,全国,全国,128,59,69
哈尔滨伏尔加庄园,20220224,全国,全国,82,0,82
哈尔滨伏尔加庄园,20220225,全国,全国,76,0,76
哈尔滨伏尔加庄园,20220226,全国,全国,69,0,69
哈尔滨伏尔加庄园,20220227,全国,全国,78,0,78
哈尔滨伏尔加庄园,20220228,全国,全国,66,0,66
哈尔滨伏尔加庄园,20220301,全国,全国,129,64,65
哈尔滨伏尔加庄园,20220302,全国,全国,129,59,70
哈尔滨伏尔加庄园,20220303,全国,全国,66,0,66
哈尔滨伏尔加庄园,20220304,全国,全国,128,59,69
哈尔滨伏尔加庄园,20220305,全国,全国,65,0,65
哈尔滨伏尔加庄园,20220306,全国,全国,130,59,71
哈尔滨伏尔加庄园,20220307,全国,全国,128,59,69
哈尔滨伏尔加庄园,20220308,全国,全国,69,0,69
哈尔滨伏尔加庄园,20220309,全国,全国,128,59,69
哈尔滨伏尔加庄园,20220310,全国,全国,66,0,66
哈尔滨伏尔加庄园,20220311,全国,全国,61,0,61
哈尔滨伏尔加庄园,20220312,全国,全国,70,0,70
哈尔滨伏尔加庄园,20220313,全国,全国,130,59,71
哈尔滨伏尔加庄园,20220314,全国,全国,70,0,70
哈尔滨伏尔加庄园,20220315,全国,全国,65,0,65
哈尔滨伏尔加庄园,20220316,全国,全国,128,59,69
哈尔滨伏尔加庄园,20220317,全国,全国,63,0,63
哈尔滨伏尔加庄园,20220318,全国,全国,0,0,0
哈尔滨伏尔加庄园,20220319,全国,全国,63,0,63
哈尔滨伏尔加庄园,20220320,全国,全国,67,0,67
哈尔滨伏尔加庄园,20220321,全国,全国,124,59,65
哈尔滨伏尔加庄园,20220322,全国,全国,61,0,61
哈尔滨伏尔加庄园,20220323,全国,全国,65,0,65
哈尔滨伏尔加庄园,20220324,全国,全国,125,59,66
哈尔滨伏尔加庄园,20220325,全国,全国,70,0,70
哈尔滨伏尔加庄园,20220326,全国,全国,126,59,67
哈尔滨伏尔加庄园,20220327,全国,全国,63,0,63
哈尔滨伏尔加庄园,20220328,全国,全国,65,0,65
哈尔滨伏尔加庄园,20220329,全国,全国,124,59,65
哈尔滨伏尔加庄园,20220330,全国,全国,63,0,63
哈尔滨伏尔加庄园,20220331,全国,全国,67,0,67
哈尔滨伏尔加庄园,20220401,全国,全国,66,0,66
哈尔滨伏尔加庄园,20220402,全国,全国,61,0,61
哈尔滨伏尔加庄园,20220403,全国,全国,65,0,65
哈尔滨伏尔加庄园,20220404,全国,全国,66,0,66
哈尔滨伏尔加庄园,20220405,全国,全国,122,59,63
哈尔滨伏尔加庄园,20220406,全国,全国,65,0,65
哈尔滨伏尔加庄园,20220407,全国,全国,74,0,74
哈尔滨伏尔加庄园,20220408,全国,全国,59,59,0
哈尔滨伏尔加庄园,20220409,全国,全国,67,0,67
哈尔滨伏尔加庄园,20220410,全国,全国,131,61,70
哈尔滨伏尔加庄园,20220411,全国,全国,129,59,70
哈尔滨伏尔加庄园,20220412,全国,全国,63,0,63
哈尔滨伏尔加庄园,20220413,全国,全国,65,0,65
哈尔滨伏尔加庄园,20220414,全国,全国,122,59,63
哈尔滨伏尔加庄园,20220415,全国,全国,63,0,63
哈尔滨伏尔加庄园,20220416,全国,全国,63,0,63
哈尔滨伏尔加庄园,20220417,全国,全国,124,59,65
哈尔滨伏尔加庄园,20220418,全国,全国,61,0,61
哈尔滨伏尔加庄园,20220419,全国,全国,66,0,66
哈尔滨伏尔加庄园,20220420,全国,全国,0,0,0
哈尔滨伏尔加庄园,20220421,全国,全国,66,0,66
哈尔滨伏尔加庄园,20220422,全国,全国,126,63,63
哈尔滨伏尔加庄园,20220423,全国,全国,126,63,63
哈尔滨伏尔加庄园,20220424,全国,全国,0,0,0
哈尔滨伏尔加庄园,20220425,全国,全国,131,61,70
哈尔滨伏尔加庄园,20220426,全国,全国,67,0,67
哈尔滨伏尔加庄园,20220427,全国,全国,65,0,65
哈尔滨伏尔加庄园,20220428,全国,全国,63,0,63
哈尔滨伏尔加庄园,20220429,全国,全国,124,61,63
哈尔滨伏尔加庄园,20220430,全国,全国,63,0,63
哈尔滨伏尔加庄园,20220501,全国,全国,70,0,70
哈尔滨伏尔加庄园,20220502,全国,全国,135,59,76
哈尔滨伏尔加庄园,20220503,全国,全国,61,0,61
哈尔滨伏尔加庄园,20220504,全国,全国,65,0,65
哈尔滨伏尔加庄园,20220505,全国,全国,63,63,0
哈尔滨伏尔加庄园,20220506,全国,全国,59,59,0
哈尔滨伏尔加庄园,20220507,全国,全国,76,0,76
哈尔滨伏尔加庄园,20220508,全国,全国,63,0,63
哈尔滨伏尔加庄园,20220509,全国,全国,71,0,71
哈尔滨伏尔加庄园,20220510,全国,全国,71,0,71
哈尔滨伏尔加庄园,20220511,全国,全国,141,59,82
哈尔滨伏尔加庄园,20220512,全国,全国,61,0,61
哈尔滨伏尔加庄园,20220513,全国,全国,147,63,84
哈尔滨伏尔加庄园,20220514,全国,全国,70,0,70
哈尔滨伏尔加庄园,20220515,全国,全国,78,0,78
哈尔滨伏尔加庄园,20220516,全国,全国,69,0,69
哈尔滨伏尔加庄园,20220517,全国,全国,74,0,74
哈尔滨伏尔加庄园,20220518,全国,全国,71,0,71
哈尔滨伏尔加庄园,20220519,全国,全国,130,61,69
哈尔滨伏尔加庄园,20220520,全国,全国,80,0,80
哈尔滨伏尔加庄园,20220521,全国,全国,73,0,73
哈尔滨伏尔加庄园,20220522,全国,全国,67,0,67
哈尔滨伏尔加庄园,20220523,全国,全国,66,0,66
哈尔滨伏尔加庄园,20220524,全国,全国,71,0,71
哈尔滨伏尔加庄园,20220525,全国,全国,65,0,65
哈尔滨伏尔加庄园,20220526,全国,全国,125,59,66
哈尔滨伏尔加庄园,20220527,全国,全国,66,0,66
哈尔滨伏尔加庄园,20220528,全国,全国,73,0,73
哈尔滨伏尔加庄园,20220529,全国,全国,130,61,69
哈尔滨伏尔加庄园,20220530,全国,全国,70,0,70
哈尔滨伏尔加庄园,20220531,全国,全国,70,0,70
哈尔滨伏尔加庄园,20220601,全国,全国,126,59,67
哈尔滨伏尔加庄园,20220602,全国,全国,91,0,91
哈尔滨伏尔加庄园,20220603,全国,全国,82,0,82
哈尔滨伏尔加庄园,20220604,全国,全国,89,0,89
哈尔滨伏尔加庄园,20220605,全国,全国,69,0,69
哈尔滨伏尔加庄园,20220606,全国,全国,150,61,89
哈尔滨伏尔加庄园,20220607,全国,全国,95,0,95
哈尔滨伏尔加庄园,20220608,全国,全国,148,59,89
哈尔滨伏尔加庄园,20220609,全国,全国,144,70,74
哈尔滨伏尔加庄园,20220610,全国,全国,93,0,93
哈尔滨伏尔加庄园,20220611,全国,全国,78,0,78
哈尔滨伏尔加庄园,20220612,全国,全国,97,0,97
哈尔滨伏尔加庄园,20220613,全国,全国,146,64,82
哈尔滨伏尔加庄园,20220614,全国,全国,69,0,69
哈尔滨伏尔加庄园,20220615,全国,全国,76,0,76
哈尔滨伏尔加庄园,20220616,全国,全国,135,59,76
哈尔滨伏尔加庄园,20220617,全国,全国,137,63,74
哈尔滨伏尔加庄园,20220618,全国,全国,79,0,79
哈尔滨伏尔加庄园,20220619,全国,全国,97,0,97
哈尔滨伏尔加庄园,20220620,全国,全国,150,61,89
哈尔滨伏尔加庄园,20220621,全国,全国,141,59,82
哈尔滨伏尔加庄园,20220622,全国,全国,150,61,89
哈尔滨伏尔加庄园,20220623,全国,全国,83,0,83
哈尔滨伏尔加庄园,20220624,全国,全国,141,59,82
哈尔滨伏尔加庄园,20220625,全国,全国,82,0,82
哈尔滨伏尔加庄园,20220626,全国,全国,76,0,76
哈尔滨伏尔加庄园,20220627,全国,全国,150,59,91
哈尔滨伏尔加庄园,20220628,全国,全国,165,61,104
哈尔滨伏尔加庄园,20220629,全国,全国,148,61,87
哈尔滨伏尔加庄园,20220630,全国,全国,165,63,102
哈尔滨伏尔加庄园,20220701,全国,全国,142,59,83
哈尔滨伏尔加庄园,20220702,全国,全国,86,0,86
哈尔滨伏尔加庄园,20220703,全国,全国,109,0,109
哈尔滨伏尔加庄园,20220704,全国,全国,154,63,91
哈尔滨伏尔加庄园,20220705,全国,全国,169,59,110
哈尔滨伏尔加庄园,20220706,全国,全国,152,66,86
哈尔滨伏尔加庄园,20220707,全国,全国,163,61,102
哈尔滨伏尔加庄园,20220708,全国,全国,145,59,86
哈尔滨伏尔加庄园,20220709,全国,全国,106,0,106
哈尔滨伏尔加庄园,20220710,全国,全国,109,0,109
哈尔滨伏尔加庄园,20220711,全国,全国,178,66,112
哈尔滨伏尔加庄园,20220712,全国,全国,218,63,155
哈尔滨伏尔加庄园,20220713,全国,全国,179,61,118
哈尔滨伏尔加庄园,20220714,全国,全国,212,61,151
哈尔滨伏尔加庄园,20220715,全国,全国,215,70,145
哈尔滨伏尔加庄园,20220716,全国,全国,191,61,130
哈尔滨伏尔加庄园,20220717,全国,全国,219,59,160
哈尔滨伏尔加庄园,20220718,全国,全国,211,59,152
哈尔滨伏尔加庄园,20220719,全国,全国,191,66,125
哈尔滨伏尔加庄园,20220720,全国,全国,217,59,158
哈尔滨伏尔加庄园,20220721,全国,全国,229,72,157
哈尔滨伏尔加庄园,20220722,全国,全国,206,72,134
哈尔滨伏尔加庄园,20220723,全国,全国,208,64,144
哈尔滨伏尔加庄园,20220724,全国,全国,210,59,151
哈尔滨伏尔加庄园,20220725,全国,全国,195,61,134
哈尔滨伏尔加庄园,20220726,全国,全国,187,59,128
哈尔滨伏尔加庄园,20220727,全国,全国,211,59,152
哈尔滨伏尔加庄园,20220728,全国,全国,219,72,147
哈尔滨伏尔加庄园,20220729,全国,全国,180,61,119
哈尔滨伏尔加庄园,20220730,全国,全国,206,59,147
哈尔滨伏尔加庄园,20220731,全国,全国,125,0,125
哈尔滨伏尔加庄园,20220801,全国,全国,198,63,135
哈尔滨伏尔加庄园,20220802,全国,全国,198,64,134
哈尔滨伏尔加庄园,20220803,全国,全国,185,64,121
哈尔滨伏尔加庄园,20220804,全国,全国,211,70,141
哈尔滨伏尔加庄园,20220805,全国,全国,196,64,132
哈尔滨伏尔加庄园,20220806,全国,全国,148,0,148
哈尔滨伏尔加庄园,20220807,全国,全国,118,0,118
哈尔滨伏尔加庄园,20220808,全国,全国,214,63,151
哈尔滨伏尔加庄园,20220809,全国,全国,184,66,118
哈尔滨伏尔加庄园,20220810,全国,全国,167,61,106
哈尔滨伏尔加庄园,20220811,全国,全国,145,0,145
哈尔滨伏尔加庄园,20220812,全国,全国,209,61,148
哈尔滨伏尔加庄园,20220813,全国,全国,203,64,139
哈尔滨伏尔加庄园,20220814,全国,全国,178,59,119
哈尔滨伏尔加庄园,20220815,全国,全国,184,59,125
哈尔滨伏尔加庄园,20220816,全国,全国,181,59,122
哈尔滨伏尔加庄园,20220817,全国,全国,187,61,126
哈尔滨伏尔加庄园,20220818,全国,全国,189,63,126
哈尔滨伏尔加庄园,20220819,全国,全国,126,0,126
哈尔滨伏尔加庄园,20220820,全国,全国,184,63,121
哈尔滨伏尔加庄园,20220821,全国,全国,110,0,110
哈尔滨伏尔加庄园,20220822,全国,全国,171,63,108
哈尔滨伏尔加庄园,20220823,全国,全国,204,70,134
哈尔滨伏尔加庄园,20220824,全国,全国,105,0,105
哈尔滨伏尔加庄园,20220825,全国,全国,159,59,100
哈尔滨伏尔加庄园,20220826,全国,全国,165,59,106
哈尔滨伏尔加庄园,20220827,全国,全国,122,0,122
哈尔滨伏尔加庄园,20220828,全国,全国,139,59,80
哈尔滨伏尔加庄园,20220829,全国,全国,74,0,74
哈尔滨伏尔加庄园,20220830,全国,全国,139,61,78
哈尔滨伏尔加庄园,20220831,全国,全国,132,61,71
哈尔滨伏尔加庄园,20220901,全国,全国,130,61,69
哈尔滨伏尔加庄园,20220902,全国,全国,69,0,69
哈尔滨伏尔加庄园,20220903,全国,全国,67,0,67
哈尔滨伏尔加庄园,20220904,全国,全国,71,0,71
哈尔滨伏尔加庄园,20220905,全国,全国,69,0,69
哈尔滨伏尔加庄园,20220906,全国,全国,128,61,67
哈尔滨伏尔加庄园,20220907,全国,全国,135,59,76
哈尔滨伏尔加庄园,20220908,全国,全国,92,0,92
哈尔滨伏尔加庄园,20220909,全国,全国,80,0,80
哈尔滨伏尔加庄园,20220910,全国,全国,167,59,108
哈尔滨伏尔加庄园,20220911,全国,全国,167,63,104
哈尔滨伏尔加庄园,20220912,全国,全国,96,0,96
哈尔滨伏尔加庄园,20220913,全国,全国,158,63,95
哈尔滨伏尔加庄园,20220914,全国,全国,141,59,82
哈尔滨伏尔加庄园,20220915,全国,全国,141,61,80
哈尔滨伏尔加庄园,20220916,全国,全国,141,59,82
哈尔滨伏尔加庄园,20220917,全国,全国,113,0,113
哈尔滨伏尔加庄园,20220918,全国,全国,161,66,95
哈尔滨伏尔加庄园,20220919,全国,全国,146,59,87
哈尔滨伏尔加庄园,20220920,全国,全国,150,61,89
哈尔滨伏尔加庄园,20220921,全国,全国,91,0,91
哈尔滨伏尔加庄园,20220922,全国,全国,136,63,73
哈尔滨伏尔加庄园,20220923,全国,全国,137,59,78
哈尔滨伏尔加庄园,20220924,全国,全国,126,59,67
哈尔滨伏尔加庄园,20220925,全国,全国,73,0,73
哈尔滨伏尔加庄园,20220926,全国,全国,131,64,67
哈尔滨伏尔加庄园,20220927,全国,全国,76,0,76
哈尔滨伏尔加庄园,20220928,全国,全国,134,64,70
哈尔滨伏尔加庄园,20220929,全国,全国,137,61,76
哈尔滨伏尔加庄园,20220930,全国,全国,148,68,80
哈尔滨伏尔加庄园,20221001,全国,全国,141,59,82
哈尔滨伏尔加庄园,20221002,全国,全国,80,0,80
哈尔滨伏尔加庄园,20221003,全国,全国,130,59,71
哈尔滨伏尔加庄园,20221004,全国,全国,87,0,87
哈尔滨伏尔加庄园,20221005,全国,全国,76,0,76
哈尔滨伏尔加庄园,20221006,全国,全国,82,0,82
哈尔滨伏尔加庄园,20221007,全国,全国,148,59,89
哈尔滨伏尔加庄园,20221008,全国,全国,132,61,71
哈尔滨伏尔加庄园,20221009,全国,全国,135,59,76
哈尔滨伏尔加庄园,20221010,全国,全国,76,0,76
哈尔滨伏尔加庄园,20221011,全国,全国,76,0,76
哈尔滨伏尔加庄园,20221012,全国,全国,140,70,70
哈尔滨伏尔加庄园,20221013,全国,全国,131,64,67
哈尔滨伏尔加庄园,20221014,全国,全国,61,61,0
哈尔滨伏尔加庄园,20221015,全国,全国,66,0,66
哈尔滨伏尔加庄园,20221016,全国,全国,66,0,66
哈尔滨伏尔加庄园,20221017,全国,全国,128,61,67
哈尔滨伏尔加庄园,20221018,全国,全国,146,66,80
哈尔滨伏尔加庄园,20221019,全国,全国,139,59,80
哈尔滨伏尔加庄园,20221020,全国,全国,78,0,78
哈尔滨伏尔加庄园,20221021,全国,全国,129,59,70
哈尔滨伏尔加庄园,20221022,全国,全国,95,0,95
哈尔滨伏尔加庄园,20221023,全国,全国,87,0,87
哈尔滨伏尔加庄园,20221024,全国,全国,73,0,73
哈尔滨伏尔加庄园,20221025,全国,全国,76,0,76
哈尔滨伏尔加庄园,20221026,全国,全国,74,0,74
哈尔滨伏尔加庄园,20221027,全国,全国,79,0,79
哈尔滨伏尔加庄园,20221028,全国,全国,132,63,69
哈尔滨伏尔加庄园,20221029,全国,全国,135,59,76
哈尔滨伏尔加庄园,20221030,全国,全国,79,0,79
哈尔滨伏尔加庄园,20221031,全国,全国,76,0,76
哈尔滨伏尔加庄园,20221101,全国,全国,80,0,80
哈尔滨伏尔加庄园,20221102,全国,全国,76,0,76
哈尔滨伏尔加庄园,20221103,全国,全国,135,61,74
哈尔滨伏尔加庄园,20221104,全国,全国,130,63,67
哈尔滨伏尔加庄园,20221105,全国,全国,66,0,66
哈尔滨伏尔加庄园,20221106,全国,全国,86,0,86
哈尔滨伏尔加庄园,20221107,全国,全国,140,61,79
哈尔滨伏尔加庄园,20221108,全国,全国,69,0,69
哈尔滨伏尔加庄园,20221109,全国,全国,126,59,67
哈尔滨伏尔加庄园,20221110,全国,全国,134,64,70
哈尔滨伏尔加庄园,20221111,全国,全国,69,0,69
哈尔滨伏尔加庄园,20221112,全国,全国,66,0,66
哈尔滨伏尔加庄园,20221113,全国,全国,144,61,83
哈尔滨伏尔加庄园,20221114,全国,全国,69,0,69
哈尔滨伏尔加庄园,20221115,全国,全国,61,0,61
哈尔滨伏尔加庄园,20221116,全国,全国,82,0,82
哈尔滨伏尔加庄园,20221117,全国,全国,139,66,73
哈尔滨伏尔加庄园,20221118,全国,全国,133,59,74
哈尔滨伏尔加庄园,20221119,全国,全国,66,0,66
哈尔滨伏尔加庄园,20221120,全国,全国,74,0,74
哈尔滨伏尔加庄园,20221121,全国,全国,63,0,63
哈尔滨伏尔加庄园,20221122,全国,全国,126,61,65
哈尔滨伏尔加庄园,20221123,全国,全国,128,61,67
哈尔滨伏尔加庄园,20221124,全国,全国,69,0,69
哈尔滨伏尔加庄园,20221125,全国,全国,134,61,73
哈尔滨伏尔加庄园,20221126,全国,全国,65,0,65
哈尔滨伏尔加庄园,20221127,全国,全国,130,64,66
哈尔滨伏尔加庄园,20221128,全国,全国,65,0,65
哈尔滨伏尔加庄园,20221129,全国,全国,120,59,61
哈尔滨伏尔加庄园,20221130,全国,全国,66,0,66
哈尔滨伏尔加庄园,20221201,全国,全国,122,61,61
哈尔滨伏尔加庄园,20221202,全国,全国,128,59,69
哈尔滨伏尔加庄园,20221203,全国,全国,65,0,65
哈尔滨伏尔加庄园,20221204,全国,全国,0,0,0
哈尔滨伏尔加庄园,20221205,全国,全国,125,59,66
哈尔滨伏尔加庄园,20221206,全国,全国,66,0,66
哈尔滨伏尔加庄园,20221207,全国,全国,134,61,73
哈尔滨伏尔加庄园,20221208,全国,全国,135,59,76
哈尔滨伏尔加庄园,20221209,全国,全国,141,59,82
哈尔滨伏尔加庄园,20221210,全国,全国,0,0,0
哈尔滨伏尔加庄园,20221211,全国,全国,73,0,73
哈尔滨伏尔加庄园,20221212,全国,全国,134,61,73
哈尔滨伏尔加庄园,20221213,全国,全国,130,59,71
哈尔滨伏尔加庄园,20221214,全国,全国,126,61,65
哈尔滨伏尔加庄园,20221215,全国,全国,74,0,74
哈尔滨伏尔加庄园,20221216,全国,全国,69,0,69
哈尔滨伏尔加庄园,20221217,全国,全国,0,0,0
哈尔滨伏尔加庄园,20221218,全国,全国,124,61,63
哈尔滨伏尔加庄园,20221219,全国,全国,137,63,74
哈尔滨伏尔加庄园,20221220,全国,全国,73,0,73
哈尔滨伏尔加庄园,20221221,全国,全国,127,61,66
哈尔滨伏尔加庄园,20221222,全国,全国,126,59,67
哈尔滨伏尔加庄园,20221223,全国,全国,126,61,65
哈尔滨伏尔加庄园,20221224,全国,全国,73,0,73
哈尔滨伏尔加庄园,20221225,全国,全国,67,0,67
哈尔滨伏尔加庄园,20221226,全国,全国,130,59,71
哈尔滨伏尔加庄园,20221227,全国,全国,130,59,71
哈尔滨伏尔加庄园,20221228,全国,全国,73,0,73
哈尔滨伏尔加庄园,20221229,全国,全国,134,63,71
哈尔滨伏尔加庄园,20221230,全国,全国,133,59,74
哈尔滨伏尔加庄园,20221231,全国,全国,137,61,76
哈尔滨伏尔加庄园,20230101,全国,全国,63,0,63
哈尔滨伏尔加庄园,20230102,全国,全国,127,61,66
哈尔滨伏尔加庄园,20230103,全国,全国,71,0,71
哈尔滨伏尔加庄园,20230104,全国,全国,139,59,80
哈尔滨伏尔加庄园,20230105,全国,全国,141,63,78
哈尔滨伏尔加庄园,20230106,全国,全国,142,64,78
哈尔滨伏尔加庄园,20230107,全国,全国,148,61,87
哈尔滨伏尔加庄园,20230108,全国,全国,109,0,109
哈尔滨伏尔加庄园,20230109,全国,全国,149,66,83
哈尔滨伏尔加庄园,20230110,全国,全国,146,70,76
哈尔滨伏尔加庄园,20230111,全国,全国,163,70,93
哈尔滨伏尔加庄园,20230112,全国,全国,163,63,100
哈尔滨伏尔加庄园,20230113,全国,全国,83,0,83
哈尔滨伏尔加庄园,20230114,全国,全国,84,0,84
哈尔滨伏尔加庄园,20230115,全国,全国,91,0,91
哈尔滨伏尔加庄园,20230116,全国,全国,145,66,79
哈尔滨伏尔加庄园,20230117,全国,全国,139,68,71
哈尔滨伏尔加庄园,20230118,全国,全国,143,63,80
哈尔滨伏尔加庄园,20230119,全国,全国,153,64,89
哈尔滨伏尔加庄园,20230120,全国,全国,130,63,67
哈尔滨伏尔加庄园,20230121,全国,全国,78,0,78
哈尔滨伏尔加庄园,20230122,全国,全国,91,0,91
哈尔滨伏尔加庄园,20230123,全国,全国,165,61,104
哈尔滨伏尔加庄园,20230124,全国,全国,112,0,112
哈尔滨伏尔加庄园,20230125,全国,全国,180,59,121
哈尔滨伏尔加庄园,20230126,全国,全国,119,0,119
哈尔滨伏尔加庄园,20230127,全国,全国,164,59,105
哈尔滨伏尔加庄园,20230128,全国,全国,106,0,106
哈尔滨伏尔加庄园,20230129,全国,全国,163,64,99
哈尔滨伏尔加庄园,20230130,全国,全国,150,63,87
哈尔滨伏尔加庄园,20230131,全国,全国,214,63,151
哈尔滨伏尔加庄园,20230201,全国,全国,191,72,119
哈尔滨伏尔加庄园,20230202,全国,全国,172,63,109
哈尔滨伏尔加庄园,20230203,全国,全国,160,68,92
哈尔滨伏尔加庄园,20230204,全国,全国,147,61,86
哈尔滨伏尔加庄园,20230205,全国,全国,146,59,87
哈尔滨伏尔加庄园,20230206,全国,全国,145,61,84
哈尔滨伏尔加庄园,20230207,全国,全国,163,70,93
哈尔滨伏尔加庄园,20230208,全国,全国,152,61,91
哈尔滨伏尔加庄园,20230209,全国,全国,154,59,95
哈尔滨伏尔加庄园,20230210,全国,全国,156,63,93
哈尔滨伏尔加庄园,20230211,全国,全国,159,70,89
哈尔滨伏尔加庄园,20230212,全国,全国,95,0,95
哈尔滨伏尔加庄园,20230213,全国,全国,149,63,86
哈尔滨伏尔加庄园,20230214,全国,全国,143,64,79
哈尔滨伏尔加庄园,20230215,全国,全国,142,59,83
哈尔滨伏尔加庄园,20230216,全国,全国,151,72,79
哈尔滨伏尔加庄园,20230217,全国,全国,137,61,76
哈尔滨伏尔加庄园,20230218,全国,全国,99,0,99
哈尔滨伏尔加庄园,20230219,全国,全国,82,0,82
哈尔滨伏尔加庄园,20230220,全国,全国,141,59,82
哈尔滨伏尔加庄园,20230221,全国,全国,137,63,74
哈尔滨伏尔加庄园,20230222,全国,全国,134,64,70
哈尔滨伏尔加庄园,20230223,全国,全国,137,61,76
哈尔滨伏尔加庄园,20230224,全国,全国,140,64,76
哈尔滨伏尔加庄园,20230225,全国,全国,134,61,73
哈尔滨伏尔加庄园,20230226,全国,全国,84,0,84
哈尔滨伏尔加庄园,20230227,全国,全国,141,63,78
哈尔滨伏尔加庄园,20230228,全国,全国,69,0,69
哈尔滨伏尔加庄园,20230301,全国,全国,132,61,71
哈尔滨伏尔加庄园,20230302,全国,全国,137,66,71
哈尔滨伏尔加庄园,20230303,全国,全国,141,61,80
哈尔滨伏尔加庄园,20230304,全国,全国,91,0,91
哈尔滨伏尔加庄园,20230305,全国,全国,138,59,79
哈尔滨伏尔加庄园,20230306,全国,全国,135,59,76
哈尔滨伏尔加庄园,20230307,全国,全国,132,59,73
哈尔滨伏尔加庄园,20230308,全国,全国,69,0,69
哈尔滨伏尔加庄园,20230309,全国,全国,143,61,82
哈尔滨伏尔加庄园,20230310,全国,全国,69,0,69
哈尔滨伏尔加庄园,20230311,全国,全国,78,0,78
哈尔滨伏尔加庄园,20230312,全国,全国,82,0,82
哈尔滨伏尔加庄园,20230313,全国,全国,76,0,76
哈尔滨伏尔加庄园,20230314,全国,全国,132,59,73
哈尔滨伏尔加庄园,20230315,全国,全国,145,66,79
哈尔滨伏尔加庄园,20230316,全国,全国,78,0,78
哈尔滨伏尔加庄园,20230317,全国,全国,80,0,80
哈尔滨伏尔加庄园,20230318,全国,全国,135,61,74
哈尔滨伏尔加庄园,20230319,全国,全国,83,0,83
哈尔滨伏尔加庄园,20230320,全国,全国,70,0,70
哈尔滨伏尔加庄园,20230321,全国,全国,140,64,76
哈尔滨伏尔加庄园,20230322,全国,全国,127,66,61
哈尔滨伏尔加庄园,20230323,全国,全国,73,0,73
哈尔滨伏尔加庄园,20230324,全国,全国,137,59,78
哈尔滨伏尔加庄园,20230325,全国,全国,126,61,65
哈尔滨伏尔加庄园,20230326,全国,全国,80,0,80
哈尔滨伏尔加庄园,20230327,全国,全国,137,61,76
哈尔滨伏尔加庄园,20230328,全国,全国,139,68,71
哈尔滨伏尔加庄园,20230329,全国,全国,143,61,82
哈尔滨伏尔加庄园,20230330,全国,全国,147,63,84
哈尔滨伏尔加庄园,20230331,全国,全国,133,59,74
哈尔滨伏尔加庄园,20230401,全国,全国,135,59,76
哈尔滨伏尔加庄园,20230402,全国,全国,86,0,86
哈尔滨伏尔加庄园,20230403,全国,全国,153,61,92
哈尔滨伏尔加庄园,20230404,全国,全国,145,59,86
哈尔滨伏尔加庄园,20230405,全国,全国,76,0,76
哈尔滨伏尔加庄园,20230406,全国,全国,132,59,73
哈尔滨伏尔加庄园,20230407,全国,全国,135,59,76
哈尔滨伏尔加庄园,20230408,全国,全国,86,0,86
哈尔滨伏尔加庄园,20230409,全国,全国,154,59,95
哈尔滨伏尔加庄园,20230410,全国,全国,148,61,87
哈尔滨伏尔加庄园,20230411,全国,全国,157,61,96
哈尔滨伏尔加庄园,20230412,全国,全国,143,63,80
哈尔滨伏尔加庄园,20230413,全国,全国,139,63,76
哈尔滨伏尔加庄园,20230414,全国,全国,138,59,79
哈尔滨伏尔加庄园,20230415,全国,全国,82,0,82
哈尔滨伏尔加庄园,20230416,全国,全国,91,0,91
哈尔滨伏尔加庄园,20230417,全国,全国,158,66,92
哈尔滨伏尔加庄园,20230418,全国,全国,95,0,95
哈尔滨伏尔加庄园,20230419,全国,全国,156,59,97
哈尔滨伏尔加庄园,20230420,全国,全国,172,72,100
哈尔滨伏尔加庄园,20230421,全国,全国,143,59,84
哈尔滨伏尔加庄园,20230422,全国,全国,165,63,102
哈尔滨伏尔加庄园,20230423,全国,全国,167,63,104
哈尔滨伏尔加庄园,20230424,全国,全国,174,61,113
哈尔滨伏尔加庄园,20230425,全国,全国,169,61,108
哈尔滨伏尔加庄园,20230426,全国,全国,160,61,99
哈尔滨伏尔加庄园,20230427,全国,全国,181,72,109
哈尔滨伏尔加庄园,20230428,全国,全国,225,68,157
哈尔滨伏尔加庄园,20230429,全国,全国,155,0,155
哈尔滨伏尔加庄园,20230430,全国,全国,147,0,147
哈尔滨伏尔加庄园,20230501,全国,全国,229,59,170
哈尔滨伏尔加庄园,20230502,全国,全国,138,0,138
哈尔滨伏尔加庄园,20230503,全国,全国,110,0,110
哈尔滨伏尔加庄园,20230504,全国,全国,152,66,86
哈尔滨伏尔加庄园,20230505,全国,全国,89,0,89
哈尔滨伏尔加庄园,20230506,全国,全国,138,59,79
哈尔滨伏尔加庄园,20230507,全国,全国,143,59,84
哈尔滨伏尔加庄园,20230508,全国,全国,142,63,79
哈尔滨伏尔加庄园,20230509,全国,全国,132,61,71
哈尔滨伏尔加庄园,20230510,全国,全国,91,0,91
哈尔滨伏尔加庄园,20230511,全国,全国,133,59,74
哈尔滨伏尔加庄园,20230512,全国,全国,130,61,69
哈尔滨伏尔加庄园,20230513,全国,全国,83,0,83
哈尔滨伏尔加庄园,20230514,全国,全国,155,68,87
哈尔滨伏尔加庄园,20230515,全国,全国,150,61,89
哈尔滨伏尔加庄园,20230516,全国,全国,149,63,86
哈尔滨伏尔加庄园,20230517,全国,全国,137,59,78
哈尔滨伏尔加庄园,20230518,全国,全国,170,68,102
哈尔滨伏尔加庄园,20230519,全国,全国,151,64,87
哈尔滨伏尔加庄园,20230520,全国,全国,96,0,96
哈尔滨伏尔加庄园,20230521,全国,全国,73,0,73
哈尔滨伏尔加庄园,20230522,全国,全国,138,59,79
哈尔滨伏尔加庄园,20230523,全国,全国,140,61,79
哈尔滨伏尔加庄园,20230524,全国,全国,145,61,84
哈尔滨伏尔加庄园,20230525,全国,全国,168,66,102
哈尔滨伏尔加庄园,20230526,全国,全国,177,64,113
哈尔滨伏尔加庄园,20230527,全国,全国,87,0,87
哈尔滨伏尔加庄园,20230528,全国,全国,89,0,89
哈尔滨伏尔加庄园,20230529,全国,全国,191,66,125
哈尔滨伏尔加庄园,20230530,全国,全国,194,68,126
哈尔滨伏尔加庄园,20230531,全国,全国,166,66,100
哈尔滨伏尔加庄园,20230601,全国,全国,150,61,89
哈尔滨伏尔加庄园,20230602,全国,全国,160,63,97
哈尔滨伏尔加庄园,20230603,全国,全国,95,0,95
哈尔滨伏尔加庄园,20230604,全国,全国,176,59,117
哈尔滨伏尔加庄园,20230605,全国,全国,181,64,117
哈尔滨伏尔加庄园,20230606,全国,全国,95,0,95
哈尔滨伏尔加庄园,20230607,全国,全国,174,61,113
哈尔滨伏尔加庄园,20230608,全国,全国,178,68,110
哈尔滨伏尔加庄园,20230609,全国,全国,93,0,93
哈尔滨伏尔加庄园,20230610,全国,全国,112,0,112
哈尔滨伏尔加庄园,20230611,全国,全国,160,63,97
哈尔滨伏尔加庄园,20230612,全国,全国,173,63,110
哈尔滨伏尔加庄园,20230613,全国,全国,198,59,139
哈尔滨伏尔加庄园,20230614,全国,全国,204,76,128
哈尔滨伏尔加庄园,20230615,全国,全国,80,0,80
哈尔滨伏尔加庄园,20230616,全国,全国,178,61,117
哈尔滨伏尔加庄园,20230617,全国,全国,117,0,117
哈尔滨伏尔加庄园,20230618,全国,全国,191,59,132
哈尔滨伏尔加庄园,20230619,全国,全国,185,63,122
哈尔滨伏尔加庄园,20230620,全国,全国,189,59,130
哈尔滨伏尔加庄园,20230621,全国,全国,183,66,117
哈尔滨伏尔加庄园,20230622,全国,全国,128,0,128
哈尔滨伏尔加庄园,20230623,全国,全国,134,0,134
哈尔滨伏尔加庄园,20230624,全国,全国,174,59,115
哈尔滨伏尔加庄园,20230625,全国,全国,160,63,97
哈尔滨伏尔加庄园,20230626,全国,全国,163,63,100
哈尔滨伏尔加庄园,20230627,全国,全国,144,64,80
哈尔滨伏尔加庄园,20230628,全国,全国,151,59,92
哈尔滨伏尔加庄园,20230629,全国,全国,109,0,109
哈尔滨伏尔加庄园,20230630,全国,全国,163,63,100
哈尔滨伏尔加庄园,20230701,全国,全国,164,59,105
哈尔滨伏尔加庄园,20230702,全国,全国,171,59,112
哈尔滨伏尔加庄园,20230703,全国,全国,180,70,110
哈尔滨伏尔加庄园,20230704,全国,全国,170,64,106
哈尔滨伏尔加庄园,20230705,全国,全国,176,66,110
哈尔滨伏尔加庄园,20230706,全国,全国,183,66,117
哈尔滨伏尔加庄园,20230707,全国,全国,191,68,123
哈尔滨伏尔加庄园,20230708,全国,全国,194,59,135
哈尔滨伏尔加庄园,20230709,全国,全国,197,61,136
哈尔滨伏尔加庄园,20230710,全国,全国,174,66,108
哈尔滨伏尔加庄园,20230711,全国,全国,197,72,125
哈尔滨伏尔加庄园,20230712,全国,全国,185,66,119
哈尔滨伏尔加庄园,20230713,全国,全国,200,61,139
哈尔滨伏尔加庄园,20230714,全国,全国,172,59,113
哈尔滨伏尔加庄园,20230715,全国,全国,194,68,126
哈尔滨伏尔加庄园,20230716,全国,全国,210,74,136
哈尔滨伏尔加庄园,20230717,全国,全国,188,63,125
哈尔滨伏尔加庄园,20230718,全国,全国,219,68,151
哈尔滨伏尔加庄园,20230719,全国,全国,209,68,141
哈尔滨伏尔加庄园,20230720,全国,全国,206,63,143
哈尔滨伏尔加庄园,20230721,全国,全国,192,66,126
哈尔滨伏尔加庄园,20230722,全国,全国,193,63,130
哈尔滨伏尔加庄园,20230723,全国,全国,195,59,136
哈尔滨伏尔加庄园,20230724,全国,全国,212,76,136
哈尔滨伏尔加庄园,20230725,全国,全国,211,70,141
哈尔滨伏尔加庄园,20230726,全国,全国,207,64,143
哈尔滨伏尔加庄园,20230727,全国,全国,226,68,158
哈尔滨伏尔加庄园,20230728,全国,全国,200,68,132
哈尔滨伏尔加庄园,20230729,全国,全国,223,64,159
哈尔滨伏尔加庄园,20230730,全国,全国,229,59,170
哈尔滨伏尔加庄园,20230731,全国,全国,220,63,157
哈尔滨伏尔加庄园,20230801,全国,全国,211,68,143
哈尔滨伏尔加庄园,20230802,全国,全国,216,64,152
哈尔滨伏尔加庄园,20230803,全国,全国,208,70,138
哈尔滨伏尔加庄园,20230804,全国,全国,194,64,130
哈尔滨伏尔加庄园,20230805,全国,全国,222,61,161
哈尔滨伏尔加庄园,20230806,全国,全国,248,63,185
哈尔滨伏尔加庄园,20230807,全国,全国,207,59,148
哈尔滨伏尔加庄园,20230808,全国,全国,190,64,126
哈尔滨伏尔加庄园,20230809,全国,全国,189,63,126
哈尔滨伏尔加庄园,20230810,全国,全国,178,59,119
哈尔滨伏尔加庄园,20230811,全国,全国,112,0,112
哈尔滨伏尔加庄园,20230812,全国,全国,169,64,105
哈尔滨伏尔加庄园,20230813,全国,全国,113,0,113
哈尔滨伏尔加庄园,20230814,全国,全国,199,61,138
哈尔滨伏尔加庄园,20230815,全国,全国,191,68,123
哈尔滨伏尔加庄园,20230816,全国,全国,181,66,115
哈尔滨伏尔加庄园,20230817,全国,全国,159,63,96
哈尔滨伏尔加庄园,20230818,全国,全国,202,68,134
哈尔滨伏尔加庄园,20230819,全国,全国,177,59,118
哈尔滨伏尔加庄园,20230820,全国,全国,174,61,113
哈尔滨伏尔加庄园,20230821,全国,全国,195,72,123
哈尔滨伏尔加庄园,20230822,全国,全国,117,0,117
哈尔滨伏尔加庄园,20230823,全国,全国,154,59,95
哈尔滨伏尔加庄园,20230824,全国,全国,178,68,110
哈尔滨伏尔加庄园,20230825,全国,全国,189,64,125
哈尔滨伏尔加庄园,20230826,全国,全国,173,61,112
哈尔滨伏尔加庄园,20230827,全国,全国,169,64,105
哈尔滨伏尔加庄园,20230828,全国,全国,168,59,109
哈尔滨伏尔加庄园,20230829,全国,全国,148,64,84
哈尔滨伏尔加庄园,20230830,全国,全国,145,61,84
哈尔滨伏尔加庄园,20230831,全国,全国,159,68,91
哈尔滨伏尔加庄园,20230901,全国,全国,159,66,93
哈尔滨伏尔加庄园,20230902,全国,全国,158,59,99
哈尔滨伏尔加庄园,20230903,全国,全国,151,59,92
哈尔滨伏尔加庄园,20230904,全国,全国,150,63,87
哈尔滨伏尔加庄园,20230905,全国,全国,158,61,97
哈尔滨伏尔加庄园,20230906,全国,全国,84,0,84
哈尔滨伏尔加庄园,20230907,全国,全国,168,68,100
哈尔滨伏尔加庄园,20230908,全国,全国,169,64,105
哈尔滨伏尔加庄园,20230909,全国,全国,166,70,96
哈尔滨伏尔加庄园,20230910,全国,全国,178,61,117
哈尔滨伏尔加庄园,20230911,全国,全国,174,66,108
哈尔滨伏尔加庄园,20230912,全国,全国,87,0,87
哈尔滨伏尔加庄园,20230913,全国,全国,155,64,91
哈尔滨伏尔加庄园,20230914,全国,全国,153,64,89
哈尔滨伏尔加庄园,20230915,全国,全国,166,66,100
哈尔滨伏尔加庄园,20230916,全国,全国,162,63,99
哈尔滨伏尔加庄园,20230917,全国,全国,100,0,100
哈尔滨伏尔加庄园,20230918,全国,全国,165,66,99
哈尔滨伏尔加庄园,20230919,全国,全国,150,63,87
哈尔滨伏尔加庄园,20230920,全国,全国,160,64,96
哈尔滨伏尔加庄园,20230921,全国,全国,162,66,96
哈尔滨伏尔加庄园,20230922,全国,全国,176,85,91
哈尔滨伏尔加庄园,20230923,全国,全国,163,61,102
哈尔滨伏尔加庄园,20230924,全国,全国,177,68,109
哈尔滨伏尔加庄园,20230925,全国,全国,170,66,104
哈尔滨伏尔加庄园,20230926,全国,全国,170,66,104
哈尔滨伏尔加庄园,20230927,全国,全国,160,68,92
哈尔滨伏尔加庄园,20230928,全国,全国,199,63,136
哈尔滨伏尔加庄园,20230929,全国,全国,138,0,138
哈尔滨伏尔加庄园,20230930,全国,全国,193,0,193
哈尔滨伏尔加庄园,20231001,全国,全国,228,61,167
哈尔滨伏尔加庄园,20231002,全国,全国,219,59,160
哈尔滨伏尔加庄园,20231003,全国,全国,224,61,163
哈尔滨伏尔加庄园,20231004,全国,全国,119,0,119
哈尔滨伏尔加庄园,20231005,全国,全国,173,61,112
哈尔滨伏尔加庄园,20231006,全国,全国,155,59,96
哈尔滨伏尔加庄园,20231007,全国,全国,166,64,102
哈尔滨伏尔加庄园,20231008,全国,全国,84,0,84
哈尔滨伏尔加庄园,20231009,全国,全国,144,61,83
哈尔滨伏尔加庄园,20231010,全国,全国,135,59,76
哈尔滨伏尔加庄园,20231011,全国,全国,150,63,87
哈尔滨伏尔加庄园,20231012,全国,全国,150,59,91
哈尔滨伏尔加庄园,20231013,全国,全国,137,63,74
哈尔滨伏尔加庄园,20231014,全国,全国,138,59,79
哈尔滨伏尔加庄园,20231015,全国,全国,145,61,84
哈尔滨伏尔加庄园,20231016,全国,全国,147,64,83
哈尔滨伏尔加庄园,20231017,全国,全国,149,63,86
哈尔滨伏尔加庄园,20231018,全国,全国,149,63,86
哈尔滨伏尔加庄园,20231019,全国,全国,149,66,83
哈尔滨伏尔加庄园,20231020,全国,全国,137,64,73
哈尔滨伏尔加庄园,20231021,全国,全国,71,0,71
哈尔滨伏尔加庄园,20231022,全国,全国,139,59,80
哈尔滨伏尔加庄园,20231023,全国,全国,134,68,66
哈尔滨伏尔加庄园,20231024,全国,全国,130,59,71
哈尔滨伏尔加庄园,20231025,全国,全国,152,74,78
哈尔滨伏尔加庄园,20231026,全国,全国,127,66,61
哈尔滨伏尔加庄园,20231027,全国,全国,139,59,80
哈尔滨伏尔加庄园,20231028,全国,全国,78,0,78
哈尔滨伏尔加庄园,20231029,全国,全国,137,64,73
哈尔滨伏尔加庄园,20231030,全国,全国,74,0,74
哈尔滨伏尔加庄园,20231031,全国,全国,126,63,63
哈尔滨伏尔加庄园,20231101,全国,全国,135,61,74
哈尔滨伏尔加庄园,20231102,全国,全国,128,63,65
哈尔滨伏尔加庄园,20231103,全国,全国,156,72,84
哈尔滨伏尔加庄园,20231104,全国,全国,126,61,65
哈尔滨伏尔加庄园,20231105,全国,全国,130,63,67
哈尔滨伏尔加庄园,20231106,全国,全国,137,63,74
哈尔滨伏尔加庄园,20231107,全国,全国,63,63,0
哈尔滨伏尔加庄园,20231108,全国,全国,136,70,66
哈尔滨伏尔加庄园,20231109,全国,全国,142,66,76
哈尔滨伏尔加庄园,20231110,全国,全国,142,68,74
哈尔滨伏尔加庄园,20231111,全国,全国,130,59,71
哈尔滨伏尔加庄园,20231112,全国,全国,83,0,83
哈尔滨伏尔加庄园,20231113,全国,全国,147,76,71
哈尔滨伏尔加庄园,20231114,全国,全国,142,63,79
哈尔滨伏尔加庄园,20231115,全国,全国,136,66,70
哈尔滨伏尔加庄园,20231116,全国,全国,137,61,76
哈尔滨伏尔加庄园,20231117,全国,全国,133,59,74
哈尔滨伏尔加庄园,20231118,全国,全国,138,64,74
哈尔滨伏尔加庄园,20231119,全国,全国,141,59,82
哈尔滨伏尔加庄园,20231120,全国,全国,146,64,82
哈尔滨伏尔加庄园,20231121,全国,全国,149,70,79
哈尔滨伏尔加庄园,20231122,全国,全国,159,72,87
哈尔滨伏尔加庄园,20231123,全国,全国,126,59,67
哈尔滨伏尔加庄园,20231124,全国,全国,157,66,91
哈尔滨伏尔加庄园,20231125,全国,全国,137,59,78
哈尔滨伏尔加庄园,20231126,全国,全国,83,0,83
哈尔滨伏尔加庄园,20231127,全国,全国,141,63,78
哈尔滨伏尔加庄园,20231128,全国,全国,149,66,83
哈尔滨伏尔加庄园,20231129,全国,全国,145,66,79
哈尔滨伏尔加庄园,20231130,全国,全国,151,64,87
哈尔滨伏尔加庄园,20231201,全国,全国,156,70,86
哈尔滨伏尔加庄园,20231202,全国,全国,132,59,73
哈尔滨伏尔加庄园,20231203,全国,全国,76,0,76
哈尔滨伏尔加庄园,20231204,全国,全国,152,68,84
哈尔滨伏尔加庄园,20231205,全国,全国,150,70,80
哈尔滨伏尔加庄园,20231206,全国,全国,159,66,93
哈尔滨伏尔加庄园,20231207,全国,全国,143,70,73
哈尔滨伏尔加庄园,20231208,全国,全国,152,68,84
哈尔滨伏尔加庄园,20231209,全国,全国,159,59,100
哈尔滨伏尔加庄园,20231210,全国,全国,142,59,83
哈尔滨伏尔加庄园,20231211,全国,全国,156,74,82
哈尔滨伏尔加庄园,20231212,全国,全国,142,68,74
哈尔滨伏尔加庄园,20231213,全国,全国,140,64,76
哈尔滨伏尔加庄园,20231214,全国,全国,159,66,93
哈尔滨伏尔加庄园,20231215,全国,全国,169,70,99
哈尔滨伏尔加庄园,20231216,全国,全国,145,59,86
哈尔滨伏尔加庄园,20231217,全国,全国,173,61,112
哈尔滨伏尔加庄园,20231218,全国,全国,175,76,99
哈尔滨伏尔加庄园,20231219,全国,全国,170,66,104
哈尔滨伏尔加庄园,20231220,全国,全国,172,72,100
哈尔滨伏尔加庄园,20231221,全国,全国,176,70,106
哈尔滨伏尔加庄园,20231222,全国,全国,176,72,104
哈尔滨伏尔加庄园,20231223,全国,全国,171,66,105
哈尔滨伏尔加庄园,20231224,全国,全国,150,59,91
哈尔滨伏尔加庄园,20231225,全国,全国,108,0,108
哈尔滨伏尔加庄园,20231226,全国,全国,197,76,121
哈尔滨伏尔加庄园,20231227,全国,全国,216,72,144
哈尔滨伏尔加庄园,20231228,全国,全国,191,72,119
哈尔滨伏尔加庄园,20231229,全国,全国,182,80,102
哈尔滨伏尔加庄园,20231230,全国,全国,182,64,118
哈尔滨伏尔加庄园,20231231,全国,全国,184,61,123
哈尔滨伏尔加庄园,20240101,全国,全国,181,63,118
哈尔滨伏尔加庄园,20240102,全国,全国,181,85,96
哈尔滨伏尔加庄园,20240103,全国,全国,207,82,125
哈尔滨伏尔加庄园,20240104,全国,全国,385,110,275
哈尔滨伏尔加庄园,20240105,全国,全国,338,102,236
哈尔滨伏尔加庄园,20240106,全国,全国,268,85,183
哈尔滨伏尔加庄园,20240107,全国,全国,332,91,241
哈尔滨伏尔加庄园,20240108,全国,全国,272,102,170
哈尔滨伏尔加庄园,20240109,全国,全国,237,101,136
哈尔滨伏尔加庄园,20240110,全国,全国,241,93,148
哈尔滨伏尔加庄园,20240111,全国,全国,208,85,123
哈尔滨伏尔加庄园,20240112,全国,全国,218,82,136
哈尔滨伏尔加庄园,20240113,全国,全国,231,68,163
哈尔滨伏尔加庄园,20240114,全国,全国,222,74,148
哈尔滨伏尔加庄园,20240115,全国,全国,210,76,134
哈尔滨伏尔加庄园,20240116,全国,全国,201,89,112
哈尔滨伏尔加庄园,20240117,全国,全国,193,68,125
哈尔滨伏尔加庄园,20240118,全国,全国,203,72,131
哈尔滨伏尔加庄园,20240119,全国,全国,179,64,115
哈尔滨伏尔加庄园,20240120,全国,全国,167,59,108
哈尔滨伏尔加庄园,20240121,全国,全国,188,66,122
哈尔滨伏尔加庄园,20240122,全国,全国,179,66,113
哈尔滨伏尔加庄园,20240123,全国,全国,193,72,121
哈尔滨伏尔加庄园,20240124,全国,全国,205,74,131
哈尔滨伏尔加庄园,20240125,全国,全国,184,66,118
哈尔滨伏尔加庄园,20240126,全国,全国,203,68,135
哈尔滨伏尔加庄园,20240127,全国,全国,195,63,132
哈尔滨伏尔加庄园,20240128,全国,全国,134,0,134
哈尔滨伏尔加庄园,20240129,全国,全国,204,63,141
哈尔滨伏尔加庄园,20240130,全国,全国,175,66,109
哈尔滨伏尔加庄园,20240131,全国,全国,174,68,106
哈尔滨伏尔加庄园,20240201,全国,全国,199,68,131
哈尔滨伏尔加庄园,20240202,全国,全国,178,61,117
哈尔滨伏尔加庄园,20240203,全国,全国,134,0,134
哈尔滨伏尔加庄园,20240204,全国,全国,164,68,96
哈尔滨伏尔加庄园,20240205,全国,全国,176,66,110
哈尔滨伏尔加庄园,20240206,全国,全国,117,0,117
哈尔滨伏尔加庄园,20240207,全国,全国,159,59,100
哈尔滨伏尔加庄园,20240208,全国,全国,171,66,105
哈尔滨伏尔加庄园,20240209,全国,全国,86,0,86
哈尔滨伏尔加庄园,20240210,全国,全国,118,0,118
哈尔滨伏尔加庄园,20240211,全国,全国,149,0,149
哈尔滨伏尔加庄园,20240212,全国,全国,157,0,157
哈尔滨伏尔加庄园,20240213,全国,全国,212,0,212
哈尔滨伏尔加庄园,20240214,全国,全国,181,0,181
哈尔滨伏尔加庄园,20240215,全国,全国,234,66,168
哈尔滨伏尔加庄园,20240216,全国,全国,230,63,167
哈尔滨伏尔加庄园,20240217,全国,全国,206,59,147
哈尔滨伏尔加庄园,20240218,全国,全国,196,64,132
哈尔滨伏尔加庄园,20240219,全国,全国,164,68,96
哈尔滨伏尔加庄园,20240220,全国,全国,163,63,100
哈尔滨伏尔加庄园,20240221,全国,全国,142,64,78
哈尔滨伏尔加庄园,20240222,全国,全国,141,59,82
哈尔滨伏尔加庄园,20240223,全国,全国,134,63,71
哈尔滨伏尔加庄园,20240224,全国,全国,76,0,76
哈尔滨伏尔加庄园,20240225,全国,全国,76,0,76
哈尔滨伏尔加庄园,20240226,全国,全国,145,59,86
哈尔滨伏尔加庄园,20240227,全国,全国,142,59,83
哈尔滨伏尔加庄园,20240228,全国,全国,147,68,79
哈尔滨伏尔加庄园,20240229,全国,全国,71,0,71
哈尔滨伏尔加庄园,20240301,全国,全国,71,0,71
哈尔滨伏尔加庄园,20240302,全国,全国,82,0,82
哈尔滨伏尔加庄园,20240303,全国,全国,69,0,69
哈尔滨伏尔加庄园,20240304,全国,全国,141,61,80
哈尔滨伏尔加庄园,20240305,全国,全国,142,68,74
哈尔滨伏尔加庄园,20240306,全国,全国,74,0,74
哈尔滨伏尔加庄园,20240307,全国,全国,127,61,66
哈尔滨伏尔加庄园,20240308,全国,全国,127,61,66
哈尔滨伏尔加庄园,20240309,全国,全国,124,59,65
哈尔滨伏尔加庄园,20240310,全国,全国,135,59,76
哈尔滨伏尔加庄园,20240311,全国,全国,133,66,67
哈尔滨伏尔加庄园,20240312,全国,全国,126,59,67
哈尔滨伏尔加庄园,20240313,全国,全国,130,63,67
哈尔滨伏尔加庄园,20240314,全国,全国,137,59,78
哈尔滨伏尔加庄园,20240315,全国,全国,65,0,65
哈尔滨伏尔加庄园,20240316,全国,全国,131,68,63
哈尔滨伏尔加庄园,20240317,全国,全国,124,59,65
哈尔滨伏尔加庄园,20240318,全国,全国,73,0,73
哈尔滨伏尔加庄园,20240319,全国,全国,127,61,66
哈尔滨伏尔加庄园,20240320,全国,全国,137,63,74
哈尔滨伏尔加庄园,20240321,全国,全国,61,0,61
哈尔滨伏尔加庄园,20240322,全国,全国,59,59,0
哈尔滨伏尔加庄园,20240323,全国,全国,130,59,71
哈尔滨伏尔加庄园,20240324,全国,全国,65,0,65
哈尔滨伏尔加庄园,20240325,全国,全国,63,63,0
哈尔滨伏尔加庄园,20240326,全国,全国,126,59,67
哈尔滨伏尔加庄园,20240327,全国,全国,126,61,65
哈尔滨伏尔加庄园,20240328,全国,全国,133,66,67
哈尔滨伏尔加庄园,20240329,全国,全国,132,61,71
哈尔滨伏尔加庄园,20240330,全国,全国,70,0,70
哈尔滨伏尔加庄园,20240331,全国,全国,67,0,67
哈尔滨伏尔加庄园,20240401,全国,全国,140,61,79
哈尔滨伏尔加庄园,20240402,全国,全国,140,64,76
哈尔滨伏尔加庄园,20240403,全国,全国,139,59,80
哈尔滨伏尔加庄园,20240404,全国,全国,100,0,100
哈尔滨伏尔加庄园,20240405,全国,全国,82,0,82
哈尔滨伏尔加庄园,20240406,全国,全国,76,0,76
哈尔滨伏尔加庄园,20240407,全国,全国,142,64,78
哈尔滨伏尔加庄园,20240408,全国,全国,132,59,73
哈尔滨伏尔加庄园,20240409,全国,全国,139,66,73
哈尔滨伏尔加庄园,20240410,全国,全国,133,57,76
哈尔滨伏尔加庄园,20240411,全国,全国,134,64,70
哈尔滨伏尔加庄园,20240412,全国,全国,139,63,76
哈尔滨伏尔加庄园,20240413,全国,全国,133,57,76
哈尔滨伏尔加庄园,20240414,全国,全国,137,57,80
哈尔滨伏尔加庄园,20240415,全国,全国,148,74,74
哈尔滨伏尔加庄园,20240416,全国,全国,128,61,67
哈尔滨伏尔加庄园,20240417,全国,全国,143,61,82
哈尔滨伏尔加庄园,20240418,全国,全国,142,63,79
哈尔滨伏尔加庄园,20240419,全国,全国,146,68,78
哈尔滨伏尔加庄园,20240420,全国,全国,137,59,78
哈尔滨伏尔加庄园,20240421,全国,全国,83,0,83
哈尔滨伏尔加庄园,20240422,全国,全国,147,61,86
哈尔滨伏尔加庄园,20240423,全国,全国,156,64,92
哈尔滨伏尔加庄园,20240424,全国,全国,152,63,89
哈尔滨伏尔加庄园,20240425,全国,全国,146,59,87
哈尔滨伏尔加庄园,20240426,全国,全国,150,63,87
哈尔滨伏尔加庄园,20240427,全国,全国,169,59,110
哈尔滨伏尔加庄园,20240428,全国,全国,189,76,113
哈尔滨伏尔加庄园,20240429,全国,全国,163,59,104
哈尔滨伏尔加庄园,20240430,全国,全国,225,74,151
哈尔滨伏尔加庄园,20240501,全国,全国,197,59,138
哈尔滨伏尔加庄园,20240502,全国,全国,205,57,148
哈尔滨伏尔加庄园,20240503,全国,全国,189,57,132
哈尔滨伏尔加庄园,20240504,全国,全国,157,57,100
哈尔滨伏尔加庄园,20240505,全国,全国,150,57,93
哈尔滨伏尔加庄园,20240506,全国,全国,139,63,76
哈尔滨伏尔加庄园,20240507,全国,全国,149,66,83
哈尔滨伏尔加庄园,20240508,全国,全国,146,59,87
哈尔滨伏尔加庄园,20240509,全国,全国,157,61,96
哈尔滨伏尔加庄园,20240510,全国,全国,155,66,89
北方森林动物园,20220101,全国,全国,0,0,0
北方森林动物园,20220102,全国,全国,0,0,0
北方森林动物园,20220103,全国,全国,61,0,61
北方森林动物园,20220104,全国,全国,0,0,0
北方森林动物园,20220105,全国,全国,0,0,0
北方森林动物园,20220106,全国,全国,61,0,61
北方森林动物园,20220107,全国,全国,59,59,0
北方森林动物园,20220108,全国,全国,0,0,0
北方森林动物园,20220109,全国,全国,0,0,0
北方森林动物园,20220110,全国,全国,0,0,0
北方森林动物园,20220111,全国,全国,0,0,0
北方森林动物园,20220112,全国,全国,61,0,61
北方森林动物园,20220113,全国,全国,59,59,0
北方森林动物园,20220114,全国,全国,0,0,0
北方森林动物园,20220115,全国,全国,0,0,0
北方森林动物园,20220116,全国,全国,0,0,0
北方森林动物园,20220117,全国,全国,0,0,0
北方森林动物园,20220118,全国,全国,0,0,0
北方森林动物园,20220119,全国,全国,0,0,0
北方森林动物园,20220120,全国,全国,59,59,0
北方森林动物园,20220121,全国,全国,0,0,0
北方森林动物园,20220122,全国,全国,0,0,0
北方森林动物园,20220123,全国,全国,0,0,0
北方森林动物园,20220124,全国,全国,0,0,0
北方森林动物园,20220125,全国,全国,0,0,0
北方森林动物园,20220126,全国,全国,0,0,0
北方森林动物园,20220127,全国,全国,0,0,0
北方森林动物园,20220128,全国,全国,0,0,0
北方森林动物园,20220129,全国,全国,0,0,0
北方森林动物园,20220130,全国,全国,59,59,0
北方森林动物园,20220131,全国,全国,0,0,0
北方森林动物园,20220201,全国,全国,0,0,0
北方森林动物园,20220202,全国,全国,0,0,0
北方森林动物园,20220203,全国,全国,63,0,63
北方森林动物园,20220204,全国,全国,59,59,0
北方森林动物园,20220205,全国,全国,0,0,0
北方森林动物园,20220206,全国,全国,0,0,0
北方森林动物园,20220207,全国,全国,0,0,0
北方森林动物园,20220208,全国,全国,124,59,65
北方森林动物园,20220209,全国,全国,0,0,0
北方森林动物园,20220210,全国,全国,59,59,0
北方森林动物园,20220211,全国,全国,0,0,0
北方森林动物园,20220212,全国,全国,71,0,71
北方森林动物园,20220213,全国,全国,69,0,69
北方森林动物园,20220214,全国,全国,65,0,65
北方森林动物园,20220215,全国,全国,61,0,61
北方森林动物园,20220216,全国,全国,126,61,65
北方森林动物园,20220217,全国,全国,0,0,0
北方森林动物园,20220218,全国,全国,67,0,67
北方森林动物园,20220219,全国,全国,65,0,65
北方森林动物园,20220220,全国,全国,0,0,0
北方森林动物园,20220221,全国,全国,0,0,0
北方森林动物园,20220222,全国,全国,126,59,67
北方森林动物园,20220223,全国,全国,0,0,0
北方森林动物园,20220224,全国,全国,124,61,63
北方森林动物园,20220225,全国,全国,69,0,69
北方森林动物园,20220226,全国,全国,70,0,70
北方森林动物园,20220227,全国,全国,70,0,70
北方森林动物园,20220228,全国,全国,65,0,65
北方森林动物园,20220301,全国,全国,61,0,61
北方森林动物园,20220302,全国,全国,0,0,0
北方森林动物园,20220303,全国,全国,0,0,0
北方森林动物园,20220304,全国,全国,0,0,0
北方森林动物园,20220305,全国,全国,0,0,0
北方森林动物园,20220306,全国,全国,0,0,0
北方森林动物园,20220307,全国,全国,70,0,70
北方森林动物园,20220308,全国,全国,59,59,0
北方森林动物园,20220309,全国,全国,141,61,80
北方森林动物园,20220310,全国,全国,127,61,66
北方森林动物园,20220311,全国,全国,61,0,61
北方森林动物园,20220312,全国,全国,65,0,65
北方森林动物园,20220313,全国,全国,0,0,0
北方森林动物园,20220314,全国,全国,65,0,65
北方森林动物园,20220315,全国,全国,59,59,0
北方森林动物园,20220316,全国,全国,61,0,61
北方森林动物园,20220317,全国,全国,0,0,0
北方森林动物园,20220318,全国,全国,61,0,61
北方森林动物园,20220319,全国,全国,0,0,0
北方森林动物园,20220320,全国,全国,0,0,0
北方森林动物园,20220321,全国,全国,67,0,67
北方森林动物园,20220322,全国,全国,59,59,0
北方森林动物园,20220323,全国,全国,120,59,61
北方森林动物园,20220324,全国,全国,0,0,0
北方森林动物园,20220325,全国,全国,73,0,73
北方森林动物园,20220326,全国,全国,66,0,66
北方森林动物园,20220327,全国,全国,61,0,61
北方森林动物园,20220328,全国,全国,0,0,0
北方森林动物园,20220329,全国,全国,69,0,69
北方森林动物园,20220330,全国,全国,0,0,0
北方森林动物园,20220331,全国,全国,70,0,70
北方森林动物园,20220401,全国,全国,63,0,63
北方森林动物园,20220402,全国,全国,63,0,63
北方森林动物园,20220403,全国,全国,0,0,0
北方森林动物园,20220404,全国,全国,76,0,76
北方森林动物园,20220405,全国,全国,0,0,0
北方森林动物园,20220406,全国,全国,0,0,0
北方森林动物园,20220407,全国,全国,61,0,61
北方森林动物园,20220408,全国,全国,0,0,0
北方森林动物园,20220409,全国,全国,63,0,63
北方森林动物园,20220410,全国,全国,69,0,69
北方森林动物园,20220411,全国,全国,127,61,66
北方森林动物园,20220412,全国,全国,139,63,76
北方森林动物园,20220413,全国,全国,127,61,66
北方森林动物园,20220414,全国,全国,124,61,63
北方森林动物园,20220415,全国,全国,0,0,0
北方森林动物园,20220416,全国,全国,0,0,0
北方森林动物园,20220417,全国,全国,66,0,66
北方森林动物园,20220418,全国,全国,61,61,0
北方森林动物园,20220419,全国,全国,67,0,67
北方森林动物园,20220420,全国,全国,122,59,63
北方森林动物园,20220421,全国,全国,61,0,61
北方森林动物园,20220422,全国,全国,0,0,0
北方森林动物园,20220423,全国,全国,63,0,63
北方森林动物园,20220424,全国,全国,84,0,84
北方森林动物园,20220425,全国,全国,65,0,65
北方森林动物园,20220426,全国,全国,70,0,70
北方森林动物园,20220427,全国,全国,66,0,66
北方森林动物园,20220428,全国,全国,73,0,73
北方森林动物园,20220429,全国,全国,76,0,76
北方森林动物园,20220430,全国,全国,80,0,80
北方森林动物园,20220501,全国,全国,76,0,76
北方森林动物园,20220502,全国,全国,132,59,73
北方森林动物园,20220503,全国,全国,69,0,69
北方森林动物园,20220504,全国,全国,65,0,65
北方森林动物园,20220505,全国,全国,82,0,82
北方森林动物园,20220506,全国,全国,139,59,80
北方森林动物园,20220507,全国,全国,86,0,86
北方森林动物园,20220508,全国,全国,78,0,78
北方森林动物园,20220509,全国,全国,91,0,91
北方森林动物园,20220510,全国,全国,74,0,74
北方森林动物园,20220511,全国,全国,86,0,86
北方森林动物园,20220512,全国,全国,167,63,104
北方森林动物园,20220513,全国,全国,159,59,100
北方森林动物园,20220514,全国,全国,187,59,128
北方森林动物园,20220515,全国,全国,168,59,109
北方森林动物园,20220516,全国,全国,188,70,118
北方森林动物园,20220517,全国,全国,165,66,99
北方森林动物园,20220518,全国,全国,173,61,112
北方森林动物园,20220519,全国,全国,197,61,136
北方森林动物园,20220520,全国,全国,188,63,125
北方森林动物园,20220521,全国,全国,151,0,151
北方森林动物园,20220522,全国,全国,154,0,154
北方森林动物园,20220523,全国,全国,167,63,104
北方森林动物园,20220524,全国,全国,96,0,96
北方森林动物园,20220525,全国,全国,145,59,86
北方森林动物园,20220526,全国,全国,147,64,83
北方森林动物园,20220527,全国,全国,135,0,135
北方森林动物园,20220528,全国,全国,141,0,141
北方森林动物园,20220529,全国,全国,105,0,105
北方森林动物园,20220530,全国,全国,163,59,104
北方森林动物园,20220531,全国,全国,241,63,178
北方森林动物园,20220601,全国,全国,247,61,186
北方森林动物园,20220602,全国,全国,281,64,217
北方森林动物园,20220603,全国,全国,303,0,303
北方森林动物园,20220604,全国,全国,286,59,227
北方森林动物园,20220605,全国,全国,181,59,122
北方森林动物园,20220606,全国,全国,171,63,108
北方森林动物园,20220607,全国,全国,154,59,95
北方森林动物园,20220608,全国,全国,113,0,113
北方森林动物园,20220609,全国,全国,172,64,108
北方森林动物园,20220610,全国,全国,171,61,110
北方森林动物园,20220611,全国,全国,138,0,138
北方森林动物园,20220612,全国,全国,193,61,132
北方森林动物园,20220613,全国,全国,71,0,71
北方森林动物园,20220614,全国,全国,165,61,104
北方森林动物园,20220615,全国,全国,167,59,108
北方森林动物园,20220616,全国,全国,150,59,91
北方森林动物园,20220617,全国,全国,134,0,134
北方森林动物园,20220618,全国,全国,182,59,123
北方森林动物园,20220619,全国,全国,138,0,138
北方森林动物园,20220620,全国,全国,97,0,97
北方森林动物园,20220621,全国,全国,100,0,100
北方森林动物园,20220622,全国,全国,147,61,86
北方森林动物园,20220623,全国,全国,92,0,92
北方森林动物园,20220624,全国,全国,112,0,112
北方森林动物园,20220625,全国,全国,99,0,99
北方森林动物园,20220626,全国,全国,119,0,119
北方森林动物园,20220627,全国,全国,165,63,102
北方森林动物园,20220628,全国,全国,178,59,119
北方森林动物园,20220629,全国,全国,176,63,113
北方森林动物园,20220630,全国,全国,165,61,104
北方森林动物园,20220701,全国,全国,177,59,118
北方森林动物园,20220702,全国,全国,182,61,121
北方森林动物园,20220703,全国,全国,144,0,144
北方森林动物园,20220704,全国,全国,169,59,110
北方森林动物园,20220705,全国,全国,172,64,108
北方森林动物园,20220706,全国,全国,166,61,105
北方森林动物园,20220707,全国,全国,177,68,109
北方森林动物园,20220708,全国,全国,176,66,110
北方森林动物园,20220709,全国,全国,143,0,143
北方森林动物园,20220710,全国,全国,176,0,176
北方森林动物园,20220711,全国,全国,172,64,108
北方森林动物园,20220712,全国,全国,134,0,134
北方森林动物园,20220713,全国,全国,177,59,118
北方森林动物园,20220714,全国,全国,149,0,149
北方森林动物园,20220715,全国,全国,231,66,165
北方森林动物园,20220716,全国,全国,149,0,149
北方森林动物园,20220717,全国,全国,184,0,184
北方森林动物园,20220718,全国,全国,183,61,122
北方森林动物园,20220719,全国,全国,213,61,152
北方森林动物园,20220720,全国,全国,181,59,122
北方森林动物园,20220721,全国,全国,219,59,160
北方森林动物园,20220722,全国,全国,224,59,165
北方森林动物园,20220723,全国,全国,234,61,173
北方森林动物园,20220724,全国,全国,237,63,174
北方森林动物园,20220725,全国,全国,233,63,170
北方森林动物园,20220726,全国,全国,213,59,154
北方森林动物园,20220727,全国,全国,193,61,132
北方森林动物园,20220728,全国,全国,213,64,149
北方森林动物园,20220729,全国,全国,215,63,152
北方森林动物园,20220730,全国,全国,237,61,176
北方森林动物园,20220731,全国,全国,235,59,176
北方森林动物园,20220801,全国,全国,230,63,167
北方森林动物园,20220802,全国,全国,176,0,176
北方森林动物园,20220803,全国,全国,205,61,144
北方森林动物园,20220804,全国,全国,241,68,173
北方森林动物园,20220805,全国,全国,237,63,174
北方森林动物园,20220806,全国,全国,251,59,192
北方森林动物园,20220807,全国,全国,192,0,192
北方森林动物园,20220808,全国,全国,215,63,152
北方森林动物园,20220809,全国,全国,202,61,141
北方森林动物园,20220810,全国,全国,220,59,161
北方森林动物园,20220811,全国,全国,216,59,157
北方森林动物园,20220812,全国,全国,216,59,157
北方森林动物园,20220813,全国,全国,241,61,180
北方森林动物园,20220814,全国,全国,233,59,174
北方森林动物园,20220815,全国,全国,135,0,135
北方森林动物园,20220816,全国,全国,164,0,164
北方森林动物园,20220817,全国,全国,203,64,139
北方森林动物园,20220818,全国,全国,134,0,134
北方森林动物园,20220819,全国,全国,178,61,117
北方森林动物园,20220820,全国,全国,250,61,189
北方森林动物园,20220821,全国,全国,136,0,136
北方森林动物园,20220822,全国,全国,150,61,89
北方森林动物园,20220823,全国,全国,182,61,121
北方森林动物园,20220824,全国,全国,175,63,112
北方森林动物园,20220825,全国,全国,96,0,96
北方森林动物园,20220826,全国,全国,169,63,106
北方森林动物园,20220827,全国,全国,121,0,121
北方森林动物园,20220828,全国,全国,109,0,109
北方森林动物园,20220829,全国,全国,126,61,65
北方森林动物园,20220830,全国,全国,70,0,70
北方森林动物园,20220831,全国,全国,0,0,0
北方森林动物园,20220901,全国,全国,0,0,0
北方森林动物园,20220902,全国,全国,65,0,65
北方森林动物园,20220903,全国,全国,73,0,73
北方森林动物园,20220904,全国,全国,66,0,66
北方森林动物园,20220905,全国,全国,61,61,0
北方森林动物园,20220906,全国,全国,122,61,61
北方森林动物园,20220907,全国,全国,73,0,73
北方森林动物园,20220908,全国,全国,138,59,79
北方森林动物园,20220909,全国,全国,171,66,105
北方森林动物园,20220910,全国,全国,117,0,117
北方森林动物园,20220911,全国,全国,222,59,163
北方森林动物园,20220912,全国,全国,115,0,115
北方森林动物园,20220913,全国,全国,150,59,91
北方森林动物园,20220914,全国,全国,139,59,80
北方森林动物园,20220915,全国,全国,84,0,84
北方森林动物园,20220916,全国,全国,87,0,87
北方森林动物园,20220917,全国,全国,96,0,96
北方森林动物园,20220918,全国,全国,99,0,99
北方森林动物园,20220919,全国,全国,141,59,82
北方森林动物园,20220920,全国,全国,67,0,67
北方森林动物园,20220921,全国,全国,125,59,66
北方森林动物园,20220922,全国,全国,73,0,73
北方森林动物园,20220923,全国,全国,128,59,69
北方森林动物园,20220924,全国,全国,86,0,86
北方森林动物园,20220925,全国,全国,80,0,80
北方森林动物园,20220926,全国,全国,74,0,74
北方森林动物园,20220927,全国,全国,86,0,86
北方森林动物园,20220928,全国,全国,80,0,80
北方森林动物园,20220929,全国,全国,152,61,91
北方森林动物园,20220930,全国,全国,216,68,148
北方森林动物园,20221001,全国,全国,187,0,187
北方森林动物园,20221002,全国,全国,179,0,179
北方森林动物园,20221003,全国,全国,105,0,105
北方森林动物园,20221004,全国,全国,122,0,122
北方森林动物园,20221005,全国,全国,97,0,97
北方森林动物园,20221006,全国,全国,84,0,84
北方森林动物园,20221007,全国,全国,96,0,96
北方森林动物园,20221008,全国,全国,76,0,76
北方森林动物园,20221009,全国,全国,126,59,67
北方森林动物园,20221010,全国,全国,126,59,67
北方森林动物园,20221011,全国,全国,61,0,61
北方森林动物园,20221012,全国,全国,61,0,61
北方森林动物园,20221013,全国,全国,80,0,80
北方森林动物园,20221014,全国,全国,69,0,69
北方森林动物园,20221015,全国,全国,132,59,73
北方森林动物园,20221016,全国,全国,74,0,74
北方森林动物园,20221017,全国,全国,67,0,67
北方森林动物园,20221018,全国,全国,70,0,70
北方森林动物园,20221019,全国,全国,61,0,61
北方森林动物园,20221020,全国,全国,0,0,0
北方森林动物园,20221021,全国,全国,66,0,66
北方森林动物园,20221022,全国,全国,69,0,69
北方森林动物园,20221023,全国,全国,65,0,65
北方森林动物园,20221024,全国,全国,0,0,0
北方森林动物园,20221025,全国,全国,0,0,0
北方森林动物园,20221026,全国,全国,69,0,69
北方森林动物园,20221027,全国,全国,63,0,63
北方森林动物园,20221028,全国,全国,0,0,0
北方森林动物园,20221029,全国,全国,71,0,71
北方森林动物园,20221030,全国,全国,66,0,66
北方森林动物园,20221031,全国,全国,0,0,0
北方森林动物园,20221101,全国,全国,66,0,66
北方森林动物园,20221102,全国,全国,59,59,0
北方森林动物园,20221103,全国,全国,65,0,65
北方森林动物园,20221104,全国,全国,63,0,63
北方森林动物园,20221105,全国,全国,66,0,66
北方森林动物园,20221106,全国,全国,0,0,0
北方森林动物园,20221107,全国,全国,0,0,0
北方森林动物园,20221108,全国,全国,61,0,61
北方森林动物园,20221109,全国,全国,63,0,63
北方森林动物园,20221110,全国,全国,63,0,63
北方森林动物园,20221111,全国,全国,0,0,0
北方森林动物园,20221112,全国,全国,122,59,63
北方森林动物园,20221113,全国,全国,71,0,71
北方森林动物园,20221114,全国,全国,61,0,61
北方森林动物园,20221115,全国,全国,0,0,0
北方森林动物园,20221116,全国,全国,0,0,0
北方森林动物园,20221117,全国,全国,61,0,61
北方森林动物园,20221118,全国,全国,0,0,0
北方森林动物园,20221119,全国,全国,69,0,69
北方森林动物园,20221120,全国,全国,0,0,0
北方森林动物园,20221121,全国,全国,66,0,66
北方森林动物园,20221122,全国,全国,61,0,61
北方森林动物园,20221123,全国,全国,0,0,0
北方森林动物园,20221124,全国,全国,0,0,0
北方森林动物园,20221125,全国,全国,0,0,0
北方森林动物园,20221126,全国,全国,0,0,0
北方森林动物园,20221127,全国,全国,70,0,70
北方森林动物园,20221128,全国,全国,0,0,0
北方森林动物园,20221129,全国,全国,63,0,63
北方森林动物园,20221130,全国,全国,65,0,65
北方森林动物园,20221201,全国,全国,0,0,0
北方森林动物园,20221202,全国,全国,0,0,0
北方森林动物园,20221203,全国,全国,61,0,61
北方森林动物园,20221204,全国,全国,0,0,0
北方森林动物园,20221205,全国,全国,0,0,0
北方森林动物园,20221206,全国,全国,120,59,61
北方森林动物园,20221207,全国,全国,0,0,0
北方森林动物园,20221208,全国,全国,0,0,0
北方森林动物园,20221209,全国,全国,67,0,67
北方森林动物园,20221210,全国,全国,65,0,65
北方森林动物园,20221211,全国,全国,0,0,0
北方森林动物园,20221212,全国,全国,0,0,0
北方森林动物园,20221213,全国,全国,66,0,66
北方森林动物园,20221214,全国,全国,66,0,66
北方森林动物园,20221215,全国,全国,63,0,63
北方森林动物园,20221216,全国,全国,61,0,61
北方森林动物园,20221217,全国,全国,61,0,61
北方森林动物园,20221218,全国,全国,63,0,63
北方森林动物园,20221219,全国,全国,0,0,0
北方森林动物园,20221220,全国,全国,0,0,0
北方森林动物园,20221221,全国,全国,59,59,0
北方森林动物园,20221222,全国,全国,0,0,0
北方森林动物园,20221223,全国,全国,0,0,0
北方森林动物园,20221224,全国,全国,65,0,65
北方森林动物园,20221225,全国,全国,61,0,61
北方森林动物园,20221226,全国,全国,122,61,61
北方森林动物园,20221227,全国,全国,65,0,65
北方森林动物园,20221228,全国,全国,67,0,67
北方森林动物园,20221229,全国,全国,0,0,0
北方森林动物园,20221230,全国,全国,0,0,0
北方森林动物园,20221231,全国,全国,0,0,0
北方森林动物园,20230101,全国,全国,0,0,0
北方森林动物园,20230102,全国,全国,63,0,63
北方森林动物园,20230103,全国,全国,122,61,61
北方森林动物园,20230104,全国,全国,61,0,61
北方森林动物园,20230105,全国,全国,61,0,61
北方森林动物园,20230106,全国,全国,0,0,0
北方森林动物园,20230107,全国,全国,63,0,63
北方森林动物园,20230108,全国,全国,0,0,0
北方森林动物园,20230109,全国,全国,0,0,0
北方森林动物园,20230110,全国,全国,120,59,61
北方森林动物园,20230111,全国,全国,125,59,66
北方森林动物园,20230112,全国,全国,61,0,61
北方森林动物园,20230113,全国,全国,0,0,0
北方森林动物园,20230114,全国,全国,0,0,0
北方森林动物园,20230115,全国,全国,0,0,0
北方森林动物园,20230116,全国,全国,63,0,63
北方森林动物园,20230117,全国,全国,0,0,0
北方森林动物园,20230118,全国,全国,0,0,0
北方森林动物园,20230119,全国,全国,65,0,65
北方森林动物园,20230120,全国,全国,0,0,0
北方森林动物园,20230121,全国,全国,0,0,0
北方森林动物园,20230122,全国,全国,66,0,66
北方森林动物园,20230123,全国,全国,70,0,70
北方森林动物园,20230124,全国,全国,69,0,69
北方森林动物园,20230125,全国,全国,71,0,71
北方森林动物园,20230126,全国,全国,126,59,67
北方森林动物园,20230127,全国,全国,0,0,0
北方森林动物园,20230128,全国,全国,66,0,66
北方森林动物园,20230129,全国,全国,73,0,73
北方森林动物园,20230130,全国,全国,67,0,67
北方森林动物园,20230131,全国,全国,127,61,66
北方森林动物园,20230201,全国,全国,67,0,67
北方森林动物园,20230202,全国,全国,124,59,65
北方森林动物园,20230203,全国,全国,73,0,73
北方森林动物园,20230204,全国,全国,65,0,65
北方森林动物园,20230205,全国,全国,124,59,65
北方森林动物园,20230206,全国,全国,66,0,66
北方森林动物园,20230207,全国,全国,61,61,0
北方森林动物园,20230208,全国,全国,65,0,65
北方森林动物园,20230209,全国,全国,0,0,0
北方森林动物园,20230210,全国,全国,63,0,63
北方森林动物园,20230211,全国,全国,122,59,63
北方森林动物园,20230212,全国,全国,67,0,67
北方森林动物园,20230213,全国,全国,69,0,69
北方森林动物园,20230214,全国,全国,0,0,0
北方森林动物园,20230215,全国,全国,0,0,0
北方森林动物园,20230216,全国,全国,61,0,61
北方森林动物园,20230217,全国,全国,59,59,0
北方森林动物园,20230218,全国,全国,65,0,65
北方森林动物园,20230219,全国,全国,122,59,63
北方森林动物园,20230220,全国,全国,0,0,0
北方森林动物园,20230221,全国,全国,0,0,0
北方森林动物园,20230222,全国,全国,126,59,67
北方森林动物园,20230223,全国,全国,67,0,67
北方森林动物园,20230224,全国,全国,61,0,61
北方森林动物园,20230225,全国,全国,132,59,73
北方森林动物园,20230226,全国,全国,69,0,69
北方森林动物园,20230227,全国,全国,133,64,69
北方森林动物园,20230228,全国,全国,124,63,61
北方森林动物园,20230301,全国,全国,66,0,66
北方森林动物园,20230302,全国,全国,71,0,71
北方森林动物园,20230303,全国,全国,70,0,70
北方森林动物园,20230304,全国,全国,122,59,63
北方森林动物园,20230305,全国,全国,67,0,67
北方森林动物园,20230306,全国,全国,65,0,65
北方森林动物园,20230307,全国,全国,71,0,71
北方森林动物园,20230308,全国,全国,126,59,67
北方森林动物园,20230309,全国,全国,76,0,76
北方森林动物园,20230310,全国,全国,132,63,69
北方森林动物园,20230311,全国,全国,124,59,65
北方森林动物园,20230312,全国,全国,74,0,74
北方森林动物园,20230313,全国,全国,78,0,78
北方森林动物园,20230314,全国,全国,130,59,71
北方森林动物园,20230315,全国,全国,67,0,67
北方森林动物园,20230316,全国,全国,135,61,74
北方森林动物园,20230317,全国,全国,78,0,78
北方森林动物园,20230318,全国,全国,80,0,80
北方森林动物园,20230319,全国,全国,138,59,79
北方森林动物园,20230320,全国,全国,139,61,78
北方森林动物园,20230321,全国,全国,74,0,74
北方森林动物园,20230322,全国,全国,148,59,89
北方森林动物园,20230323,全国,全国,78,0,78
北方森林动物园,20230324,全国,全国,105,0,105
北方森林动物园,20230325,全国,全国,82,0,82
北方森林动物园,20230326,全国,全国,71,0,71
北方森林动物园,20230327,全国,全国,146,59,87
北方森林动物园,20230328,全国,全国,86,0,86
北方森林动物园,20230329,全国,全国,132,61,71
北方森林动物园,20230330,全国,全国,153,61,92
北方森林动物园,20230331,全国,全国,154,63,91
北方森林动物园,20230401,全国,全国,78,0,78
北方森林动物园,20230402,全国,全国,158,59,99
北方森林动物园,20230403,全国,全国,145,59,86
北方森林动物园,20230404,全国,全国,166,64,102
北方森林动物园,20230405,全国,全国,109,0,109
北方森林动物园,20230406,全国,全国,148,59,89
北方森林动物园,20230407,全国,全国,83,0,83
北方森林动物园,20230408,全国,全国,178,63,115
北方森林动物园,20230409,全国,全国,97,0,97
北方森林动物园,20230410,全国,全国,173,61,112
北方森林动物园,20230411,全国,全国,193,74,119
北方森林动物园,20230412,全国,全国,189,66,123
北方森林动物园,20230413,全国,全国,195,70,125
北方森林动物园,20230414,全国,全国,189,70,119
北方森林动物园,20230415,全国,全国,214,63,151
北方森林动物园,20230416,全国,全国,154,0,154
北方森林动物园,20230417,全国,全国,197,61,136
北方森林动物园,20230418,全国,全国,198,64,134
北方森林动物园,20230419,全国,全国,190,59,131
北方森林动物园,20230420,全国,全国,169,61,108
北方森林动物园,20230421,全国,全国,214,63,151
北方森林动物园,20230422,全国,全国,217,59,158
北方森林动物园,20230423,全国,全国,227,76,151
北方森林动物园,20230424,全国,全国,229,72,157
北方森林动物园,20230425,全国,全国,223,63,160
北方森林动物园,20230426,全国,全国,247,68,179
北方森林动物园,20230427,全国,全国,323,80,243
北方森林动物园,20230428,全国,全国,381,80,301
北方森林动物园,20230429,全国,全国,454,61,393
北方森林动物园,20230430,全国,全国,669,70,599
北方森林动物园,20230501,全国,全国,937,82,855
北方森林动物园,20230502,全国,全国,623,59,564
北方森林动物园,20230503,全国,全国,353,61,292
北方森林动物园,20230504,全国,全国,226,64,162
北方森林动物园,20230505,全国,全国,211,66,145
北方森林动物园,20230506,全国,全国,209,61,148
北方森林动物园,20230507,全国,全国,159,0,159
北方森林动物园,20230508,全国,全国,171,59,112
北方森林动物园,20230509,全国,全国,167,63,104
北方森林动物园,20230510,全国,全国,175,66,109
北方森林动物园,20230511,全国,全国,187,59,128
北方森林动物园,20230512,全国,全国,110,0,110
北方森林动物园,20230513,全国,全国,154,0,154
北方森林动物园,20230514,全国,全国,134,0,134
北方森林动物园,20230515,全国,全国,187,59,128
北方森林动物园,20230516,全国,全国,182,64,118
北方森林动物园,20230517,全国,全国,149,0,149
北方森林动物园,20230518,全国,全国,180,59,121
北方森林动物园,20230519,全国,全国,123,0,123
北方森林动物园,20230520,全国,全国,145,0,145
北方森林动物园,20230521,全国,全国,143,0,143
北方森林动物园,20230522,全国,全国,109,0,109
北方森林动物园,20230523,全国,全国,112,0,112
北方森林动物园,20230524,全国,全国,227,63,164
北方森林动物园,20230525,全国,全国,230,68,162
北方森林动物园,20230526,全国,全国,227,61,166
北方森林动物园,20230527,全国,全国,232,59,173
北方森林动物园,20230528,全国,全国,231,61,170
北方森林动物园,20230529,全国,全国,170,0,170
北方森林动物园,20230530,全国,全国,234,72,162
北方森林动物园,20230531,全国,全国,233,63,170
北方森林动物园,20230601,全国,全国,228,61,167
北方森林动物园,20230602,全国,全国,194,63,131
北方森林动物园,20230603,全国,全国,260,59,201
北方森林动物园,20230604,全国,全国,179,0,179
北方森林动物园,20230605,全国,全国,179,0,179
北方森林动物园,20230606,全国,全国,132,0,132
北方森林动物园,20230607,全国,全国,192,61,131
北方森林动物园,20230608,全国,全国,154,59,95
北方森林动物园,20230609,全国,全国,204,61,143
北方森林动物园,20230610,全国,全国,152,0,152
北方森林动物园,20230611,全国,全国,155,0,155
北方森林动物园,20230612,全国,全国,118,0,118
北方森林动物园,20230613,全国,全国,163,61,102
北方森林动物园,20230614,全国,全国,108,0,108
北方森林动物园,20230615,全国,全国,156,59,97
北方森林动物园,20230616,全国,全国,164,59,105
北方森林动物园,20230617,全国,全国,157,0,157
北方森林动物园,20230618,全国,全国,157,0,157
北方森林动物园,20230619,全国,全国,174,59,115
北方森林动物园,20230620,全国,全国,105,0,105
北方森林动物园,20230621,全国,全国,195,63,132
北方森林动物园,20230622,全国,全国,282,63,219
北方森林动物园,20230623,全国,全国,214,0,214
北方森林动物园,20230624,全国,全国,199,64,135
北方森林动物园,20230625,全国,全国,182,61,121
北方森林动物园,20230626,全国,全国,152,61,91
北方森林动物园,20230627,全国,全国,158,63,95
北方森林动物园,20230628,全国,全国,91,0,91
北方森林动物园,20230629,全国,全国,92,0,92
北方森林动物园,20230630,全国,全国,158,63,95
北方森林动物园,20230701,全国,全国,182,59,123
北方森林动物园,20230702,全国,全国,197,61,136
北方森林动物园,20230703,全国,全国,96,0,96
北方森林动物园,20230704,全国,全国,152,61,91
北方森林动物园,20230705,全国,全国,159,64,95
北方森林动物园,20230706,全国,全国,156,59,97
北方森林动物园,20230707,全国,全国,115,0,115
北方森林动物园,20230708,全国,全国,181,63,118
北方森林动物园,20230709,全国,全国,93,0,93
北方森林动物园,20230710,全国,全国,92,0,92
北方森林动物园,20230711,全国,全国,113,0,113
北方森林动物园,20230712,全国,全国,157,61,96
北方森林动物园,20230713,全国,全国,167,59,108
北方森林动物园,20230714,全国,全国,104,0,104
北方森林动物园,20230715,全国,全国,87,0,87
北方森林动物园,20230716,全国,全国,121,0,121
北方森林动物园,20230717,全国,全国,166,64,102
北方森林动物园,20230718,全国,全国,93,0,93
北方森林动物园,20230719,全国,全国,187,64,123
北方森林动物园,20230720,全国,全国,191,61,130
北方森林动物园,20230721,全国,全国,169,61,108
北方森林动物园,20230722,全国,全国,139,0,139
北方森林动物园,20230723,全国,全国,115,0,115
北方森林动物园,20230724,全国,全国,93,0,93
北方森林动物园,20230725,全国,全国,173,63,110
北方森林动物园,20230726,全国,全国,197,59,138
北方森林动物园,20230727,全国,全国,122,0,122
北方森林动物园,20230728,全国,全国,182,59,123
北方森林动物园,20230729,全国,全国,220,59,161
北方森林动物园,20230730,全国,全国,231,61,170
北方森林动物园,20230731,全国,全国,227,61,166
北方森林动物园,20230801,全国,全国,190,59,131
北方森林动物园,20230802,全国,全国,96,0,96
北方森林动物园,20230803,全国,全国,165,63,102
北方森林动物园,20230804,全国,全国,160,68,92
北方森林动物园,20230805,全国,全国,154,63,91
北方森林动物园,20230806,全国,全国,147,0,147
北方森林动物园,20230807,全国,全国,122,0,122
北方森林动物园,20230808,全国,全国,108,0,108
北方森林动物园,20230809,全国,全国,113,0,113
北方森林动物园,20230810,全国,全国,159,59,100
北方森林动物园,20230811,全国,全国,173,63,110
北方森林动物园,20230812,全国,全国,159,59,100
北方森林动物园,20230813,全国,全国,106,0,106
北方森林动物园,20230814,全国,全国,185,66,119
北方森林动物园,20230815,全国,全国,143,0,143
北方森林动物园,20230816,全国,全国,148,0,148
北方森林动物园,20230817,全国,全国,185,59,126
北方森林动物园,20230818,全国,全国,139,0,139
北方森林动物园,20230819,全国,全国,220,59,161
北方森林动物园,20230820,全国,全国,144,0,144
北方森林动物园,20230821,全国,全国,105,0,105
北方森林动物园,20230822,全国,全国,189,61,128
北方森林动物园,20230823,全国,全国,171,59,112
北方森林动物园,20230824,全国,全国,180,63,117
北方森林动物园,20230825,全国,全国,168,59,109
北方森林动物园,20230826,全国,全国,182,59,123
北方森林动物园,20230827,全国,全国,163,0,163
北方森林动物园,20230828,全国,全国,160,63,97
北方森林动物园,20230829,全国,全国,84,0,84
北方森林动物园,20230830,全国,全国,134,61,73
北方森林动物园,20230831,全国,全国,99,0,99
北方森林动物园,20230901,全国,全国,148,59,89
北方森林动物园,20230902,全国,全国,169,59,110
北方森林动物园,20230903,全国,全国,108,0,108
北方森林动物园,20230904,全国,全国,76,0,76
北方森林动物园,20230905,全国,全国,148,70,78
北方森林动物园,20230906,全国,全国,139,61,78
北方森林动物园,20230907,全国,全国,140,70,70
北方森林动物园,20230908,全国,全国,175,63,112
北方森林动物园,20230909,全国,全国,208,59,149
北方森林动物园,20230910,全国,全国,135,0,135
北方森林动物园,20230911,全国,全国,86,0,86
北方森林动物园,20230912,全国,全国,80,0,80
北方森林动物园,20230913,全国,全国,155,59,96
北方森林动物园,20230914,全国,全国,155,63,92
北方森林动物园,20230915,全国,全国,165,63,102
北方森林动物园,20230916,全国,全国,168,59,109
北方森林动物园,20230917,全国,全国,121,0,121
北方森林动物园,20230918,全国,全国,78,0,78
北方森林动物园,20230919,全国,全国,141,59,82
北方森林动物园,20230920,全国,全国,141,59,82
北方森林动物园,20230921,全国,全国,154,59,95
北方森林动物园,20230922,全国,全国,168,66,102
北方森林动物园,20230923,全国,全国,184,72,112
北方森林动物园,20230924,全国,全国,89,0,89
北方森林动物园,20230925,全国,全国,172,64,108
北方森林动物园,20230926,全国,全国,205,66,139
北方森林动物园,20230927,全国,全国,199,68,131
北方森林动物园,20230928,全国,全国,215,74,141
北方森林动物园,20230929,全国,全国,187,0,187
北方森林动物园,20230930,全国,全国,311,61,250
北方森林动物园,20231001,全国,全国,372,63,309
北方森林动物园,20231002,全国,全国,383,64,319
北方森林动物园,20231003,全国,全国,221,0,221
北方森林动物园,20231004,全国,全国,280,59,221
北方森林动物园,20231005,全国,全国,230,59,171
北方森林动物园,20231006,全国,全国,191,59,132
北方森林动物园,20231007,全国,全国,91,0,91
北方森林动物园,20231008,全国,全国,84,0,84
北方森林动物园,20231009,全国,全国,74,0,74
北方森林动物园,20231010,全国,全国,73,0,73
北方森林动物园,20231011,全国,全国,67,0,67
北方森林动物园,20231012,全国,全国,125,59,66
北方森林动物园,20231013,全国,全国,141,59,82
北方森林动物园,20231014,全国,全国,105,0,105
北方森林动物园,20231015,全国,全国,86,0,86
北方森林动物园,20231016,全国,全国,70,0,70
北方森林动物园,20231017,全国,全国,124,61,63
北方森林动物园,20231018,全国,全国,132,61,71
北方森林动物园,20231019,全国,全国,66,0,66
北方森林动物园,20231020,全国,全国,70,0,70
北方森林动物园,20231021,全国,全国,78,0,78
北方森林动物园,20231022,全国,全国,129,59,70
北方森林动物园,20231023,全国,全国,66,0,66
北方森林动物园,20231024,全国,全国,76,0,76
北方森林动物园,20231025,全国,全国,124,59,65
北方森林动物园,20231026,全国,全国,61,0,61
北方森林动物园,20231027,全国,全国,66,0,66
北方森林动物园,20231028,全国,全国,71,0,71
北方森林动物园,20231029,全国,全国,76,0,76
北方森林动物园,20231030,全国,全国,61,0,61
北方森林动物园,20231031,全国,全国,65,0,65
北方森林动物园,20231101,全国,全国,61,0,61
北方森林动物园,20231102,全国,全国,0,0,0
北方森林动物园,20231103,全国,全国,61,61,0
北方森林动物园,20231104,全国,全国,59,59,0
北方森林动物园,20231105,全国,全国,0,0,0
北方森林动物园,20231106,全国,全国,0,0,0
北方森林动物园,20231107,全国,全国,0,0,0
北方森林动物园,20231108,全国,全国,0,0,0
北方森林动物园,20231109,全国,全国,0,0,0
北方森林动物园,20231110,全国,全国,0,0,0
北方森林动物园,20231111,全国,全国,0,0,0
北方森林动物园,20231112,全国,全国,0,0,0
北方森林动物园,20231113,全国,全国,61,61,0
北方森林动物园,20231114,全国,全国,0,0,0
北方森林动物园,20231115,全国,全国,0,0,0
北方森林动物园,20231116,全国,全国,0,0,0
北方森林动物园,20231117,全国,全国,59,59,0
北方森林动物园,20231118,全国,全国,0,0,0
北方森林动物园,20231119,全国,全国,61,0,61
北方森林动物园,20231120,全国,全国,126,61,65
北方森林动物园,20231121,全国,全国,0,0,0
北方森林动物园,20231122,全国,全国,0,0,0
北方森林动物园,20231123,全国,全国,0,0,0
北方森林动物园,20231124,全国,全国,61,0,61
北方森林动物园,20231125,全国,全国,0,0,0
北方森林动物园,20231126,全国,全国,0,0,0
北方森林动物园,20231127,全国,全国,61,61,0
北方森林动物园,20231128,全国,全国,0,0,0
北方森林动物园,20231129,全国,全国,63,0,63
北方森林动物园,20231130,全国,全国,67,0,67
北方森林动物园,20231201,全国,全国,0,0,0
北方森林动物园,20231202,全国,全国,61,0,61
北方森林动物园,20231203,全国,全国,0,0,0
北方森林动物园,20231204,全国,全国,0,0,0
北方森林动物园,20231205,全国,全国,0,0,0
北方森林动物园,20231206,全国,全国,63,0,63
北方森林动物园,20231207,全国,全国,64,64,0
北方森林动物园,20231208,全国,全国,61,0,61
北方森林动物园,20231209,全国,全国,61,0,61
北方森林动物园,20231210,全国,全国,0,0,0
北方森林动物园,20231211,全国,全国,59,59,0
北方森林动物园,20231212,全国,全国,0,0,0
北方森林动物园,20231213,全国,全国,0,0,0
北方森林动物园,20231214,全国,全国,0,0,0
北方森林动物园,20231215,全国,全国,0,0,0
北方森林动物园,20231216,全国,全国,65,0,65
北方森林动物园,20231217,全国,全国,0,0,0
北方森林动物园,20231218,全国,全国,59,59,0
北方森林动物园,20231219,全国,全国,0,0,0
北方森林动物园,20231220,全国,全国,0,0,0
北方森林动物园,20231221,全国,全国,65,0,65
北方森林动物园,20231222,全国,全国,59,59,0
北方森林动物园,20231223,全国,全国,61,0,61
北方森林动物园,20231224,全国,全国,0,0,0
北方森林动物园,20231225,全国,全国,0,0,0
北方森林动物园,20231226,全国,全国,0,0,0
北方森林动物园,20231227,全国,全国,0,0,0
北方森林动物园,20231228,全国,全国,0,0,0
北方森林动物园,20231229,全国,全国,0,0,0
北方森林动物园,20231230,全国,全国,120,59,61
北方森林动物园,20231231,全国,全国,63,0,63
北方森林动物园,20240101,全国,全国,0,0,0
北方森林动物园,20240102,全国,全国,59,59,0
北方森林动物园,20240103,全国,全国,0,0,0
北方森林动物园,20240104,全国,全国,63,0,63
北方森林动物园,20240105,全国,全国,0,0,0
北方森林动物园,20240106,全国,全国,124,59,65
北方森林动物园,20240107,全国,全国,67,0,67
北方森林动物园,20240108,全国,全国,0,0,0
北方森林动物园,20240109,全国,全国,59,59,0
北方森林动物园,20240110,全国,全国,66,0,66
北方森林动物园,20240111,全国,全国,61,61,0
北方森林动物园,20240112,全国,全国,0,0,0
北方森林动物园,20240113,全国,全国,0,0,0
北方森林动物园,20240114,全国,全国,59,59,0
北方森林动物园,20240115,全国,全国,0,0,0
北方森林动物园,20240116,全国,全国,61,0,61
北方森林动物园,20240117,全国,全国,65,0,65
北方森林动物园,20240118,全国,全国,61,0,61
北方森林动物园,20240119,全国,全国,0,0,0
北方森林动物园,20240120,全国,全国,0,0,0
北方森林动物园,20240121,全国,全国,66,0,66
北方森林动物园,20240122,全国,全国,120,59,61
北方森林动物园,20240123,全国,全国,0,0,0
北方森林动物园,20240124,全国,全国,63,63,0
北方森林动物园,20240125,全国,全国,0,0,0
北方森林动物园,20240126,全国,全国,126,59,67
北方森林动物园,20240127,全国,全国,0,0,0
北方森林动物园,20240128,全国,全国,0,0,0
北方森林动物园,20240129,全国,全国,129,59,70
北方森林动物园,20240130,全国,全国,59,59,0
北方森林动物园,20240131,全国,全国,59,59,0
北方森林动物园,20240201,全国,全国,0,0,0
北方森林动物园,20240202,全国,全国,0,0,0
北方森林动物园,20240203,全国,全国,0,0,0
北方森林动物园,20240204,全国,全国,0,0,0
北方森林动物园,20240205,全国,全国,61,61,0
北方森林动物园,20240206,全国,全国,59,59,0
北方森林动物园,20240207,全国,全国,126,61,65
北方森林动物园,20240208,全国,全国,63,0,63
北方森林动物园,20240209,全国,全国,0,0,0
北方森林动物园,20240210,全国,全国,65,0,65
北方森林动物园,20240211,全国,全国,129,59,70
北方森林动物园,20240212,全国,全国,61,0,61
北方森林动物园,20240213,全国,全国,65,0,65
北方森林动物园,20240214,全国,全国,127,64,63
北方森林动物园,20240215,全国,全国,83,0,83
北方森林动物园,20240216,全国,全国,67,0,67
北方森林动物园,20240217,全国,全国,66,0,66
北方森林动物园,20240218,全国,全国,67,0,67
北方森林动物园,20240219,全国,全国,0,0,0
北方森林动物园,20240220,全国,全国,65,0,65
北方森林动物园,20240221,全国,全国,63,0,63
北方森林动物园,20240222,全国,全国,0,0,0
北方森林动物园,20240223,全国,全国,61,0,61
北方森林动物园,20240224,全国,全国,65,0,65
北方森林动物园,20240225,全国,全国,63,0,63
北方森林动物园,20240226,全国,全国,61,0,61
北方森林动物园,20240227,全国,全国,61,0,61
北方森林动物园,20240228,全国,全国,65,0,65
北方森林动物园,20240229,全国,全国,65,0,65
北方森林动物园,20240301,全国,全国,0,0,0
北方森林动物园,20240302,全国,全国,80,0,80
北方森林动物园,20240303,全国,全国,120,59,61
北方森林动物园,20240304,全国,全国,61,0,61
北方森林动物园,20240305,全国,全国,66,0,66
北方森林动物园,20240306,全国,全国,0,0,0
北方森林动物园,20240307,全国,全国,66,0,66
北方森林动物园,20240308,全国,全国,65,0,65
北方森林动物园,20240309,全国,全国,78,0,78
北方森林动物园,20240310,全国,全国,132,61,71
北方森林动物园,20240311,全国,全国,59,59,0
北方森林动物园,20240312,全国,全国,67,0,67
北方森林动物园,20240313,全国,全国,65,0,65
北方森林动物园,20240314,全国,全国,67,0,67
北方森林动物园,20240315,全国,全国,67,0,67
北方森林动物园,20240316,全国,全国,67,0,67
北方森林动物园,20240317,全国,全国,65,0,65
北方森林动物园,20240318,全国,全国,66,0,66
北方森林动物园,20240319,全国,全国,74,0,74
北方森林动物园,20240320,全国,全国,66,0,66
北方森林动物园,20240321,全国,全国,61,0,61
北方森林动物园,20240322,全国,全国,63,0,63
北方森林动物园,20240323,全国,全国,126,59,67
北方森林动物园,20240324,全国,全国,137,59,78
北方森林动物园,20240325,全国,全国,156,63,93
北方森林动物园,20240326,全国,全国,145,63,82
北方森林动物园,20240327,全国,全国,135,68,67
北方森林动物园,20240328,全国,全国,133,59,74
北方森林动物园,20240329,全国,全国,146,63,83
北方森林动物园,20240330,全国,全国,69,0,69
北方森林动物园,20240331,全国,全国,71,0,71
北方森林动物园,20240401,全国,全国,137,63,74
北方森林动物园,20240402,全国,全国,149,63,86
北方森林动物园,20240403,全国,全国,200,78,122
北方森林动物园,20240404,全国,全国,208,59,149
北方森林动物园,20240405,全国,全国,204,61,143
北方森林动物园,20240406,全国,全国,108,0,108
北方森林动物园,20240407,全国,全国,148,59,89
北方森林动物园,20240408,全国,全国,128,59,69
北方森林动物园,20240409,全国,全国,137,61,76
北方森林动物园,20240410,全国,全国,76,0,76
北方森林动物园,20240411,全国,全国,146,66,80
北方森林动物园,20240412,全国,全国,79,0,79
北方森林动物园,20240413,全国,全国,165,57,108
北方森林动物园,20240414,全国,全国,87,0,87
北方森林动物园,20240415,全国,全国,135,57,78
北方森林动物园,20240416,全国,全国,128,57,71
北方森林动物园,20240417,全国,全国,140,57,83
北方森林动物园,20240418,全国,全国,160,61,99
北方森林动物园,20240419,全国,全国,153,61,92
北方森林动物园,20240420,全国,全国,169,59,110
北方森林动物园,20240421,全国,全国,121,0,121
北方森林动物园,20240422,全国,全国,163,57,106
北方森林动物园,20240423,全国,全国,160,63,97
北方森林动物园,20240424,全国,全国,108,0,108
北方森林动物园,20240425,全国,全国,167,61,106
北方森林动物园,20240426,全国,全国,186,68,118
北方森林动物园,20240427,全国,全国,163,0,163
北方森林动物园,20240428,全国,全国,217,66,151
北方森林动物园,20240429,全国,全国,216,61,155
北方森林动物园,20240430,全国,全国,353,82,271
北方森林动物园,20240501,全国,全国,481,68,413
北方森林动物园,20240502,全国,全国,493,61,432
北方森林动物园,20240503,全国,全国,446,59,387
北方森林动物园,20240504,全国,全国,306,57,249
北方森林动物园,20240505,全国,全国,170,0,170
北方森林动物园,20240506,全国,全国,160,61,99
北方森林动物园,20240507,全国,全国,158,59,99
北方森林动物园,20240508,全国,全国,150,61,89
北方森林动物园,20240509,全国,全国,156,57,99
北方森林动物园,20240510,全国,全国,136,57,79
萧红故居,20220101,全国,全国,61,0,61
萧红故居,20220102,全国,全国,128,59,69
萧红故居,20220103,全国,全国,67,0,67
萧红故居,20220104,全国,全国,125,59,66
萧红故居,20220105,全国,全国,65,0,65
萧红故居,20220106,全国,全国,59,59,0
萧红故居,20220107,全国,全国,67,0,67
萧红故居,20220108,全国,全国,79,0,79
萧红故居,20220109,全国,全国,65,0,65
萧红故居,20220110,全国,全国,0,0,0
萧红故居,20220111,全国,全国,124,59,65
萧红故居,20220112,全国,全国,65,0,65
萧红故居,20220113,全国,全国,134,63,71
萧红故居,20220114,全国,全国,130,61,69
萧红故居,20220115,全国,全国,66,0,66
萧红故居,20220116,全国,全国,66,0,66
萧红故居,20220117,全国,全国,63,0,63
萧红故居,20220118,全国,全国,137,59,78
萧红故居,20220119,全国,全国,124,61,63
萧红故居,20220120,全国,全国,66,0,66
萧红故居,20220121,全国,全国,128,59,69
萧红故居,20220122,全国,全国,67,0,67
萧红故居,20220123,全国,全国,79,0,79
萧红故居,20220124,全国,全国,70,0,70
萧红故居,20220125,全国,全国,0,0,0
萧红故居,20220126,全国,全国,65,0,65
萧红故居,20220127,全国,全国,129,59,70
萧红故居,20220128,全国,全国,80,0,80
萧红故居,20220129,全国,全国,70,0,70
萧红故居,20220130,全国,全国,73,0,73
萧红故居,20220131,全国,全国,67,0,67
萧红故居,20220201,全国,全国,67,0,67
萧红故居,20220202,全国,全国,79,0,79
萧红故居,20220203,全国,全国,139,63,76
萧红故居,20220204,全国,全国,74,0,74
萧红故居,20220205,全国,全国,73,0,73
萧红故居,20220206,全国,全国,74,0,74
萧红故居,20220207,全国,全国,0,0,0
萧红故居,20220208,全国,全国,129,66,63
萧红故居,20220209,全国,全国,125,59,66
萧红故居,20220210,全国,全国,144,68,76
萧红故居,20220211,全国,全国,67,0,67
萧红故居,20220212,全国,全国,67,0,67
萧红故居,20220213,全国,全国,63,0,63
萧红故居,20220214,全国,全国,74,0,74
萧红故居,20220215,全国,全国,65,0,65
萧红故居,20220216,全国,全国,140,64,76
萧红故居,20220217,全国,全国,78,0,78
萧红故居,20220218,全国,全国,80,0,80
萧红故居,20220219,全国,全国,143,61,82
萧红故居,20220220,全国,全国,82,0,82
萧红故居,20220221,全国,全国,166,64,102
萧红故居,20220222,全国,全国,92,0,92
萧红故居,20220223,全国,全国,194,64,130
萧红故居,20220224,全国,全国,100,0,100
萧红故居,20220225,全国,全国,95,0,95
萧红故居,20220226,全国,全国,164,59,105
萧红故居,20220227,全国,全国,176,59,117
萧红故居,20220228,全国,全国,144,64,80
萧红故居,20220301,全国,全国,141,59,82
萧红故居,20220302,全国,全国,156,63,93
萧红故居,20220303,全国,全国,105,0,105
萧红故居,20220304,全国,全国,76,0,76
萧红故居,20220305,全国,全国,99,0,99
萧红故居,20220306,全国,全国,145,59,86
萧红故居,20220307,全国,全国,155,59,96
萧红故居,20220308,全国,全国,89,0,89
萧红故居,20220309,全国,全国,137,59,78
萧红故居,20220310,全国,全国,139,63,76
萧红故居,20220311,全国,全国,73,0,73
萧红故居,20220312,全国,全国,89,0,89
萧红故居,20220313,全国,全国,80,0,80
萧红故居,20220314,全国,全国,137,59,78
萧红故居,20220315,全国,全国,141,61,80
萧红故居,20220316,全国,全国,82,0,82
萧红故居,20220317,全国,全国,78,0,78
萧红故居,20220318,全国,全国,130,59,71
萧红故居,20220319,全国,全国,135,61,74
萧红故居,20220320,全国,全国,78,0,78
萧红故居,20220321,全国,全国,130,59,71
萧红故居,20220322,全国,全国,137,59,78
萧红故居,20220323,全国,全国,63,0,63
萧红故居,20220324,全国,全国,74,0,74
萧红故居,20220325,全国,全国,65,0,65
萧红故居,20220326,全国,全国,79,0,79
萧红故居,20220327,全国,全国,74,0,74
萧红故居,20220328,全国,全国,139,61,78
萧红故居,20220329,全国,全国,146,66,80
萧红故居,20220330,全国,全国,71,0,71
萧红故居,20220331,全国,全国,70,0,70
萧红故居,20220401,全国,全国,67,0,67
萧红故居,20220402,全国,全国,124,59,65
萧红故居,20220403,全国,全国,122,59,63
萧红故居,20220404,全国,全国,66,0,66
萧红故居,20220405,全国,全国,139,63,76
萧红故居,20220406,全国,全国,130,59,71
萧红故居,20220407,全国,全国,0,0,0
萧红故居,20220408,全国,全国,71,0,71
萧红故居,20220409,全国,全国,76,0,76
萧红故居,20220410,全国,全国,69,0,69
萧红故居,20220411,全国,全国,71,0,71
萧红故居,20220412,全国,全国,128,59,69
萧红故居,20220413,全国,全国,71,0,71
萧红故居,20220414,全国,全国,135,59,76
萧红故居,20220415,全国,全国,69,0,69
萧红故居,20220416,全国,全国,69,0,69
萧红故居,20220417,全国,全国,71,0,71
萧红故居,20220418,全国,全国,66,0,66
萧红故居,20220419,全国,全国,129,64,65
萧红故居,20220420,全国,全国,78,0,78
萧红故居,20220421,全国,全国,135,59,76
萧红故居,20220422,全国,全国,122,61,61
萧红故居,20220423,全国,全国,124,59,65
萧红故居,20220424,全国,全国,63,0,63
萧红故居,20220425,全国,全国,126,59,67
萧红故居,20220426,全国,全国,131,61,70
萧红故居,20220427,全国,全国,70,0,70
萧红故居,20220428,全国,全国,126,59,67
萧红故居,20220429,全国,全国,137,61,76
萧红故居,20220430,全国,全国,86,0,86
萧红故居,20220501,全国,全国,139,59,80
萧红故居,20220502,全国,全国,132,61,71
萧红故居,20220503,全国,全国,65,0,65
萧红故居,20220504,全国,全国,141,59,82
萧红故居,20220505,全国,全国,80,0,80
萧红故居,20220506,全国,全国,69,0,69
萧红故居,20220507,全国,全国,67,0,67
萧红故居,20220508,全国,全国,70,0,70
萧红故居,20220509,全国,全国,66,0,66
萧红故居,20220510,全国,全国,74,0,74
萧红故居,20220511,全国,全国,129,59,70
萧红故居,20220512,全国,全国,133,59,74
萧红故居,20220513,全国,全国,71,0,71
萧红故居,20220514,全国,全国,131,61,70
萧红故居,20220515,全国,全国,73,0,73
萧红故居,20220516,全国,全国,132,61,71
萧红故居,20220517,全国,全国,135,61,74
萧红故居,20220518,全国,全国,139,61,78
萧红故居,20220519,全国,全国,152,70,82
萧红故居,20220520,全国,全国,129,59,70
萧红故居,20220521,全国,全国,144,61,83
萧红故居,20220522,全国,全国,142,59,83
萧红故居,20220523,全国,全国,76,0,76
萧红故居,20220524,全国,全国,71,0,71
萧红故居,20220525,全国,全国,83,0,83
萧红故居,20220526,全国,全国,139,59,80
萧红故居,20220527,全国,全国,137,59,78
萧红故居,20220528,全国,全国,87,0,87
萧红故居,20220529,全国,全国,82,0,82
萧红故居,20220530,全国,全国,146,59,87
萧红故居,20220531,全国,全国,86,0,86
萧红故居,20220601,全国,全国,100,0,100
萧红故居,20220602,全国,全国,69,0,69
萧红故居,20220603,全国,全国,87,0,87
萧红故居,20220604,全国,全国,143,59,84
萧红故居,20220605,全国,全国,76,0,76
萧红故居,20220606,全国,全国,144,68,76
萧红故居,20220607,全国,全国,149,63,86
萧红故居,20220608,全国,全国,86,0,86
萧红故居,20220609,全国,全国,142,59,83
萧红故居,20220610,全国,全国,82,0,82
萧红故居,20220611,全国,全国,78,0,78
萧红故居,20220612,全国,全国,128,59,69
萧红故居,20220613,全国,全国,142,63,79
萧红故居,20220614,全国,全国,137,68,69
萧红故居,20220615,全国,全国,155,72,83
萧红故居,20220616,全国,全国,154,68,86
萧红故居,20220617,全国,全国,137,63,74
萧红故居,20220618,全国,全国,144,61,83
萧红故居,20220619,全国,全国,153,64,89
萧红故居,20220620,全国,全国,76,0,76
萧红故居,20220621,全国,全国,144,66,78
萧红故居,20220622,全国,全国,150,63,87
萧红故居,20220623,全国,全国,163,63,100
萧红故居,20220624,全国,全国,158,61,97
萧红故居,20220625,全国,全国,82,0,82
萧红故居,20220626,全国,全国,84,0,84
萧红故居,20220627,全国,全国,176,68,108
萧红故居,20220628,全国,全国,149,63,86
萧红故居,20220629,全国,全国,96,0,96
萧红故居,20220630,全国,全国,169,59,110
萧红故居,20220701,全国,全国,145,59,86
萧红故居,20220702,全国,全国,89,0,89
萧红故居,20220703,全国,全国,97,0,97
萧红故居,20220704,全国,全国,142,64,78
萧红故居,20220705,全国,全国,143,61,82
萧红故居,20220706,全国,全国,147,61,86
萧红故居,20220707,全国,全国,80,0,80
萧红故居,20220708,全国,全国,161,64,97
萧红故居,20220709,全国,全国,87,0,87
萧红故居,20220710,全国,全国,84,0,84
萧红故居,20220711,全国,全国,152,59,93
萧红故居,20220712,全国,全国,121,0,121
萧红故居,20220713,全国,全国,164,59,105
萧红故居,20220714,全国,全国,143,61,82
萧红故居,20220715,全国,全国,171,59,112
萧红故居,20220716,全国,全国,117,0,117
萧红故居,20220717,全国,全国,118,0,118
萧红故居,20220718,全国,全国,163,59,104
萧红故居,20220719,全国,全国,154,68,86
萧红故居,20220720,全国,全国,158,61,97
萧红故居,20220721,全国,全国,87,0,87
萧红故居,20220722,全国,全国,109,0,109
萧红故居,20220723,全国,全国,139,0,139
萧红故居,20220724,全国,全国,119,0,119
萧红故居,20220725,全国,全国,182,63,119
萧红故居,20220726,全国,全国,106,0,106
萧红故居,20220727,全国,全国,163,63,100
萧红故居,20220728,全国,全国,170,66,104
萧红故居,20220729,全国,全国,172,64,108
萧红故居,20220730,全国,全国,172,59,113
萧红故居,20220731,全国,全国,193,59,134
萧红故居,20220801,全国,全国,163,59,104
萧红故居,20220802,全国,全国,141,61,80
萧红故居,20220803,全国,全国,104,0,104
萧红故居,20220804,全国,全国,174,59,115
萧红故居,20220805,全国,全国,121,0,121
萧红故居,20220806,全国,全国,185,63,122
萧红故居,20220807,全国,全国,169,59,110
萧红故居,20220808,全国,全国,174,68,106
萧红故居,20220809,全国,全国,167,59,108
萧红故居,20220810,全国,全国,160,61,99
萧红故居,20220811,全国,全国,155,59,96
萧红故居,20220812,全国,全国,151,59,92
萧红故居,20220813,全国,全国,173,63,110
萧红故居,20220814,全国,全国,92,0,92
萧红故居,20220815,全国,全国,155,59,96
萧红故居,20220816,全国,全国,158,61,97
萧红故居,20220817,全国,全国,147,63,84
萧红故居,20220818,全国,全国,163,59,104
萧红故居,20220819,全国,全国,154,63,91
萧红故居,20220820,全国,全国,92,0,92
萧红故居,20220821,全国,全国,177,64,113
萧红故居,20220822,全国,全国,84,0,84
萧红故居,20220823,全国,全国,146,64,82
萧红故居,20220824,全国,全国,161,61,100
萧红故居,20220825,全国,全国,155,59,96
萧红故居,20220826,全国,全国,141,59,82
萧红故居,20220827,全国,全国,92,0,92
萧红故居,20220828,全国,全国,69,0,69
萧红故居,20220829,全国,全国,80,0,80
萧红故居,20220830,全国,全国,74,0,74
萧红故居,20220831,全国,全国,66,0,66
萧红故居,20220901,全国,全国,59,59,0
萧红故居,20220902,全国,全国,128,63,65
萧红故居,20220903,全国,全国,65,0,65
萧红故居,20220904,全国,全国,65,0,65
萧红故居,20220905,全国,全国,70,0,70
萧红故居,20220906,全国,全国,130,61,69
萧红故居,20220907,全国,全国,131,61,70
萧红故居,20220908,全国,全国,74,0,74
萧红故居,20220909,全国,全国,143,61,82
萧红故居,20220910,全国,全国,70,0,70
萧红故居,20220911,全国,全国,78,0,78
萧红故居,20220912,全国,全国,83,0,83
萧红故居,20220913,全国,全国,70,0,70
萧红故居,20220914,全国,全国,76,0,76
萧红故居,20220915,全国,全国,84,0,84
萧红故居,20220916,全国,全国,69,0,69
萧红故居,20220917,全国,全国,69,0,69
萧红故居,20220918,全国,全国,70,0,70
萧红故居,20220919,全国,全国,78,0,78
萧红故居,20220920,全国,全国,67,0,67
萧红故居,20220921,全国,全国,65,0,65
萧红故居,20220922,全国,全国,70,0,70
萧红故居,20220923,全国,全国,140,64,76
萧红故居,20220924,全国,全国,69,0,69
萧红故居,20220925,全国,全国,69,0,69
萧红故居,20220926,全国,全国,61,61,0
萧红故居,20220927,全国,全国,63,0,63
萧红故居,20220928,全国,全国,66,0,66
萧红故居,20220929,全国,全国,69,0,69
萧红故居,20220930,全国,全国,83,0,83
萧红故居,20221001,全国,全国,80,0,80
萧红故居,20221002,全国,全国,95,0,95
萧红故居,20221003,全国,全国,70,0,70
萧红故居,20221004,全国,全国,80,0,80
萧红故居,20221005,全国,全国,89,0,89
萧红故居,20221006,全国,全国,133,63,70
萧红故居,20221007,全国,全国,142,59,83
萧红故居,20221008,全国,全国,79,0,79
萧红故居,20221009,全国,全国,66,0,66
萧红故居,20221010,全国,全国,126,63,63
萧红故居,20221011,全国,全国,70,0,70
萧红故居,20221012,全国,全国,63,0,63
萧红故居,20221013,全国,全国,63,0,63
萧红故居,20221014,全国,全国,0,0,0
萧红故居,20221015,全国,全国,143,63,80
萧红故居,20221016,全国,全国,67,0,67
萧红故居,20221017,全国,全国,122,59,63
萧红故居,20221018,全国,全国,71,0,71
萧红故居,20221019,全国,全国,80,0,80
萧红故居,20221020,全国,全国,141,63,78
萧红故居,20221021,全国,全国,76,0,76
萧红故居,20221022,全国,全国,83,0,83
萧红故居,20221023,全国,全国,141,59,82
萧红故居,20221024,全国,全国,76,0,76
萧红故居,20221025,全国,全国,87,0,87
萧红故居,20221026,全国,全国,135,59,76
萧红故居,20221027,全国,全国,76,0,76
萧红故居,20221028,全国,全国,135,59,76
萧红故居,20221029,全国,全国,157,64,93
萧红故居,20221030,全国,全国,70,0,70
萧红故居,20221031,全国,全国,124,59,65
萧红故居,20221101,全国,全国,69,0,69
萧红故居,20221102,全国,全国,69,0,69
萧红故居,20221103,全国,全国,138,59,79
萧红故居,20221104,全国,全国,126,59,67
萧红故居,20221105,全国,全国,70,0,70
萧红故居,20221106,全国,全国,125,59,66
萧红故居,20221107,全国,全国,140,66,74
萧红故居,20221108,全国,全国,139,59,80
萧红故居,20221109,全国,全国,132,59,73
萧红故居,20221110,全国,全国,70,0,70
萧红故居,20221111,全国,全国,137,61,76
萧红故居,20221112,全国,全国,76,0,76
萧红故居,20221113,全国,全国,132,61,71
萧红故居,20221114,全国,全国,70,0,70
萧红故居,20221115,全国,全国,0,0,0
萧红故居,20221116,全国,全国,134,61,73
萧红故居,20221117,全国,全国,65,0,65
萧红故居,20221118,全国,全国,136,63,73
萧红故居,20221119,全国,全国,135,61,74
萧红故居,20221120,全国,全国,70,0,70
萧红故居,20221121,全国,全国,78,0,78
萧红故居,20221122,全国,全国,71,0,71
萧红故居,20221123,全国,全国,67,0,67
萧红故居,20221124,全国,全国,70,0,70
萧红故居,20221125,全国,全国,63,0,63
萧红故居,20221126,全国,全国,130,61,69
萧红故居,20221127,全国,全国,65,0,65
萧红故居,20221128,全国,全国,69,0,69
萧红故居,20221129,全国,全国,122,59,63
萧红故居,20221130,全国,全国,61,0,61
萧红故居,20221201,全国,全国,67,0,67
萧红故居,20221202,全国,全国,74,0,74
萧红故居,20221203,全国,全国,69,0,69
萧红故居,20221204,全国,全国,65,0,65
萧红故居,20221205,全国,全国,69,0,69
萧红故居,20221206,全国,全国,138,59,79
萧红故居,20221207,全国,全国,124,61,63
萧红故居,20221208,全国,全国,78,0,78
萧红故居,20221209,全国,全国,80,0,80
萧红故居,20221210,全国,全国,67,0,67
萧红故居,20221211,全国,全国,131,61,70
萧红故居,20221212,全国,全国,67,0,67
萧红故居,20221213,全国,全国,122,61,61
萧红故居,20221214,全国,全国,126,61,65
萧红故居,20221215,全国,全国,0,0,0
萧红故居,20221216,全国,全国,125,59,66
萧红故居,20221217,全国,全国,73,0,73
萧红故居,20221218,全国,全国,0,0,0
萧红故居,20221219,全国,全国,122,59,63
萧红故居,20221220,全国,全国,59,59,0
萧红故居,20221221,全国,全国,125,59,66
萧红故居,20221222,全国,全国,65,0,65
萧红故居,20221223,全国,全国,0,0,0
萧红故居,20221224,全国,全国,67,0,67
萧红故居,20221225,全国,全国,125,59,66
萧红故居,20221226,全国,全国,67,0,67
萧红故居,20221227,全国,全国,65,0,65
萧红故居,20221228,全国,全国,126,63,63
萧红故居,20221229,全国,全国,80,0,80
萧红故居,20221230,全国,全国,65,0,65
萧红故居,20221231,全国,全国,70,0,70
萧红故居,20230101,全国,全国,127,61,66
萧红故居,20230102,全国,全国,73,0,73
萧红故居,20230103,全国,全国,131,61,70
萧红故居,20230104,全国,全国,126,61,65
萧红故居,20230105,全国,全国,137,63,74
萧红故居,20230106,全国,全国,124,61,63
萧红故居,20230107,全国,全国,76,0,76
萧红故居,20230108,全国,全国,71,0,71
萧红故居,20230109,全国,全国,69,0,69
萧红故居,20230110,全国,全国,122,59,63
萧红故居,20230111,全国,全国,73,0,73
萧红故居,20230112,全国,全国,129,64,65
萧红故居,20230113,全国,全国,135,61,74
萧红故居,20230114,全国,全国,132,59,73
萧红故居,20230115,全国,全国,65,0,65
萧红故居,20230116,全国,全国,70,0,70
萧红故居,20230117,全国,全国,65,0,65
萧红故居,20230118,全国,全国,73,0,73
萧红故居,20230119,全国,全国,146,59,87
萧红故居,20230120,全国,全国,78,0,78
萧红故居,20230121,全国,全国,66,0,66
萧红故居,20230122,全国,全国,71,0,71
萧红故居,20230123,全国,全国,65,0,65
萧红故居,20230124,全国,全国,80,0,80
萧红故居,20230125,全国,全国,143,61,82
萧红故居,20230126,全国,全国,84,0,84
萧红故居,20230127,全国,全国,82,0,82
萧红故居,20230128,全国,全国,96,0,96
萧红故居,20230129,全国,全国,74,0,74
萧红故居,20230130,全国,全国,135,59,76
萧红故居,20230131,全国,全国,70,0,70
萧红故居,20230201,全国,全国,135,61,74
萧红故居,20230202,全国,全国,135,59,76
萧红故居,20230203,全国,全国,156,61,95
萧红故居,20230204,全国,全国,69,0,69
萧红故居,20230205,全国,全国,140,61,79
萧红故居,20230206,全国,全国,83,0,83
萧红故居,20230207,全国,全国,154,61,93
萧红故居,20230208,全国,全国,181,64,117
萧红故居,20230209,全国,全国,187,64,123
萧红故居,20230210,全国,全国,184,59,125
萧红故居,20230211,全国,全国,159,59,100
萧红故居,20230212,全国,全国,170,61,109
萧红故居,20230213,全国,全国,176,61,115
萧红故居,20230214,全国,全国,160,61,99
萧红故居,20230215,全国,全国,169,64,105
萧红故居,20230216,全国,全国,115,0,115
萧红故居,20230217,全国,全国,167,61,106
萧红故居,20230218,全国,全国,100,0,100
萧红故居,20230219,全国,全国,165,59,106
萧红故居,20230220,全国,全国,145,59,86
萧红故居,20230221,全国,全国,152,59,93
萧红故居,20230222,全国,全国,179,64,115
萧红故居,20230223,全国,全国,161,61,100
萧红故居,20230224,全国,全国,156,61,95
萧红故居,20230225,全国,全国,186,68,118
萧红故居,20230226,全国,全国,185,63,122
萧红故居,20230227,全国,全国,178,63,115
萧红故居,20230228,全国,全国,84,0,84
萧红故居,20230301,全国,全国,97,0,97
萧红故居,20230302,全国,全国,156,64,92
萧红故居,20230303,全国,全国,93,0,93
萧红故居,20230304,全国,全国,182,63,119
萧红故居,20230305,全国,全国,187,61,126
萧红故居,20230306,全国,全国,169,59,110
萧红故居,20230307,全国,全国,100,0,100
萧红故居,20230308,全国,全国,163,72,91
萧红故居,20230309,全国,全国,153,61,92
萧红故居,20230310,全国,全国,89,0,89
萧红故居,20230311,全国,全国,109,0,109
萧红故居,20230312,全国,全国,115,0,115
萧红故居,20230313,全国,全国,136,66,70
萧红故居,20230314,全国,全国,92,0,92
萧红故居,20230315,全国,全国,157,64,93
萧红故居,20230316,全国,全国,82,0,82
萧红故居,20230317,全国,全国,102,0,102
萧红故居,20230318,全国,全国,108,0,108
萧红故居,20230319,全国,全国,169,64,105
萧红故居,20230320,全国,全国,83,0,83
萧红故居,20230321,全国,全国,139,59,80
萧红故居,20230322,全国,全国,151,59,92
萧红故居,20230323,全国,全国,138,59,79
萧红故居,20230324,全国,全国,152,68,84
萧红故居,20230325,全国,全国,102,0,102
萧红故居,20230326,全国,全国,102,0,102
萧红故居,20230327,全国,全国,150,61,89
萧红故居,20230328,全国,全国,161,59,102
萧红故居,20230329,全国,全国,167,61,106
萧红故居,20230330,全国,全国,173,61,112
萧红故居,20230331,全国,全国,160,68,92
萧红故居,20230401,全国,全国,135,0,135
萧红故居,20230402,全国,全国,191,63,128
萧红故居,20230403,全国,全国,161,59,102
萧红故居,20230404,全国,全国,188,63,125
萧红故居,20230405,全国,全国,147,0,147
萧红故居,20230406,全国,全国,150,59,91
萧红故居,20230407,全国,全国,155,59,96
萧红故居,20230408,全国,全国,102,0,102
萧红故居,20230409,全国,全国,112,0,112
萧红故居,20230410,全国,全国,155,63,92
萧红故居,20230411,全国,全国,137,63,74
萧红故居,20230412,全国,全国,89,0,89
萧红故居,20230413,全国,全国,96,0,96
萧红故居,20230414,全国,全国,176,61,115
萧红故居,20230415,全国,全国,172,59,113
萧红故居,20230416,全国,全国,180,59,121
萧红故居,20230417,全国,全国,146,59,87
萧红故居,20230418,全国,全国,157,64,93
萧红故居,20230419,全国,全国,174,59,115
萧红故居,20230420,全国,全国,158,61,97
萧红故居,20230421,全国,全国,170,66,104
萧红故居,20230422,全国,全国,115,0,115
萧红故居,20230423,全国,全国,193,70,123
萧红故居,20230424,全国,全国,188,63,125
萧红故居,20230425,全国,全国,187,70,117
萧红故居,20230426,全国,全国,184,61,123
萧红故居,20230427,全国,全国,171,66,105
萧红故居,20230428,全国,全国,99,0,99
萧红故居,20230429,全国,全国,155,0,155
萧红故居,20230430,全国,全国,229,59,170
萧红故居,20230501,全国,全国,199,0,199
萧红故居,20230502,全国,全国,182,0,182
萧红故居,20230503,全国,全国,141,0,141
萧红故居,20230504,全国,全国,152,61,91
萧红故居,20230505,全国,全国,163,59,104
萧红故居,20230506,全国,全国,86,0,86
萧红故居,20230507,全国,全国,86,0,86
萧红故居,20230508,全国,全国,158,63,95
萧红故居,20230509,全国,全国,161,61,100
萧红故居,20230510,全国,全国,174,61,113
萧红故居,20230511,全国,全国,148,74,74
萧红故居,20230512,全国,全国,157,66,91
萧红故居,20230513,全国,全国,87,0,87
萧红故居,20230514,全国,全国,99,0,99
萧红故居,20230515,全国,全国,152,66,86
萧红故居,20230516,全国,全国,150,59,91
萧红故居,20230517,全国,全国,156,61,95
萧红故居,20230518,全国,全国,156,61,95
萧红故居,20230519,全国,全国,158,59,99
萧红故居,20230520,全国,全国,154,59,95
萧红故居,20230521,全国,全国,84,0,84
萧红故居,20230522,全国,全国,152,59,93
萧红故居,20230523,全国,全国,93,0,93
萧红故居,20230524,全国,全国,148,59,89
萧红故居,20230525,全国,全国,170,61,109
萧红故居,20230526,全国,全国,153,66,87
萧红故居,20230527,全国,全国,154,61,93
萧红故居,20230528,全国,全国,174,61,113
萧红故居,20230529,全国,全国,155,66,89
萧红故居,20230530,全国,全国,144,61,83
萧红故居,20230531,全国,全国,84,0,84
萧红故居,20230601,全国,全国,102,0,102
萧红故居,20230602,全国,全国,89,0,89
萧红故居,20230603,全国,全国,169,61,108
萧红故居,20230604,全国,全国,164,68,96
萧红故居,20230605,全国,全国,93,0,93
萧红故居,20230606,全国,全国,93,0,93
萧红故居,20230607,全国,全国,150,59,91
萧红故居,20230608,全国,全国,73,0,73
萧红故居,20230609,全国,全国,148,61,87
萧红故居,20230610,全国,全国,95,0,95
萧红故居,20230611,全国,全国,78,0,78
萧红故居,20230612,全国,全国,87,0,87
萧红故居,20230613,全国,全国,97,0,97
萧红故居,20230614,全国,全国,140,61,79
萧红故居,20230615,全国,全国,87,0,87
萧红故居,20230616,全国,全国,146,66,80
萧红故居,20230617,全国,全国,145,59,86
萧红故居,20230618,全国,全国,110,0,110
萧红故居,20230619,全国,全国,142,63,79
萧红故居,20230620,全国,全国,152,61,91
萧红故居,20230621,全国,全国,112,0,112
萧红故居,20230622,全国,全国,141,0,141
萧红故居,20230623,全国,全国,130,0,130
萧红故居,20230624,全国,全国,216,61,155
萧红故居,20230625,全国,全国,173,63,110
萧红故居,20230626,全国,全国,192,64,128
萧红故居,20230627,全国,全国,221,70,151
萧红故居,20230628,全国,全国,180,63,117
萧红故居,20230629,全国,全国,157,64,93
萧红故居,20230630,全国,全国,106,0,106
萧红故居,20230701,全国,全国,172,59,113
萧红故居,20230702,全国,全国,153,61,92
萧红故居,20230703,全国,全国,152,59,93
萧红故居,20230704,全国,全国,104,0,104
萧红故居,20230705,全国,全国,89,0,89
萧红故居,20230706,全国,全国,157,61,96
萧红故居,20230707,全国,全国,168,64,104
萧红故居,20230708,全国,全国,121,0,121
萧红故居,20230709,全国,全国,105,0,105
萧红故居,20230710,全国,全国,161,61,100
萧红故居,20230711,全国,全国,184,63,121
萧红故居,20230712,全国,全国,160,61,99
萧红故居,20230713,全国,全国,197,61,136
萧红故居,20230714,全国,全国,173,64,109
萧红故居,20230715,全国,全国,169,61,108
萧红故居,20230716,全国,全国,173,63,110
萧红故居,20230717,全国,全国,91,0,91
萧红故居,20230718,全国,全国,119,0,119
萧红故居,20230719,全国,全国,176,59,117
萧红故居,20230720,全国,全国,163,59,104
萧红故居,20230721,全国,全国,200,70,130
萧红故居,20230722,全国,全国,200,61,139
萧红故居,20230723,全国,全国,191,61,130
萧红故居,20230724,全国,全国,157,64,93
萧红故居,20230725,全国,全国,189,59,130
萧红故居,20230726,全国,全国,188,63,125
萧红故居,20230727,全国,全国,175,63,112
萧红故居,20230728,全国,全国,176,61,115
萧红故居,20230729,全国,全国,134,0,134
萧红故居,20230730,全国,全国,132,0,132
萧红故居,20230731,全国,全国,163,59,104
萧红故居,20230801,全国,全国,202,59,143
萧红故居,20230802,全国,全国,95,0,95
萧红故居,20230803,全国,全国,106,0,106
萧红故居,20230804,全国,全国,173,63,110
萧红故居,20230805,全国,全国,198,59,139
萧红故居,20230806,全国,全国,212,63,149
萧红故居,20230807,全国,全国,174,66,108
萧红故居,20230808,全国,全国,115,0,115
萧红故居,20230809,全国,全国,197,66,131
萧红故居,20230810,全国,全国,118,0,118
萧红故居,20230811,全国,全国,108,0,108
萧红故居,20230812,全国,全国,100,0,100
萧红故居,20230813,全国,全国,167,59,108
萧红故居,20230814,全国,全国,128,0,128
萧红故居,20230815,全国,全国,176,63,113
萧红故居,20230816,全国,全国,173,63,110
萧红故居,20230817,全国,全国,187,61,126
萧红故居,20230818,全国,全国,167,59,108
萧红故居,20230819,全国,全国,144,0,144
萧红故居,20230820,全国,全国,108,0,108
萧红故居,20230821,全国,全国,159,63,96
萧红故居,20230822,全国,全国,152,59,93
萧红故居,20230823,全国,全国,153,61,92
萧红故居,20230824,全国,全国,156,64,92
萧红故居,20230825,全国,全国,97,0,97
萧红故居,20230826,全国,全国,104,0,104
萧红故居,20230827,全国,全国,109,0,109
萧红故居,20230828,全国,全国,163,59,104
萧红故居,20230829,全国,全国,95,0,95
萧红故居,20230830,全国,全国,179,74,105
萧红故居,20230831,全国,全国,161,66,95
萧红故居,20230901,全国,全国,142,63,79
萧红故居,20230902,全国,全国,158,61,97
萧红故居,20230903,全国,全国,141,61,80
萧红故居,20230904,全国,全国,155,59,96
萧红故居,20230905,全国,全国,71,0,71
萧红故居,20230906,全国,全国,78,0,78
萧红故居,20230907,全国,全国,93,0,93
萧红故居,20230908,全国,全国,76,0,76
萧红故居,20230909,全国,全国,96,0,96
萧红故居,20230910,全国,全国,92,0,92
萧红故居,20230911,全国,全国,84,0,84
萧红故居,20230912,全国,全国,138,59,79
萧红故居,20230913,全国,全国,150,63,87
萧红故居,20230914,全国,全国,80,0,80
萧红故居,20230915,全国,全国,82,0,82
萧红故居,20230916,全国,全国,95,0,95
萧红故居,20230917,全国,全国,87,0,87
萧红故居,20230918,全国,全国,145,63,82
萧红故居,20230919,全国,全国,78,0,78
萧红故居,20230920,全国,全国,83,0,83
萧红故居,20230921,全国,全国,140,61,79
萧红故居,20230922,全国,全国,141,59,82
萧红故居,20230923,全国,全国,106,0,106
萧红故居,20230924,全国,全国,143,61,82
萧红故居,20230925,全国,全国,156,63,93
萧红故居,20230926,全国,全国,83,0,83
萧红故居,20230927,全国,全国,104,0,104
萧红故居,20230928,全国,全国,172,63,109
萧红故居,20230929,全国,全国,105,0,105
萧红故居,20230930,全国,全国,102,0,102
萧红故居,20231001,全国,全国,185,59,126
萧红故居,20231002,全国,全国,163,0,163
萧红故居,20231003,全国,全国,210,66,144
萧红故居,20231004,全国,全国,112,0,112
萧红故居,20231005,全国,全国,113,0,113
萧红故居,20231006,全国,全国,168,59,109
萧红故居,20231007,全国,全国,154,61,93
萧红故居,20231008,全国,全国,151,59,92
萧红故居,20231009,全国,全国,152,70,82
萧红故居,20231010,全国,全国,139,63,76
萧红故居,20231011,全国,全国,93,0,93
萧红故居,20231012,全国,全国,139,59,80
萧红故居,20231013,全国,全国,87,0,87
萧红故居,20231014,全国,全国,96,0,96
萧红故居,20231015,全国,全国,71,0,71
萧红故居,20231016,全国,全国,74,0,74
萧红故居,20231017,全国,全国,139,63,76
萧红故居,20231018,全国,全国,150,68,82
萧红故居,20231019,全国,全国,141,59,82
萧红故居,20231020,全国,全国,65,0,65
萧红故居,20231021,全国,全国,78,0,78
萧红故居,20231022,全国,全国,135,59,76
萧红故居,20231023,全国,全国,130,59,71
萧红故居,20231024,全国,全国,76,0,76
萧红故居,20231025,全国,全国,0,0,0
萧红故居,20231026,全国,全国,87,0,87
萧红故居,20231027,全国,全国,71,0,71
萧红故居,20231028,全国,全国,84,0,84
萧红故居,20231029,全国,全国,70,0,70
萧红故居,20231030,全国,全国,133,63,70
萧红故居,20231031,全国,全国,129,59,70
萧红故居,20231101,全国,全国,70,0,70
萧红故居,20231102,全国,全国,125,59,66
萧红故居,20231103,全国,全国,82,0,82
萧红故居,20231104,全国,全国,73,0,73
萧红故居,20231105,全国,全国,82,0,82
萧红故居,20231106,全国,全国,122,59,63
萧红故居,20231107,全国,全国,132,66,66
萧红故居,20231108,全国,全国,129,66,63
萧红故居,20231109,全国,全国,69,0,69
萧红故居,20231110,全国,全国,71,0,71
萧红故居,20231111,全国,全国,83,0,83
萧红故居,20231112,全国,全国,69,0,69
萧红故居,20231113,全国,全国,131,61,70
萧红故居,20231114,全国,全国,150,61,89
萧红故居,20231115,全国,全国,130,61,69
萧红故居,20231116,全国,全国,66,0,66
萧红故居,20231117,全国,全国,133,59,74
萧红故居,20231118,全国,全国,73,0,73
萧红故居,20231119,全国,全国,139,59,80
萧红故居,20231120,全国,全国,146,59,87
萧红故居,20231121,全国,全国,150,59,91
萧红故居,20231122,全国,全国,76,0,76
萧红故居,20231123,全国,全国,76,0,76
萧红故居,20231124,全国,全国,76,0,76
萧红故居,20231125,全国,全国,74,0,74
萧红故居,20231126,全国,全国,128,59,69
萧红故居,20231127,全国,全国,128,61,67
萧红故居,20231128,全国,全国,126,61,65
萧红故居,20231129,全国,全国,128,61,67
萧红故居,20231130,全国,全国,70,0,70
萧红故居,20231201,全国,全国,132,63,69
萧红故居,20231202,全国,全国,73,0,73
萧红故居,20231203,全国,全国,86,0,86
萧红故居,20231204,全国,全国,135,61,74
萧红故居,20231205,全国,全国,78,0,78
萧红故居,20231206,全国,全国,74,0,74
萧红故居,20231207,全国,全国,69,0,69
萧红故居,20231208,全国,全国,137,59,78
萧红故居,20231209,全国,全国,66,0,66
萧红故居,20231210,全国,全国,80,0,80
萧红故居,20231211,全国,全国,61,0,61
萧红故居,20231212,全国,全国,138,59,79
萧红故居,20231213,全国,全国,73,0,73
萧红故居,20231214,全国,全国,132,61,71
萧红故居,20231215,全国,全国,70,0,70
萧红故居,20231216,全国,全国,79,0,79
萧红故居,20231217,全国,全国,138,64,74
萧红故居,20231218,全国,全国,149,63,86
萧红故居,20231219,全国,全国,122,59,63
萧红故居,20231220,全国,全国,76,0,76
萧红故居,20231221,全国,全国,128,59,69
萧红故居,20231222,全国,全国,73,0,73
萧红故居,20231223,全国,全国,78,0,78
萧红故居,20231224,全国,全国,134,63,71
萧红故居,20231225,全国,全国,65,0,65
萧红故居,20231226,全国,全国,67,0,67
萧红故居,20231227,全国,全国,145,59,86
萧红故居,20231228,全国,全国,84,0,84
萧红故居,20231229,全国,全国,80,0,80
萧红故居,20231230,全国,全国,100,0,100
萧红故居,20231231,全国,全国,78,0,78
萧红故居,20240101,全国,全国,74,0,74
萧红故居,20240102,全国,全国,69,0,69
萧红故居,20240103,全国,全国,70,0,70
萧红故居,20240104,全国,全国,148,61,87
萧红故居,20240105,全国,全国,150,64,86
萧红故居,20240106,全国,全国,146,59,87
萧红故居,20240107,全国,全国,80,0,80
萧红故居,20240108,全国,全国,153,61,92
萧红故居,20240109,全国,全国,86,0,86
萧红故居,20240110,全国,全国,143,61,82
萧红故居,20240111,全国,全国,80,0,80
萧红故居,20240112,全国,全国,143,61,82
萧红故居,20240113,全国,全国,73,0,73
萧红故居,20240114,全国,全国,91,0,91
萧红故居,20240115,全国,全国,91,0,91
萧红故居,20240116,全国,全国,89,0,89
萧红故居,20240117,全国,全国,150,63,87
萧红故居,20240118,全国,全国,144,61,83
萧红故居,20240119,全国,全国,74,0,74
萧红故居,20240120,全国,全国,143,59,84
萧红故居,20240121,全国,全国,104,0,104
萧红故居,20240122,全国,全国,160,64,96
萧红故居,20240123,全国,全国,153,66,87
萧红故居,20240124,全国,全国,141,59,82
萧红故居,20240125,全国,全国,145,59,86
萧红故居,20240126,全国,全国,95,0,95
萧红故居,20240127,全国,全国,105,0,105
萧红故居,20240128,全国,全国,92,0,92
萧红故居,20240129,全国,全国,141,63,78
萧红故居,20240130,全国,全国,92,0,92
萧红故居,20240131,全国,全国,92,0,92
萧红故居,20240201,全国,全国,138,59,79
萧红故居,20240202,全国,全国,80,0,80
萧红故居,20240203,全国,全国,130,61,69
萧红故居,20240204,全国,全国,142,59,83
萧红故居,20240205,全国,全国,78,0,78
萧红故居,20240206,全国,全国,141,59,82
萧红故居,20240207,全国,全国,141,59,82
萧红故居,20240208,全国,全国,130,59,71
萧红故居,20240209,全国,全国,78,0,78
萧红故居,20240210,全国,全国,66,0,66
萧红故居,20240211,全国,全国,89,0,89
萧红故居,20240212,全国,全国,93,0,93
萧红故居,20240213,全国,全国,104,0,104
萧红故居,20240214,全国,全国,112,0,112
萧红故居,20240215,全国,全国,168,59,109
萧红故居,20240216,全国,全国,93,0,93
萧红故居,20240217,全国,全国,91,0,91
萧红故居,20240218,全国,全国,87,0,87
萧红故居,20240219,全国,全国,78,0,78
萧红故居,20240220,全国,全国,83,0,83
萧红故居,20240221,全国,全国,169,63,106
萧红故居,20240222,全国,全国,167,61,106
萧红故居,20240223,全国,全国,157,66,91
萧红故居,20240224,全国,全国,145,59,86
萧红故居,20240225,全国,全国,161,61,100
萧红故居,20240226,全国,全国,172,59,113
萧红故居,20240227,全国,全国,196,68,128
萧红故居,20240228,全国,全国,246,72,174
萧红故居,20240229,全国,全国,257,70,187
萧红故居,20240301,全国,全国,183,64,119
萧红故居,20240302,全国,全国,108,0,108
萧红故居,20240303,全国,全国,170,61,109
萧红故居,20240304,全国,全国,164,68,96
萧红故居,20240305,全国,全国,93,0,93
萧红故居,20240306,全国,全国,160,68,92
萧红故居,20240307,全国,全国,137,61,76
萧红故居,20240308,全国,全国,83,0,83
萧红故居,20240309,全国,全国,96,0,96
萧红故居,20240310,全国,全国,163,59,104
萧红故居,20240311,全国,全国,141,59,82
萧红故居,20240312,全国,全国,86,0,86
萧红故居,20240313,全国,全国,133,59,74
萧红故居,20240314,全国,全国,151,59,92
萧红故居,20240315,全国,全国,73,0,73
萧红故居,20240316,全国,全国,82,0,82
萧红故居,20240317,全国,全国,110,0,110
萧红故居,20240318,全国,全国,89,0,89
萧红故居,20240319,全国,全国,87,0,87
萧红故居,20240320,全国,全国,139,61,78
萧红故居,20240321,全国,全国,132,59,73
萧红故居,20240322,全国,全国,141,61,80
萧红故居,20240323,全国,全国,78,0,78
萧红故居,20240324,全国,全国,162,63,99
萧红故居,20240325,全国,全国,142,59,83
萧红故居,20240326,全国,全国,80,0,80
萧红故居,20240327,全国,全国,152,59,93
萧红故居,20240328,全国,全国,133,63,70
萧红故居,20240329,全国,全国,141,63,78
萧红故居,20240330,全国,全国,83,0,83
萧红故居,20240331,全国,全国,99,0,99
萧红故居,20240401,全国,全国,138,64,74
萧红故居,20240402,全国,全国,153,64,89
萧红故居,20240403,全国,全国,110,0,110
萧红故居,20240404,全国,全国,220,63,157
萧红故居,20240405,全国,全国,151,0,151
萧红故居,20240406,全国,全国,152,59,93
萧红故居,20240407,全国,全国,78,0,78
萧红故居,20240408,全国,全国,150,61,89
萧红故居,20240409,全国,全国,129,59,70
萧红故居,20240410,全国,全国,83,0,83
萧红故居,20240411,全国,全国,132,61,71
萧红故居,20240412,全国,全国,151,59,92
萧红故居,20240413,全国,全国,167,59,108
萧红故居,20240414,全国,全国,143,61,82
萧红故居,20240415,全国,全国,146,63,83
萧红故居,20240416,全国,全国,144,61,83
萧红故居,20240417,全国,全国,145,61,84
萧红故居,20240418,全国,全国,152,61,91
萧红故居,20240419,全国,全国,156,57,99
萧红故居,20240420,全国,全国,156,61,95
萧红故居,20240421,全国,全国,162,63,99
萧红故居,20240422,全国,全国,136,63,73
萧红故居,20240423,全国,全国,86,0,86
萧红故居,20240424,全国,全国,150,57,93
萧红故居,20240425,全国,全国,152,61,91
萧红故居,20240426,全国,全国,154,59,95
萧红故居,20240427,全国,全国,154,57,97
萧红故居,20240428,全国,全国,159,66,93
萧红故居,20240429,全国,全国,155,64,91
萧红故居,20240430,全国,全国,161,66,95
萧红故居,20240501,全国,全国,134,0,134
萧红故居,20240502,全国,全国,155,0,155
萧红故居,20240503,全国,全国,187,59,128
萧红故居,20240504,全国,全国,131,0,131
萧红故居,20240505,全国,全国,182,57,125
萧红故居,20240506,全国,全国,173,64,109
萧红故居,20240507,全国,全国,152,59,93
萧红故居,20240508,全国,全国,137,63,74
萧红故居,20240509,全国,全国,140,57,83
萧红故居,20240510,全国,全国,144,66,78
