关键词,日期,省份,城市,PC+移动端,PC端,移动端
冰雪大世界,20220101,全国,全国,1027,114,913
冰雪大世界,20220102,全国,全国,993,129,864
冰雪大世界,20220103,全国,全国,986,142,844
冰雪大世界,20220104,全国,全国,1035,193,842
冰雪大世界,20220105,全国,全国,966,166,800
冰雪大世界,20220106,全国,全国,956,176,780
冰雪大世界,20220107,全国,全国,845,162,683
冰雪大世界,20220108,全国,全国,879,97,782
冰雪大世界,20220109,全国,全国,849,114,735
冰雪大世界,20220110,全国,全国,847,163,684
冰雪大世界,20220111,全国,全国,776,148,628
冰雪大世界,20220112,全国,全国,754,157,597
冰雪大世界,20220113,全国,全国,836,170,666
冰雪大世界,20220114,全国,全国,826,168,658
冰雪大世界,20220115,全国,全国,790,95,695
冰雪大世界,20220116,全国,全国,730,102,628
冰雪大世界,20220117,全国,全国,712,172,540
冰雪大世界,20220118,全国,全国,680,127,553
冰雪大世界,20220119,全国,全国,600,129,471
冰雪大世界,20220120,全国,全国,655,159,496
冰雪大世界,20220121,全国,全国,727,118,609
冰雪大世界,20220122,全国,全国,727,118,609
冰雪大世界,20220123,全国,全国,715,95,620
冰雪大世界,20220124,全国,全国,654,108,546
冰雪大世界,20220125,全国,全国,617,110,507
冰雪大世界,20220126,全国,全国,656,125,531
冰雪大世界,20220127,全国,全国,655,131,524
冰雪大世界,20220128,全国,全国,690,152,538
冰雪大世界,20220129,全国,全国,696,125,571
冰雪大世界,20220130,全国,全国,568,93,475
冰雪大世界,20220131,全国,全国,592,70,522
冰雪大世界,20220201,全国,全国,898,91,807
冰雪大世界,20220202,全国,全国,974,106,868
冰雪大世界,20220203,全国,全国,965,85,880
冰雪大世界,20220204,全国,全国,983,91,892
冰雪大世界,20220205,全国,全国,975,106,869
冰雪大世界,20220206,全国,全国,938,97,841
冰雪大世界,20220207,全国,全国,918,166,752
冰雪大世界,20220208,全国,全国,855,150,705
冰雪大世界,20220209,全国,全国,757,150,607
冰雪大世界,20220210,全国,全国,813,161,652
冰雪大世界,20220211,全国,全国,794,157,637
冰雪大世界,20220212,全国,全国,747,104,643
冰雪大世界,20220213,全国,全国,776,106,670
冰雪大世界,20220214,全国,全国,742,165,577
冰雪大世界,20220215,全国,全国,842,161,681
冰雪大世界,20220216,全国,全国,631,121,510
冰雪大世界,20220217,全国,全国,627,154,473
冰雪大世界,20220218,全国,全国,647,151,496
冰雪大世界,20220219,全国,全国,604,99,505
冰雪大世界,20220220,全国,全国,633,93,540
冰雪大世界,20220221,全国,全国,544,137,407
冰雪大世界,20220222,全国,全国,553,139,414
冰雪大世界,20220223,全国,全国,573,123,450
冰雪大世界,20220224,全国,全国,623,133,490
冰雪大世界,20220225,全国,全国,576,118,458
冰雪大世界,20220226,全国,全国,572,83,489
冰雪大世界,20220227,全国,全国,531,83,448
冰雪大世界,20220228,全国,全国,430,99,331
冰雪大世界,20220301,全国,全国,356,120,236
冰雪大世界,20220302,全国,全国,314,99,215
冰雪大世界,20220303,全国,全国,295,87,208
冰雪大世界,20220304,全国,全国,287,95,192
冰雪大世界,20220305,全国,全国,312,93,219
冰雪大世界,20220306,全国,全国,300,68,232
冰雪大世界,20220307,全国,全国,290,95,195
冰雪大世界,20220308,全国,全国,296,91,205
冰雪大世界,20220309,全国,全国,278,97,181
冰雪大世界,20220310,全国,全国,271,87,184
冰雪大世界,20220311,全国,全国,285,104,181
冰雪大世界,20220312,全国,全国,259,76,183
冰雪大世界,20220313,全国,全国,265,70,195
冰雪大世界,20220314,全国,全国,241,83,158
冰雪大世界,20220315,全国,全国,282,102,180
冰雪大世界,20220316,全国,全国,243,91,152
冰雪大世界,20220317,全国,全国,291,102,189
冰雪大世界,20220318,全国,全国,272,99,173
冰雪大世界,20220319,全国,全国,264,87,177
冰雪大世界,20220320,全国,全国,244,76,168
冰雪大世界,20220321,全国,全国,248,80,168
冰雪大世界,20220322,全国,全国,276,91,185
冰雪大世界,20220323,全国,全国,271,74,197
冰雪大世界,20220324,全国,全国,246,85,161
冰雪大世界,20220325,全国,全国,254,91,163
冰雪大世界,20220326,全国,全国,254,83,171
冰雪大世界,20220327,全国,全国,261,78,183
冰雪大世界,20220328,全国,全国,233,82,151
冰雪大世界,20220329,全国,全国,236,93,143
冰雪大世界,20220330,全国,全国,248,78,170
冰雪大世界,20220331,全国,全国,246,89,157
冰雪大世界,20220401,全国,全国,225,76,149
冰雪大世界,20220402,全国,全国,198,64,134
冰雪大世界,20220403,全国,全国,217,72,145
冰雪大世界,20220404,全国,全国,226,66,160
冰雪大世界,20220405,全国,全国,224,70,154
冰雪大世界,20220406,全国,全国,241,82,159
冰雪大世界,20220407,全国,全国,242,87,155
冰雪大世界,20220408,全国,全国,227,72,155
冰雪大世界,20220409,全国,全国,250,74,176
冰雪大世界,20220410,全国,全国,252,70,182
冰雪大世界,20220411,全国,全国,224,76,148
冰雪大世界,20220412,全国,全国,240,80,160
冰雪大世界,20220413,全国,全国,225,74,151
冰雪大世界,20220414,全国,全国,235,68,167
冰雪大世界,20220415,全国,全国,229,70,159
冰雪大世界,20220416,全国,全国,257,74,183
冰雪大世界,20220417,全国,全国,255,70,185
冰雪大世界,20220418,全国,全国,236,72,164
冰雪大世界,20220419,全国,全国,247,89,158
冰雪大世界,20220420,全国,全国,253,102,151
冰雪大世界,20220421,全国,全国,254,80,174
冰雪大世界,20220422,全国,全国,260,93,167
冰雪大世界,20220423,全国,全国,240,66,174
冰雪大世界,20220424,全国,全国,248,78,170
冰雪大世界,20220425,全国,全国,238,83,155
冰雪大世界,20220426,全国,全国,263,83,180
冰雪大世界,20220427,全国,全国,254,80,174
冰雪大世界,20220428,全国,全国,236,63,173
冰雪大世界,20220429,全国,全国,223,72,151
冰雪大世界,20220430,全国,全国,234,63,171
冰雪大世界,20220501,全国,全国,231,63,168
冰雪大世界,20220502,全国,全国,247,68,179
冰雪大世界,20220503,全国,全国,236,66,170
冰雪大世界,20220504,全国,全国,263,74,189
冰雪大世界,20220505,全国,全国,206,74,132
冰雪大世界,20220506,全国,全国,223,74,149
冰雪大世界,20220507,全国,全国,221,72,149
冰雪大世界,20220508,全国,全国,228,63,165
冰雪大世界,20220509,全国,全国,255,101,154
冰雪大世界,20220510,全国,全国,243,85,158
冰雪大世界,20220511,全国,全国,240,82,158
冰雪大世界,20220512,全国,全国,238,87,151
冰雪大世界,20220513,全国,全国,241,82,159
冰雪大世界,20220514,全国,全国,261,76,185
冰雪大世界,20220515,全国,全国,240,66,174
冰雪大世界,20220516,全国,全国,235,80,155
冰雪大世界,20220517,全国,全国,242,87,155
冰雪大世界,20220518,全国,全国,247,80,167
冰雪大世界,20220519,全国,全国,219,78,141
冰雪大世界,20220520,全国,全国,222,70,152
冰雪大世界,20220521,全国,全国,215,68,147
冰雪大世界,20220522,全国,全国,258,74,184
冰雪大世界,20220523,全国,全国,245,78,167
冰雪大世界,20220524,全国,全国,244,83,161
冰雪大世界,20220525,全国,全国,253,76,177
冰雪大世界,20220526,全国,全国,258,95,163
冰雪大世界,20220527,全国,全国,229,78,151
冰雪大世界,20220528,全国,全国,231,72,159
冰雪大世界,20220529,全国,全国,242,74,168
冰雪大世界,20220530,全国,全国,249,85,164
冰雪大世界,20220531,全国,全国,231,76,155
冰雪大世界,20220601,全国,全国,259,89,170
冰雪大世界,20220602,全国,全国,225,74,151
冰雪大世界,20220603,全国,全国,257,72,185
冰雪大世界,20220604,全国,全国,259,72,187
冰雪大世界,20220605,全国,全国,258,80,178
冰雪大世界,20220606,全国,全国,227,83,144
冰雪大世界,20220607,全国,全国,264,97,167
冰雪大世界,20220608,全国,全国,268,83,185
冰雪大世界,20220609,全国,全国,8154,2423,5731
冰雪大世界,20220610,全国,全国,2467,831,1636
冰雪大世界,20220611,全国,全国,685,108,577
冰雪大世界,20220612,全国,全国,390,89,301
冰雪大世界,20220613,全国,全国,465,131,334
冰雪大世界,20220614,全国,全国,365,101,264
冰雪大世界,20220615,全国,全国,281,83,198
冰雪大世界,20220616,全国,全国,288,95,193
冰雪大世界,20220617,全国,全国,288,99,189
冰雪大世界,20220618,全国,全国,281,63,218
冰雪大世界,20220619,全国,全国,282,70,212
冰雪大世界,20220620,全国,全国,253,83,170
冰雪大世界,20220621,全国,全国,283,83,200
冰雪大世界,20220622,全国,全国,272,85,187
冰雪大世界,20220623,全国,全国,284,78,206
冰雪大世界,20220624,全国,全国,265,80,185
冰雪大世界,20220625,全国,全国,238,64,174
冰雪大世界,20220626,全国,全国,235,78,157
冰雪大世界,20220627,全国,全国,280,102,178
冰雪大世界,20220628,全国,全国,282,93,189
冰雪大世界,20220629,全国,全国,279,112,167
冰雪大世界,20220630,全国,全国,253,82,171
冰雪大世界,20220701,全国,全国,284,89,195
冰雪大世界,20220702,全国,全国,259,70,189
冰雪大世界,20220703,全国,全国,290,85,205
冰雪大世界,20220704,全国,全国,264,87,177
冰雪大世界,20220705,全国,全国,268,101,167
冰雪大世界,20220706,全国,全国,253,76,177
冰雪大世界,20220707,全国,全国,270,97,173
冰雪大世界,20220708,全国,全国,259,85,174
冰雪大世界,20220709,全国,全国,270,70,200
冰雪大世界,20220710,全国,全国,263,64,199
冰雪大世界,20220711,全国,全国,266,82,184
冰雪大世界,20220712,全国,全国,284,95,189
冰雪大世界,20220713,全国,全国,267,87,180
冰雪大世界,20220714,全国,全国,272,87,185
冰雪大世界,20220715,全国,全国,262,72,190
冰雪大世界,20220716,全国,全国,251,80,171
冰雪大世界,20220717,全国,全国,286,80,206
冰雪大世界,20220718,全国,全国,284,104,180
冰雪大世界,20220719,全国,全国,282,89,193
冰雪大世界,20220720,全国,全国,269,85,184
冰雪大世界,20220721,全国,全国,297,101,196
冰雪大世界,20220722,全国,全国,295,87,208
冰雪大世界,20220723,全国,全国,289,64,225
冰雪大世界,20220724,全国,全国,307,76,231
冰雪大世界,20220725,全国,全国,294,89,205
冰雪大世界,20220726,全国,全国,274,68,206
冰雪大世界,20220727,全国,全国,281,82,199
冰雪大世界,20220728,全国,全国,268,76,192
冰雪大世界,20220729,全国,全国,275,78,197
冰雪大世界,20220730,全国,全国,314,66,248
冰雪大世界,20220731,全国,全国,304,80,224
冰雪大世界,20220801,全国,全国,263,74,189
冰雪大世界,20220802,全国,全国,282,85,197
冰雪大世界,20220803,全国,全国,300,97,203
冰雪大世界,20220804,全国,全国,301,97,204
冰雪大世界,20220805,全国,全国,302,97,205
冰雪大世界,20220806,全国,全国,276,61,215
冰雪大世界,20220807,全国,全国,283,61,222
冰雪大世界,20220808,全国,全国,296,97,199
冰雪大世界,20220809,全国,全国,333,85,248
冰雪大世界,20220810,全国,全国,310,89,221
冰雪大世界,20220811,全国,全国,309,95,214
冰雪大世界,20220812,全国,全国,292,91,201
冰雪大世界,20220813,全国,全国,293,66,227
冰雪大世界,20220814,全国,全国,301,63,238
冰雪大世界,20220815,全国,全国,302,87,215
冰雪大世界,20220816,全国,全国,297,80,217
冰雪大世界,20220817,全国,全国,292,80,212
冰雪大世界,20220818,全国,全国,292,83,209
冰雪大世界,20220819,全国,全国,329,101,228
冰雪大世界,20220820,全国,全国,275,76,199
冰雪大世界,20220821,全国,全国,281,70,211
冰雪大世界,20220822,全国,全国,299,91,208
冰雪大世界,20220823,全国,全国,296,101,195
冰雪大世界,20220824,全国,全国,306,87,219
冰雪大世界,20220825,全国,全国,320,116,204
冰雪大世界,20220826,全国,全国,297,85,212
冰雪大世界,20220827,全国,全国,267,66,201
冰雪大世界,20220828,全国,全国,267,66,201
冰雪大世界,20220829,全国,全国,297,89,208
冰雪大世界,20220830,全国,全国,261,99,162
冰雪大世界,20220831,全国,全国,265,80,185
冰雪大世界,20220901,全国,全国,259,80,179
冰雪大世界,20220902,全国,全国,247,85,162
冰雪大世界,20220903,全国,全国,252,78,174
冰雪大世界,20220904,全国,全国,241,76,165
冰雪大世界,20220905,全国,全国,268,89,179
冰雪大世界,20220906,全国,全国,258,76,182
冰雪大世界,20220907,全国,全国,301,82,219
冰雪大世界,20220908,全国,全国,283,106,177
冰雪大世界,20220909,全国,全国,278,74,204
冰雪大世界,20220910,全国,全国,274,63,211
冰雪大世界,20220911,全国,全国,317,74,243
冰雪大世界,20220912,全国,全国,307,76,231
冰雪大世界,20220913,全国,全国,302,97,205
冰雪大世界,20220914,全国,全国,332,104,228
冰雪大世界,20220915,全国,全国,312,101,211
冰雪大世界,20220916,全国,全国,291,87,204
冰雪大世界,20220917,全国,全国,261,72,189
冰雪大世界,20220918,全国,全国,356,76,280
冰雪大世界,20220919,全国,全国,315,97,218
冰雪大世界,20220920,全国,全国,307,95,212
冰雪大世界,20220921,全国,全国,300,102,198
冰雪大世界,20220922,全国,全国,274,97,177
冰雪大世界,20220923,全国,全国,297,95,202
冰雪大世界,20220924,全国,全国,291,82,209
冰雪大世界,20220925,全国,全国,274,74,200
冰雪大世界,20220926,全国,全国,289,91,198
冰雪大世界,20220927,全国,全国,302,104,198
冰雪大世界,20220928,全国,全国,283,82,201
冰雪大世界,20220929,全国,全国,273,80,193
冰雪大世界,20220930,全国,全国,298,99,199
冰雪大世界,20221001,全国,全国,297,80,217
冰雪大世界,20221002,全国,全国,306,74,232
冰雪大世界,20221003,全国,全国,312,70,242
冰雪大世界,20221004,全国,全国,305,70,235
冰雪大世界,20221005,全国,全国,325,83,242
冰雪大世界,20221006,全国,全国,345,95,250
冰雪大世界,20221007,全国,全国,326,83,243
冰雪大世界,20221008,全国,全国,318,97,221
冰雪大世界,20221009,全国,全国,330,101,229
冰雪大世界,20221010,全国,全国,326,104,222
冰雪大世界,20221011,全国,全国,333,116,217
冰雪大世界,20221012,全国,全国,311,106,205
冰雪大世界,20221013,全国,全国,321,97,224
冰雪大世界,20221014,全国,全国,319,101,218
冰雪大世界,20221015,全国,全国,290,91,199
冰雪大世界,20221016,全国,全国,312,80,232
冰雪大世界,20221017,全国,全国,378,116,262
冰雪大世界,20221018,全国,全国,388,127,261
冰雪大世界,20221019,全国,全国,342,118,224
冰雪大世界,20221020,全国,全国,347,120,227
冰雪大世界,20221021,全国,全国,364,116,248
冰雪大世界,20221022,全国,全国,335,82,253
冰雪大世界,20221023,全国,全国,340,83,257
冰雪大世界,20221024,全国,全国,318,104,214
冰雪大世界,20221025,全国,全国,330,116,214
冰雪大世界,20221026,全国,全国,368,104,264
冰雪大世界,20221027,全国,全国,374,142,232
冰雪大世界,20221028,全国,全国,342,97,245
冰雪大世界,20221029,全国,全国,317,85,232
冰雪大世界,20221030,全国,全国,303,64,239
冰雪大世界,20221031,全国,全国,340,99,241
冰雪大世界,20221101,全国,全国,315,87,228
冰雪大世界,20221102,全国,全国,376,112,264
冰雪大世界,20221103,全国,全国,356,104,252
冰雪大世界,20221104,全国,全国,343,129,214
冰雪大世界,20221105,全国,全国,333,74,259
冰雪大世界,20221106,全国,全国,343,95,248
冰雪大世界,20221107,全国,全国,336,83,253
冰雪大世界,20221108,全国,全国,359,106,253
冰雪大世界,20221109,全国,全国,431,121,310
冰雪大世界,20221110,全国,全国,578,183,395
冰雪大世界,20221111,全国,全国,416,118,298
冰雪大世界,20221112,全国,全国,466,101,365
冰雪大世界,20221113,全国,全国,459,78,381
冰雪大世界,20221114,全国,全国,432,127,305
冰雪大世界,20221115,全国,全国,428,125,303
冰雪大世界,20221116,全国,全国,452,125,327
冰雪大世界,20221117,全国,全国,481,127,354
冰雪大世界,20221118,全国,全国,493,131,362
冰雪大世界,20221119,全国,全国,395,83,312
冰雪大世界,20221120,全国,全国,395,76,319
冰雪大世界,20221121,全国,全国,435,114,321
冰雪大世界,20221122,全国,全国,514,148,366
冰雪大世界,20221123,全国,全国,461,144,317
冰雪大世界,20221124,全国,全国,457,104,353
冰雪大世界,20221125,全国,全国,473,120,353
冰雪大世界,20221126,全国,全国,457,83,374
冰雪大世界,20221127,全国,全国,456,97,359
冰雪大世界,20221128,全国,全国,567,123,444
冰雪大世界,20221129,全国,全国,661,140,521
冰雪大世界,20221130,全国,全国,653,170,483
冰雪大世界,20221201,全国,全国,669,168,501
冰雪大世界,20221202,全国,全国,582,152,430
冰雪大世界,20221203,全国,全国,617,121,496
冰雪大世界,20221204,全国,全国,655,104,551
冰雪大世界,20221205,全国,全国,813,182,631
冰雪大世界,20221206,全国,全国,771,158,613
冰雪大世界,20221207,全国,全国,906,242,664
冰雪大世界,20221208,全国,全国,1108,253,855
冰雪大世界,20221209,全国,全国,947,213,734
冰雪大世界,20221210,全国,全国,813,142,671
冰雪大世界,20221211,全国,全国,949,146,803
冰雪大世界,20221212,全国,全国,893,220,673
冰雪大世界,20221213,全国,全国,767,186,581
冰雪大世界,20221214,全国,全国,850,198,652
冰雪大世界,20221215,全国,全国,864,194,670
冰雪大世界,20221216,全国,全国,829,179,650
冰雪大世界,20221217,全国,全国,1021,179,842
冰雪大世界,20221218,全国,全国,811,151,660
冰雪大世界,20221219,全国,全国,772,201,571
冰雪大世界,20221220,全国,全国,729,175,554
冰雪大世界,20221221,全国,全国,765,161,604
冰雪大世界,20221222,全国,全国,782,162,620
冰雪大世界,20221223,全国,全国,789,187,602
冰雪大世界,20221224,全国,全国,782,127,655
冰雪大世界,20221225,全国,全国,858,148,710
冰雪大世界,20221226,全国,全国,947,205,742
冰雪大世界,20221227,全国,全国,976,233,743
冰雪大世界,20221228,全国,全国,1062,218,844
冰雪大世界,20221229,全国,全国,1056,226,830
冰雪大世界,20221230,全国,全国,1096,233,863
冰雪大世界,20221231,全国,全国,1068,159,909
冰雪大世界,20230101,全国,全国,1013,152,861
冰雪大世界,20230102,全国,全国,996,180,816
冰雪大世界,20230103,全国,全国,1118,268,850
冰雪大世界,20230104,全国,全国,1143,290,853
冰雪大世界,20230105,全国,全国,1206,316,890
冰雪大世界,20230106,全国,全国,1142,287,855
冰雪大世界,20230107,全国,全国,1041,182,859
冰雪大世界,20230108,全国,全国,1029,168,861
冰雪大世界,20230109,全国,全国,1134,270,864
冰雪大世界,20230110,全国,全国,1161,274,887
冰雪大世界,20230111,全国,全国,1161,264,897
冰雪大世界,20230112,全国,全国,1192,271,921
冰雪大世界,20230113,全国,全国,1153,256,897
冰雪大世界,20230114,全国,全国,1090,179,911
冰雪大世界,20230115,全国,全国,1091,163,928
冰雪大世界,20230116,全国,全国,1196,276,920
冰雪大世界,20230117,全国,全国,1160,256,904
冰雪大世界,20230118,全国,全国,1130,212,918
冰雪大世界,20230119,全国,全国,1080,193,887
冰雪大世界,20230120,全国,全国,1050,166,884
冰雪大世界,20230121,全国,全国,941,99,842
冰雪大世界,20230122,全国,全国,1050,102,948
冰雪大世界,20230123,全国,全国,1099,137,962
冰雪大世界,20230124,全国,全国,1126,142,984
冰雪大世界,20230125,全国,全国,1163,121,1042
冰雪大世界,20230126,全国,全国,1109,95,1014
冰雪大世界,20230127,全国,全国,1076,114,962
冰雪大世界,20230128,全国,全国,1186,233,953
冰雪大世界,20230129,全国,全国,1143,229,914
冰雪大世界,20230130,全国,全国,1129,229,900
冰雪大世界,20230131,全国,全国,1143,234,909
冰雪大世界,20230201,全国,全国,1105,218,887
冰雪大世界,20230202,全国,全国,1079,200,879
冰雪大世界,20230203,全国,全国,1101,197,904
冰雪大世界,20230204,全国,全国,1082,190,892
冰雪大世界,20230205,全国,全国,1028,137,891
冰雪大世界,20230206,全国,全国,1026,183,843
冰雪大世界,20230207,全国,全国,1042,201,841
冰雪大世界,20230208,全国,全国,978,212,766
冰雪大世界,20230209,全国,全国,1057,215,842
冰雪大世界,20230210,全国,全国,1034,176,858
冰雪大世界,20230211,全国,全国,979,139,840
冰雪大世界,20230212,全国,全国,889,154,735
冰雪大世界,20230213,全国,全国,853,175,678
冰雪大世界,20230214,全国,全国,779,166,613
冰雪大世界,20230215,全国,全国,773,155,618
冰雪大世界,20230216,全国,全国,806,175,631
冰雪大世界,20230217,全国,全国,820,175,645
冰雪大世界,20230218,全国,全国,776,89,687
冰雪大世界,20230219,全国,全国,740,112,628
冰雪大世界,20230220,全国,全国,686,154,532
冰雪大世界,20230221,全国,全国,664,152,512
冰雪大世界,20230222,全国,全国,636,137,499
冰雪大世界,20230223,全国,全国,679,155,524
冰雪大世界,20230224,全国,全国,674,146,528
冰雪大世界,20230225,全国,全国,660,93,567
冰雪大世界,20230226,全国,全国,535,123,412
冰雪大世界,20230227,全国,全国,408,110,298
冰雪大世界,20230228,全国,全国,415,146,269
冰雪大世界,20230301,全国,全国,388,131,257
冰雪大世界,20230302,全国,全国,361,114,247
冰雪大世界,20230303,全国,全国,369,121,248
冰雪大世界,20230304,全国,全国,370,89,281
冰雪大世界,20230305,全国,全国,354,87,267
冰雪大世界,20230306,全国,全国,330,125,205
冰雪大世界,20230307,全国,全国,331,114,217
冰雪大世界,20230308,全国,全国,323,91,232
冰雪大世界,20230309,全国,全国,269,85,184
冰雪大世界,20230310,全国,全国,275,83,192
冰雪大世界,20230311,全国,全国,297,82,215
冰雪大世界,20230312,全国,全国,315,91,224
冰雪大世界,20230313,全国,全国,323,104,219
冰雪大世界,20230314,全国,全国,307,95,212
冰雪大世界,20230315,全国,全国,295,108,187
冰雪大世界,20230316,全国,全国,310,99,211
冰雪大世界,20230317,全国,全国,278,83,195
冰雪大世界,20230318,全国,全国,271,78,193
冰雪大世界,20230319,全国,全国,300,82,218
冰雪大世界,20230320,全国,全国,282,97,185
冰雪大世界,20230321,全国,全国,301,131,170
冰雪大世界,20230322,全国,全国,307,120,187
冰雪大世界,20230323,全国,全国,259,85,174
冰雪大世界,20230324,全国,全国,256,82,174
冰雪大世界,20230325,全国,全国,291,85,206
冰雪大世界,20230326,全国,全国,281,80,201
冰雪大世界,20230327,全国,全国,283,85,198
冰雪大世界,20230328,全国,全国,286,93,193
冰雪大世界,20230329,全国,全国,273,89,184
冰雪大世界,20230330,全国,全国,276,99,177
冰雪大世界,20230331,全国,全国,259,85,174
冰雪大世界,20230401,全国,全国,244,74,170
冰雪大世界,20230402,全国,全国,268,83,185
冰雪大世界,20230403,全国,全国,282,102,180
冰雪大世界,20230404,全国,全国,306,101,205
冰雪大世界,20230405,全国,全国,280,80,200
冰雪大世界,20230406,全国,全国,284,95,189
冰雪大世界,20230407,全国,全国,320,140,180
冰雪大世界,20230408,全国,全国,281,70,211
冰雪大世界,20230409,全国,全国,289,70,219
冰雪大世界,20230410,全国,全国,256,85,171
冰雪大世界,20230411,全国,全国,270,87,183
冰雪大世界,20230412,全国,全国,274,89,185
冰雪大世界,20230413,全国,全国,255,76,179
冰雪大世界,20230414,全国,全国,286,89,197
冰雪大世界,20230415,全国,全国,245,63,182
冰雪大世界,20230416,全国,全国,256,66,190
冰雪大世界,20230417,全国,全国,288,80,208
冰雪大世界,20230418,全国,全国,282,93,189
冰雪大世界,20230419,全国,全国,321,97,224
冰雪大世界,20230420,全国,全国,286,97,189
冰雪大世界,20230421,全国,全国,314,93,221
冰雪大世界,20230422,全国,全国,325,76,249
冰雪大世界,20230423,全国,全国,317,102,215
冰雪大世界,20230424,全国,全国,278,80,198
冰雪大世界,20230425,全国,全国,279,83,196
冰雪大世界,20230426,全国,全国,297,89,208
冰雪大世界,20230427,全国,全国,269,83,186
冰雪大世界,20230428,全国,全国,274,87,187
冰雪大世界,20230429,全国,全国,295,66,229
冰雪大世界,20230430,全国,全国,312,64,248
冰雪大世界,20230501,全国,全国,273,59,214
冰雪大世界,20230502,全国,全国,296,64,232
冰雪大世界,20230503,全国,全国,267,72,195
冰雪大世界,20230504,全国,全国,267,85,182
冰雪大世界,20230505,全国,全国,263,87,176
冰雪大世界,20230506,全国,全国,248,80,168
冰雪大世界,20230507,全国,全国,244,64,180
冰雪大世界,20230508,全国,全国,273,97,176
冰雪大世界,20230509,全国,全国,289,97,192
冰雪大世界,20230510,全国,全国,300,97,203
冰雪大世界,20230511,全国,全国,313,102,211
冰雪大世界,20230512,全国,全国,260,99,161
冰雪大世界,20230513,全国,全国,220,61,159
冰雪大世界,20230514,全国,全国,258,68,190
冰雪大世界,20230515,全国,全国,243,78,165
冰雪大世界,20230516,全国,全国,245,87,158
冰雪大世界,20230517,全国,全国,253,83,170
冰雪大世界,20230518,全国,全国,241,74,167
冰雪大世界,20230519,全国,全国,254,93,161
冰雪大世界,20230520,全国,全国,233,66,167
冰雪大世界,20230521,全国,全国,244,70,174
冰雪大世界,20230522,全国,全国,243,78,165
冰雪大世界,20230523,全国,全国,248,74,174
冰雪大世界,20230524,全国,全国,253,104,149
冰雪大世界,20230525,全国,全国,241,87,154
冰雪大世界,20230526,全国,全国,241,97,144
冰雪大世界,20230527,全国,全国,237,76,161
冰雪大世界,20230528,全国,全国,269,76,193
冰雪大世界,20230529,全国,全国,277,99,178
冰雪大世界,20230530,全国,全国,271,91,180
冰雪大世界,20230531,全国,全国,242,74,168
冰雪大世界,20230601,全国,全国,268,104,164
冰雪大世界,20230602,全国,全国,257,93,164
冰雪大世界,20230603,全国,全国,243,72,171
冰雪大世界,20230604,全国,全国,246,66,180
冰雪大世界,20230605,全国,全国,248,78,170
冰雪大世界,20230606,全国,全国,233,95,138
冰雪大世界,20230607,全国,全国,265,95,170
冰雪大世界,20230608,全国,全国,256,82,174
冰雪大世界,20230609,全国,全国,268,102,166
冰雪大世界,20230610,全国,全国,243,78,165
冰雪大世界,20230611,全国,全国,255,68,187
冰雪大世界,20230612,全国,全国,265,89,176
冰雪大世界,20230613,全国,全国,268,101,167
冰雪大世界,20230614,全国,全国,244,76,168
冰雪大世界,20230615,全国,全国,248,78,170
冰雪大世界,20230616,全国,全国,268,82,186
冰雪大世界,20230617,全国,全国,246,70,176
冰雪大世界,20230618,全国,全国,244,68,176
冰雪大世界,20230619,全国,全国,250,76,174
冰雪大世界,20230620,全国,全国,309,120,189
冰雪大世界,20230621,全国,全国,275,99,176
冰雪大世界,20230622,全国,全国,270,72,198
冰雪大世界,20230623,全国,全国,252,74,178
冰雪大世界,20230624,全国,全国,257,61,196
冰雪大世界,20230625,全国,全国,259,78,181
冰雪大世界,20230626,全国,全国,265,87,178
冰雪大世界,20230627,全国,全国,262,83,179
冰雪大世界,20230628,全国,全国,286,97,189
冰雪大世界,20230629,全国,全国,262,97,165
冰雪大世界,20230630,全国,全国,248,78,170
冰雪大世界,20230701,全国,全国,252,72,180
冰雪大世界,20230702,全国,全国,267,74,193
冰雪大世界,20230703,全国,全国,264,72,192
冰雪大世界,20230704,全国,全国,275,85,190
冰雪大世界,20230705,全国,全国,256,95,161
冰雪大世界,20230706,全国,全国,284,80,204
冰雪大世界,20230707,全国,全国,262,85,177
冰雪大世界,20230708,全国,全国,284,76,208
冰雪大世界,20230709,全国,全国,271,63,208
冰雪大世界,20230710,全国,全国,295,87,208
冰雪大世界,20230711,全国,全国,281,95,186
冰雪大世界,20230712,全国,全国,294,80,214
冰雪大世界,20230713,全国,全国,308,91,217
冰雪大世界,20230714,全国,全国,263,80,183
冰雪大世界,20230715,全国,全国,265,66,199
冰雪大世界,20230716,全国,全国,264,66,198
冰雪大世界,20230717,全国,全国,268,72,196
冰雪大世界,20230718,全国,全国,290,89,201
冰雪大世界,20230719,全国,全国,301,95,206
冰雪大世界,20230720,全国,全国,345,74,271
冰雪大世界,20230721,全国,全国,352,93,259
冰雪大世界,20230722,全国,全国,303,76,227
冰雪大世界,20230723,全国,全国,306,68,238
冰雪大世界,20230724,全国,全国,308,93,215
冰雪大世界,20230725,全国,全国,327,95,232
冰雪大世界,20230726,全国,全国,308,93,215
冰雪大世界,20230727,全国,全国,295,89,206
冰雪大世界,20230728,全国,全国,286,80,206
冰雪大世界,20230729,全国,全国,297,68,229
冰雪大世界,20230730,全国,全国,304,66,238
冰雪大世界,20230731,全国,全国,302,91,211
冰雪大世界,20230801,全国,全国,274,82,192
冰雪大世界,20230802,全国,全国,280,82,198
冰雪大世界,20230803,全国,全国,297,91,206
冰雪大世界,20230804,全国,全国,336,93,243
冰雪大世界,20230805,全国,全国,325,78,247
冰雪大世界,20230806,全国,全国,311,80,231
冰雪大世界,20230807,全国,全国,301,76,225
冰雪大世界,20230808,全国,全国,288,82,206
冰雪大世界,20230809,全国,全国,295,80,215
冰雪大世界,20230810,全国,全国,288,82,206
冰雪大世界,20230811,全国,全国,309,89,220
冰雪大世界,20230812,全国,全国,314,72,242
冰雪大世界,20230813,全国,全国,309,64,245
冰雪大世界,20230814,全国,全国,306,78,228
冰雪大世界,20230815,全国,全国,324,112,212
冰雪大世界,20230816,全国,全国,332,91,241
冰雪大世界,20230817,全国,全国,338,106,232
冰雪大世界,20230818,全国,全国,313,85,228
冰雪大世界,20230819,全国,全国,329,70,259
冰雪大世界,20230820,全国,全国,309,74,235
冰雪大世界,20230821,全国,全国,303,91,212
冰雪大世界,20230822,全国,全国,277,74,203
冰雪大世界,20230823,全国,全国,300,97,203
冰雪大世界,20230824,全国,全国,312,83,229
冰雪大世界,20230825,全国,全国,336,93,243
冰雪大世界,20230826,全国,全国,294,70,224
冰雪大世界,20230827,全国,全国,291,70,221
冰雪大世界,20230828,全国,全国,297,80,217
冰雪大世界,20230829,全国,全国,319,99,220
冰雪大世界,20230830,全国,全国,313,95,218
冰雪大世界,20230831,全国,全国,320,102,218
冰雪大世界,20230901,全国,全国,272,74,198
冰雪大世界,20230902,全国,全国,264,80,184
冰雪大世界,20230903,全国,全国,288,76,212
冰雪大世界,20230904,全国,全国,272,85,187
冰雪大世界,20230905,全国,全国,284,87,197
冰雪大世界,20230906,全国,全国,297,99,198
冰雪大世界,20230907,全国,全国,275,83,192
冰雪大世界,20230908,全国,全国,288,102,186
冰雪大世界,20230909,全国,全国,319,72,247
冰雪大世界,20230910,全国,全国,358,74,284
冰雪大世界,20230911,全国,全国,309,97,212
冰雪大世界,20230912,全国,全国,346,118,228
冰雪大世界,20230913,全国,全国,354,106,248
冰雪大世界,20230914,全国,全国,380,110,270
冰雪大世界,20230915,全国,全国,363,106,257
冰雪大世界,20230916,全国,全国,379,74,305
冰雪大世界,20230917,全国,全国,412,82,330
冰雪大世界,20230918,全国,全国,338,99,239
冰雪大世界,20230919,全国,全国,329,93,236
冰雪大世界,20230920,全国,全国,356,135,221
冰雪大世界,20230921,全国,全国,337,106,231
冰雪大世界,20230922,全国,全国,307,93,214
冰雪大世界,20230923,全国,全国,301,70,231
冰雪大世界,20230924,全国,全国,343,83,260
冰雪大世界,20230925,全国,全国,348,101,247
冰雪大世界,20230926,全国,全国,298,97,201
冰雪大世界,20230927,全国,全国,348,110,238
冰雪大世界,20230928,全国,全国,361,116,245
冰雪大世界,20230929,全国,全国,327,61,266
冰雪大世界,20230930,全国,全国,365,70,295
冰雪大世界,20231001,全国,全国,358,76,282
冰雪大世界,20231002,全国,全国,395,85,310
冰雪大世界,20231003,全国,全国,414,76,338
冰雪大世界,20231004,全国,全国,484,87,397
冰雪大世界,20231005,全国,全国,406,83,323
冰雪大世界,20231006,全国,全国,406,93,313
冰雪大世界,20231007,全国,全国,482,152,330
冰雪大世界,20231008,全国,全国,521,184,337
冰雪大世界,20231009,全国,全国,502,172,330
冰雪大世界,20231010,全国,全国,527,161,366
冰雪大世界,20231011,全国,全国,586,154,432
冰雪大世界,20231012,全国,全国,777,205,572
冰雪大世界,20231013,全国,全国,1055,290,765
冰雪大世界,20231014,全国,全国,1002,150,852
冰雪大世界,20231015,全国,全国,1081,155,926
冰雪大世界,20231016,全国,全国,1480,554,926
冰雪大世界,20231017,全国,全国,1317,431,886
冰雪大世界,20231018,全国,全国,1228,380,848
冰雪大世界,20231019,全国,全国,1158,319,839
冰雪大世界,20231020,全国,全国,1137,332,805
冰雪大世界,20231021,全国,全国,852,165,687
冰雪大世界,20231022,全国,全国,850,146,704
冰雪大世界,20231023,全国,全国,1047,369,678
冰雪大世界,20231024,全国,全国,913,332,581
冰雪大世界,20231025,全国,全国,1070,456,614
冰雪大世界,20231026,全国,全国,888,341,547
冰雪大世界,20231027,全国,全国,940,298,642
冰雪大世界,20231028,全国,全国,854,173,681
冰雪大世界,20231029,全国,全国,807,157,650
冰雪大世界,20231030,全国,全国,1046,349,697
冰雪大世界,20231031,全国,全国,940,298,642
冰雪大世界,20231101,全国,全国,1228,344,884
冰雪大世界,20231102,全国,全国,1024,357,667
冰雪大世界,20231103,全国,全国,1043,288,755
冰雪大世界,20231104,全国,全国,938,173,765
冰雪大世界,20231105,全国,全国,1045,197,848
冰雪大世界,20231106,全国,全国,1698,720,978
冰雪大世界,20231107,全国,全国,1446,533,913
冰雪大世界,20231108,全国,全国,1434,513,921
冰雪大世界,20231109,全国,全国,1422,524,898
冰雪大世界,20231110,全国,全国,1347,422,925
冰雪大世界,20231111,全国,全国,1088,204,884
冰雪大世界,20231112,全国,全国,1122,218,904
冰雪大世界,20231113,全国,全国,1471,549,922
冰雪大世界,20231114,全国,全国,1541,577,964
冰雪大世界,20231115,全国,全国,1463,561,902
冰雪大世界,20231116,全国,全国,1455,549,906
冰雪大世界,20231117,全国,全国,1434,499,935
冰雪大世界,20231118,全国,全国,1132,220,912
冰雪大世界,20231119,全国,全国,1215,257,958
冰雪大世界,20231120,全国,全国,1786,656,1130
冰雪大世界,20231121,全国,全国,1706,606,1100
冰雪大世界,20231122,全国,全国,1772,620,1152
冰雪大世界,20231123,全国,全国,1546,549,997
冰雪大世界,20231124,全国,全国,1622,521,1101
冰雪大世界,20231125,全国,全国,1268,257,1011
冰雪大世界,20231126,全国,全国,1346,259,1087
冰雪大世界,20231127,全国,全国,1935,791,1144
冰雪大世界,20231128,全国,全国,1659,692,967
冰雪大世界,20231129,全国,全国,1743,727,1016
冰雪大世界,20231130,全国,全国,1761,772,989
冰雪大世界,20231201,全国,全国,1838,709,1129
冰雪大世界,20231202,全国,全国,1515,360,1155
冰雪大世界,20231203,全国,全国,1541,285,1256
冰雪大世界,20231204,全国,全国,1963,864,1099
冰雪大世界,20231205,全国,全国,1976,760,1216
冰雪大世界,20231206,全国,全国,1984,844,1140
冰雪大世界,20231207,全国,全国,1802,768,1034
冰雪大世界,20231208,全国,全国,1716,696,1020
冰雪大世界,20231209,全国,全国,1284,309,975
冰雪大世界,20231210,全国,全国,1484,307,1177
冰雪大世界,20231211,全国,全国,1939,905,1034
冰雪大世界,20231212,全国,全国,1774,851,923
冰雪大世界,20231213,全国,全国,1914,810,1104
冰雪大世界,20231214,全国,全国,2450,871,1579
冰雪大世界,20231215,全国,全国,2475,864,1611
冰雪大世界,20231216,全国,全国,2046,391,1655
冰雪大世界,20231217,全国,全国,2237,420,1817
冰雪大世界,20231218,全国,全国,3969,1040,2929
冰雪大世界,20231219,全国,全国,4247,1193,3054
冰雪大世界,20231220,全国,全国,5039,1404,3635
冰雪大世界,20231221,全国,全国,5353,1285,4068
冰雪大世界,20231222,全国,全国,4085,928,3157
冰雪大世界,20231223,全国,全国,3250,516,2734
冰雪大世界,20231224,全国,全国,2934,563,2371
冰雪大世界,20231225,全国,全国,3236,941,2295
冰雪大世界,20231226,全国,全国,3218,876,2342
冰雪大世界,20231227,全国,全国,3052,855,2197
冰雪大世界,20231228,全国,全国,3130,854,2276
冰雪大世界,20231229,全国,全国,3467,849,2618
冰雪大世界,20231230,全国,全国,3248,399,2849
冰雪大世界,20231231,全国,全国,3495,532,2963
冰雪大世界,20240101,全国,全国,3069,490,2579
冰雪大世界,20240102,全国,全国,2829,914,1915
冰雪大世界,20240103,全国,全国,3583,985,2598
冰雪大世界,20240104,全国,全国,3927,1017,2910
冰雪大世界,20240105,全国,全国,5494,1067,4427
冰雪大世界,20240106,全国,全国,9699,704,8995
冰雪大世界,20240107,全国,全国,6540,602,5938
冰雪大世界,20240108,全国,全国,10539,986,9553
冰雪大世界,20240109,全国,全国,8943,902,8041
冰雪大世界,20240110,全国,全国,8537,875,7662
冰雪大世界,20240111,全国,全国,7235,883,6352
冰雪大世界,20240112,全国,全国,8274,822,7452
冰雪大世界,20240113,全国,全国,7028,395,6633
冰雪大世界,20240114,全国,全国,5234,436,4798
冰雪大世界,20240115,全国,全国,8112,870,7242
冰雪大世界,20240116,全国,全国,6507,794,5713
冰雪大世界,20240117,全国,全国,7152,741,6411
冰雪大世界,20240118,全国,全国,6943,575,6368
冰雪大世界,20240119,全国,全国,7017,578,6439
冰雪大世界,20240120,全国,全国,6494,332,6162
冰雪大世界,20240121,全国,全国,4357,349,4008
冰雪大世界,20240122,全国,全国,6527,582,5945
冰雪大世界,20240123,全国,全国,5460,572,4888
冰雪大世界,20240124,全国,全国,2491,478,2013
冰雪大世界,20240125,全国,全国,2318,515,1803
冰雪大世界,20240126,全国,全国,2122,403,1719
冰雪大世界,20240127,全国,全国,1840,262,1578
冰雪大世界,20240128,全国,全国,1753,247,1506
冰雪大世界,20240129,全国,全国,1820,419,1401
冰雪大世界,20240130,全国,全国,1785,433,1352
冰雪大世界,20240131,全国,全国,1623,330,1293
冰雪大世界,20240201,全国,全国,1578,386,1192
冰雪大世界,20240202,全国,全国,1501,310,1191
冰雪大世界,20240203,全国,全国,1438,209,1229
冰雪大世界,20240204,全国,全国,1695,378,1317
冰雪大世界,20240205,全国,全国,1556,318,1238
冰雪大世界,20240206,全国,全国,1529,276,1253
冰雪大世界,20240207,全国,全国,1447,251,1196
冰雪大世界,20240208,全国,全国,1487,220,1267
冰雪大世界,20240209,全国,全国,1184,157,1027
冰雪大世界,20240210,全国,全国,1526,168,1358
冰雪大世界,20240211,全国,全国,1891,146,1745
冰雪大世界,20240212,全国,全国,1927,154,1773
冰雪大世界,20240213,全国,全国,3253,307,2946
冰雪大世界,20240214,全国,全国,3310,296,3014
冰雪大世界,20240215,全国,全国,2417,315,2102
冰雪大世界,20240216,全国,全国,1742,228,1514
冰雪大世界,20240217,全国,全国,1416,225,1191
冰雪大世界,20240218,全国,全国,1364,354,1010
冰雪大世界,20240219,全国,全国,1353,383,970
冰雪大世界,20240220,全国,全国,1216,288,928
冰雪大世界,20240221,全国,全国,1180,271,909
冰雪大世界,20240222,全国,全国,1152,248,904
冰雪大世界,20240223,全国,全国,1156,274,882
冰雪大世界,20240224,全国,全国,1045,159,886
冰雪大世界,20240225,全国,全国,1075,188,887
冰雪大世界,20240226,全国,全国,1059,248,811
冰雪大世界,20240227,全国,全国,1022,226,796
冰雪大世界,20240228,全国,全国,1001,228,773
冰雪大世界,20240229,全国,全国,1072,257,815
冰雪大世界,20240301,全国,全国,708,202,506
冰雪大世界,20240302,全国,全国,635,144,491
冰雪大世界,20240303,全国,全国,723,158,565
冰雪大世界,20240304,全国,全国,594,201,393
冰雪大世界,20240305,全国,全国,607,193,414
冰雪大世界,20240306,全国,全国,584,186,398
冰雪大世界,20240307,全国,全国,607,233,374
冰雪大世界,20240308,全国,全国,469,110,359
冰雪大世界,20240309,全国,全国,494,120,374
冰雪大世界,20240310,全国,全国,580,112,468
冰雪大世界,20240311,全国,全国,542,182,360
冰雪大世界,20240312,全国,全国,534,188,346
冰雪大世界,20240313,全国,全国,617,190,427
冰雪大世界,20240314,全国,全国,592,180,412
冰雪大世界,20240315,全国,全国,479,159,320
冰雪大世界,20240316,全国,全国,548,133,415
冰雪大世界,20240317,全国,全国,622,123,499
冰雪大世界,20240318,全国,全国,540,179,361
冰雪大世界,20240319,全国,全国,470,179,291
冰雪大世界,20240320,全国,全国,454,163,291
冰雪大世界,20240321,全国,全国,489,219,270
冰雪大世界,20240322,全国,全国,396,150,246
冰雪大世界,20240323,全国,全国,360,97,263
冰雪大世界,20240324,全国,全国,439,106,333
冰雪大世界,20240325,全国,全国,385,125,260
冰雪大世界,20240326,全国,全国,416,139,277
冰雪大世界,20240327,全国,全国,447,137,310
冰雪大世界,20240328,全国,全国,466,161,305
冰雪大世界,20240329,全国,全国,394,131,263
冰雪大世界,20240330,全国,全国,413,142,271
冰雪大世界,20240331,全国,全国,433,110,323
冰雪大世界,20240401,全国,全国,407,150,257
冰雪大世界,20240402,全国,全国,370,142,228
冰雪大世界,20240403,全国,全国,360,125,235
冰雪大世界,20240404,全国,全国,406,91,315
冰雪大世界,20240405,全国,全国,387,93,294
冰雪大世界,20240406,全国,全国,388,110,278
冰雪大世界,20240407,全国,全国,425,148,277
冰雪大世界,20240408,全国,全国,385,146,239
冰雪大世界,20240409,全国,全国,352,121,231
冰雪大世界,20240410,全国,全国,370,118,252
冰雪大世界,20240411,全国,全国,364,152,212
冰雪大世界,20240412,全国,全国,340,91,249
冰雪大世界,20240413,全国,全国,299,87,212
冰雪大世界,20240414,全国,全国,365,101,264
冰雪大世界,20240415,全国,全国,367,110,257
冰雪大世界,20240416,全国,全国,370,121,249
冰雪大世界,20240417,全国,全国,325,93,232
冰雪大世界,20240418,全国,全国,353,112,241
冰雪大世界,20240419,全国,全国,320,112,208
冰雪大世界,20240420,全国,全国,310,76,234
冰雪大世界,20240421,全国,全国,359,93,266
冰雪大世界,20240422,全国,全国,319,118,201
冰雪大世界,20240423,全国,全国,337,129,208
冰雪大世界,20240424,全国,全国,318,118,200
冰雪大世界,20240425,全国,全国,320,108,212
冰雪大世界,20240426,全国,全国,320,127,193
冰雪大世界,20240427,全国,全国,373,95,278
冰雪大世界,20240428,全国,全国,350,112,238
冰雪大世界,20240429,全国,全国,307,112,195
冰雪大世界,20240430,全国,全国,382,129,253
